Datetime,100034982 (Hüfferstraße),101034982 (Hüfferstraße stadteinwärts),102034982 (Hüfferstraße stadtauswärts),100034982-status,101034982-status,102034982-status
2025-03-01 00:00,13,4,9,0,0,0
2025-03-01 00:15,15,5,10,0,0,0
2025-03-01 00:30,5,2,3,0,0,0
2025-03-01 00:45,6,1,5,0,0,0
2025-03-01 01:00,6,4,2,0,0,0
2025-03-01 01:15,8,1,7,0,0,0
2025-03-01 01:30,0,0,0,0,0,0
2025-03-01 01:45,3,0,3,0,0,0
2025-03-01 02:00,7,1,6,0,0,0
2025-03-01 02:15,4,0,4,0,0,0
2025-03-01 02:30,5,0,5,0,0,0
2025-03-01 02:45,5,0,5,0,0,0
2025-03-01 03:00,3,1,2,0,0,0
2025-03-01 03:15,5,0,5,0,0,0
2025-03-01 03:30,2,0,2,0,0,0
2025-03-01 03:45,0,0,0,0,0,0
2025-03-01 04:00,9,4,5,0,0,0
2025-03-01 04:15,3,2,1,0,0,0
2025-03-01 04:30,2,2,0,0,0,0
2025-03-01 04:45,1,0,1,0,0,0
2025-03-01 05:00,1,0,1,0,0,0
2025-03-01 05:15,4,2,2,0,0,0
2025-03-01 05:30,14,2,12,0,0,0
2025-03-01 05:45,6,4,2,0,0,0
2025-03-01 06:00,9,6,3,0,0,0
2025-03-01 06:15,1,1,0,0,0,0
2025-03-01 06:30,5,3,2,0,0,0
2025-03-01 06:45,15,11,4,0,0,0
2025-03-01 07:00,5,3,2,0,0,0
2025-03-01 07:15,16,8,8,0,0,0
2025-03-01 07:30,15,5,10,0,0,0
2025-03-01 07:45,26,12,14,0,0,0
2025-03-01 08:00,21,12,9,0,0,0
2025-03-01 08:15,17,15,2,0,0,0
2025-03-01 08:30,21,13,8,0,0,0
2025-03-01 08:45,35,27,8,0,0,0
2025-03-01 09:00,26,18,8,0,0,0
2025-03-01 09:15,43,32,11,0,0,0
2025-03-01 09:30,46,30,16,0,0,0
2025-03-01 09:45,50,30,20,0,0,0
2025-03-01 10:00,48,37,11,0,0,0
2025-03-01 10:15,54,42,12,0,0,0
2025-03-01 10:30,79,35,44,0,0,0
2025-03-01 10:45,106,66,40,0,0,0
2025-03-01 11:00,76,46,30,0,0,0
2025-03-01 11:15,83,50,33,0,0,0
2025-03-01 11:30,87,55,32,0,0,0
2025-03-01 11:45,109,65,44,0,0,0
2025-03-01 12:00,103,57,46,0,0,0
2025-03-01 12:15,106,62,44,0,0,0
2025-03-01 12:30,104,42,62,0,0,0
2025-03-01 12:45,97,48,49,0,0,0
2025-03-01 13:00,94,43,51,0,0,0
2025-03-01 13:15,115,58,57,0,0,0
2025-03-01 13:30,97,39,58,0,0,0
2025-03-01 13:45,63,25,38,0,0,0
2025-03-01 14:00,77,32,45,0,0,0
2025-03-01 14:15,86,36,50,0,0,0
2025-03-01 14:30,70,21,49,0,0,0
2025-03-01 14:45,58,23,35,0,0,0
2025-03-01 15:00,72,33,39,0,0,0
2025-03-01 15:15,50,23,27,0,0,0
2025-03-01 15:30,57,19,38,0,0,0
2025-03-01 15:45,54,24,30,0,0,0
2025-03-01 16:00,57,18,39,0,0,0
2025-03-01 16:15,57,19,38,0,0,0
2025-03-01 16:30,57,26,31,0,0,0
2025-03-01 16:45,66,21,45,0,0,0
2025-03-01 17:00,70,21,49,0,0,0
2025-03-01 17:15,75,34,41,0,0,0
2025-03-01 17:30,63,15,48,0,0,0
2025-03-01 17:45,67,24,43,0,0,0
2025-03-01 18:00,59,16,43,0,0,0
2025-03-01 18:15,62,24,38,0,0,0
2025-03-01 18:30,34,15,19,0,0,0
2025-03-01 18:45,45,23,22,0,0,0
2025-03-01 19:00,53,33,20,0,0,0
2025-03-01 19:15,45,19,26,0,0,0
2025-03-01 19:30,46,21,25,0,0,0
2025-03-01 19:45,28,13,15,0,0,0
2025-03-01 20:00,32,10,22,0,0,0
2025-03-01 20:15,29,11,18,0,0,0
2025-03-01 20:30,16,4,12,0,0,0
2025-03-01 20:45,18,4,14,0,0,0
2025-03-01 21:00,20,12,8,0,0,0
2025-03-01 21:15,24,10,14,0,0,0
2025-03-01 21:30,19,9,10,0,0,0
2025-03-01 21:45,12,5,7,0,0,0
2025-03-01 22:00,23,3,20,0,0,0
2025-03-01 22:15,24,4,20,0,0,0
2025-03-01 22:30,9,2,7,0,0,0
2025-03-01 22:45,20,4,16,0,0,0
2025-03-01 23:00,20,4,16,0,0,0
2025-03-01 23:15,22,3,19,0,0,0
2025-03-01 23:30,16,5,11,0,0,0
2025-03-01 23:45,25,4,21,0,0,0
2025-03-02 00:00,11,1,10,0,0,0
2025-03-02 00:15,13,3,10,0,0,0
2025-03-02 00:30,9,4,5,0,0,0
2025-03-02 00:45,7,1,6,0,0,0
2025-03-02 01:00,6,1,5,0,0,0
2025-03-02 01:15,7,0,7,0,0,0
2025-03-02 01:30,1,0,1,0,0,0
2025-03-02 01:45,9,2,7,0,0,0
2025-03-02 02:00,12,3,9,0,0,0
2025-03-02 02:15,6,1,5,0,0,0
2025-03-02 02:30,1,0,1,0,0,0
2025-03-02 02:45,5,1,4,0,0,0
2025-03-02 03:00,1,0,1,0,0,0
2025-03-02 03:15,3,0,3,0,0,0
2025-03-02 03:30,4,2,2,0,0,0
2025-03-02 03:45,1,0,1,0,0,0
2025-03-02 04:00,6,1,5,0,0,0
2025-03-02 04:15,1,0,1,0,0,0
2025-03-02 04:30,1,0,1,0,0,0
2025-03-02 04:45,3,0,3,0,0,0
2025-03-02 05:00,2,0,2,0,0,0
2025-03-02 05:15,0,0,0,0,0,0
2025-03-02 05:30,8,2,6,0,0,0
2025-03-02 05:45,6,0,6,0,0,0
2025-03-02 06:00,4,2,2,0,0,0
2025-03-02 06:15,5,0,5,0,0,0
2025-03-02 06:30,4,3,1,0,0,0
2025-03-02 06:45,8,3,5,0,0,0
2025-03-02 07:00,1,1,0,0,0,0
2025-03-02 07:15,10,6,4,0,0,0
2025-03-02 07:30,5,4,1,0,0,0
2025-03-02 07:45,11,4,7,0,0,0
2025-03-02 08:00,10,1,9,0,0,0
2025-03-02 08:15,3,1,2,0,0,0
2025-03-02 08:30,11,9,2,0,0,0
2025-03-02 08:45,14,7,7,0,0,0
2025-03-02 09:00,5,3,2,0,0,0
2025-03-02 09:15,17,13,4,0,0,0
2025-03-02 09:30,16,11,5,0,0,0
2025-03-02 09:45,42,37,5,0,0,0
2025-03-02 10:00,29,13,16,0,0,0
2025-03-02 10:15,21,20,1,0,0,0
2025-03-02 10:30,18,11,7,0,0,0
2025-03-02 10:45,50,30,20,0,0,0
2025-03-02 11:00,47,30,17,0,0,0
2025-03-02 11:15,32,22,10,0,0,0
2025-03-02 11:30,31,14,17,0,0,0
2025-03-02 11:45,28,13,15,0,0,0
2025-03-02 12:00,39,21,18,0,0,0
2025-03-02 12:15,46,13,33,0,0,0
2025-03-02 12:30,34,13,21,0,0,0
2025-03-02 12:45,43,18,25,0,0,0
2025-03-02 13:00,52,12,40,0,0,0
2025-03-02 13:15,41,14,27,0,0,0
2025-03-02 13:30,55,29,26,0,0,0
2025-03-02 13:45,62,23,39,0,0,0
2025-03-02 14:00,45,25,20,0,0,0
2025-03-02 14:15,67,35,32,0,0,0
2025-03-02 14:30,82,28,54,0,0,0
2025-03-02 14:45,63,32,31,0,0,0
2025-03-02 15:00,48,27,21,0,0,0
2025-03-02 15:15,58,31,27,0,0,0
2025-03-02 15:30,66,29,37,0,0,0
2025-03-02 15:45,67,23,44,0,0,0
2025-03-02 16:00,56,21,35,0,0,0
2025-03-02 16:15,39,12,27,0,0,0
2025-03-02 16:30,56,13,43,0,0,0
2025-03-02 16:45,60,20,40,0,0,0
2025-03-02 17:00,33,16,17,0,0,0
2025-03-02 17:15,37,15,22,0,0,0
2025-03-02 17:30,49,22,27,0,0,0
2025-03-02 17:45,50,18,32,0,0,0
2025-03-02 18:00,51,19,32,0,0,0
2025-03-02 18:15,37,15,22,0,0,0
2025-03-02 18:30,35,8,27,0,0,0
2025-03-02 18:45,45,19,26,0,0,0
2025-03-02 19:00,23,16,7,0,0,0
2025-03-02 19:15,22,7,15,0,0,0
2025-03-02 19:30,24,16,8,0,0,0
2025-03-02 19:45,30,14,16,0,0,0
2025-03-02 20:00,26,11,15,0,0,0
2025-03-02 20:15,21,6,15,0,0,0
2025-03-02 20:30,16,5,11,0,0,0
2025-03-02 20:45,20,1,19,0,0,0
2025-03-02 21:00,17,5,12,0,0,0
2025-03-02 21:15,26,11,15,0,0,0
2025-03-02 21:30,10,4,6,0,0,0
2025-03-02 21:45,22,3,19,0,0,0
2025-03-02 22:00,13,5,8,0,0,0
2025-03-02 22:15,7,1,6,0,0,0
2025-03-02 22:30,15,0,15,0,0,0
2025-03-02 22:45,9,0,9,0,0,0
2025-03-02 23:00,10,3,7,0,0,0
2025-03-02 23:15,0,0,0,0,0,0
2025-03-02 23:30,6,1,5,0,0,0
2025-03-02 23:45,2,0,2,0,0,0
2025-03-03 00:00,6,2,4,0,0,0
2025-03-03 00:15,2,0,2,0,0,0
2025-03-03 00:30,2,1,1,0,0,0
2025-03-03 00:45,2,2,0,0,0,0
2025-03-03 01:00,4,2,2,0,0,0
2025-03-03 01:15,2,0,2,0,0,0
2025-03-03 01:30,1,1,0,0,0,0
2025-03-03 01:45,1,0,1,0,0,0
2025-03-03 02:00,0,0,0,0,0,0
2025-03-03 02:15,3,1,2,0,0,0
2025-03-03 02:30,3,1,2,0,0,0
2025-03-03 02:45,0,0,0,0,0,0
2025-03-03 03:00,0,0,0,0,0,0
2025-03-03 03:15,0,0,0,0,0,0
2025-03-03 03:30,1,1,0,0,0,0
2025-03-03 03:45,0,0,0,0,0,0
2025-03-03 04:00,3,3,0,0,0,0
2025-03-03 04:15,0,0,0,0,0,0
2025-03-03 04:30,0,0,0,0,0,0
2025-03-03 04:45,0,0,0,0,0,0
2025-03-03 05:00,2,0,2,0,0,0
2025-03-03 05:15,0,0,0,0,0,0
2025-03-03 05:30,13,5,8,0,0,0
2025-03-03 05:45,8,2,6,0,0,0
2025-03-03 06:00,2,2,0,0,0,0
2025-03-03 06:15,5,5,0,0,0,0
2025-03-03 06:30,14,12,2,0,0,0
2025-03-03 06:45,19,7,12,0,0,0
2025-03-03 07:00,19,13,6,0,0,0
2025-03-03 07:15,31,11,20,0,0,0
2025-03-03 07:30,32,20,12,0,0,0
2025-03-03 07:45,34,20,14,0,0,0
2025-03-03 08:00,48,29,19,0,0,0
2025-03-03 08:15,47,22,25,0,0,0
2025-03-03 08:30,27,15,12,0,0,0
2025-03-03 08:45,55,30,25,0,0,0
2025-03-03 09:00,29,17,12,0,0,0
2025-03-03 09:15,27,16,11,0,0,0
2025-03-03 09:30,23,17,6,0,0,0
2025-03-03 09:45,28,14,14,0,0,0
2025-03-03 10:00,33,15,18,0,0,0
2025-03-03 10:15,52,37,15,0,0,0
2025-03-03 10:30,42,27,15,0,0,0
2025-03-03 10:45,63,40,23,0,0,0
2025-03-03 11:00,37,28,9,0,0,0
2025-03-03 11:15,51,32,19,0,0,0
2025-03-03 11:30,59,42,17,0,0,0
2025-03-03 11:45,82,64,18,0,0,0
2025-03-03 12:00,110,79,31,0,0,0
2025-03-03 12:15,88,60,28,0,0,0
2025-03-03 12:30,71,49,22,0,0,0
2025-03-03 12:45,82,65,17,0,0,0
2025-03-03 13:00,81,69,12,0,0,0
2025-03-03 13:15,82,58,24,0,0,0
2025-03-03 13:30,95,56,39,0,0,0
2025-03-03 13:45,92,62,30,0,0,0
2025-03-03 14:00,59,37,22,0,0,0
2025-03-03 14:15,116,49,67,0,0,0
2025-03-03 14:30,96,34,62,0,0,0
2025-03-03 14:45,83,26,57,0,0,0
2025-03-03 15:00,50,20,30,0,0,0
2025-03-03 15:15,65,24,41,0,0,0
2025-03-03 15:30,79,24,55,0,0,0
2025-03-03 15:45,78,19,59,0,0,0
2025-03-03 16:00,95,21,74,0,0,0
2025-03-03 16:15,73,24,49,0,0,0
2025-03-03 16:30,93,13,80,0,0,0
2025-03-03 16:45,96,20,76,0,0,0
2025-03-03 17:00,84,23,61,0,0,0
2025-03-03 17:15,76,13,63,0,0,0
2025-03-03 17:30,70,15,55,0,0,0
2025-03-03 17:45,73,21,52,0,0,0
2025-03-03 18:00,49,11,38,0,0,0
2025-03-03 18:15,50,26,24,0,0,0
2025-03-03 18:30,62,16,46,0,0,0
2025-03-03 18:45,29,5,24,0,0,0
2025-03-03 19:00,33,5,28,0,0,0
2025-03-03 19:15,35,10,25,0,0,0
2025-03-03 19:30,47,17,30,0,0,0
2025-03-03 19:45,41,10,31,0,0,0
2025-03-03 20:00,27,6,21,0,0,0
2025-03-03 20:15,24,6,18,0,0,0
2025-03-03 20:30,21,5,16,0,0,0
2025-03-03 20:45,17,1,16,0,0,0
2025-03-03 21:00,28,14,14,0,0,0
2025-03-03 21:15,34,12,22,0,0,0
2025-03-03 21:30,15,7,8,0,0,0
2025-03-03 21:45,16,7,9,0,0,0
2025-03-03 22:00,18,3,15,0,0,0
2025-03-03 22:15,13,2,11,0,0,0
2025-03-03 22:30,16,1,15,0,0,0
2025-03-03 22:45,18,4,14,0,0,0
2025-03-03 23:00,7,1,6,0,0,0
2025-03-03 23:15,6,2,4,0,0,0
2025-03-03 23:30,15,1,14,0,0,0
2025-03-03 23:45,10,5,5,0,0,0
2025-03-04 00:00,4,2,2,0,0,0
2025-03-04 00:15,4,0,4,0,0,0
2025-03-04 00:30,3,0,3,0,0,0
2025-03-04 00:45,3,0,3,0,0,0
2025-03-04 01:00,1,1,0,0,0,0
2025-03-04 01:15,5,1,4,0,0,0
2025-03-04 01:30,1,0,1,0,0,0
2025-03-04 01:45,4,0,4,0,0,0
2025-03-04 02:00,0,0,0,0,0,0
2025-03-04 02:15,1,0,1,0,0,0
2025-03-04 02:30,2,1,1,0,0,0
2025-03-04 02:45,1,1,0,0,0,0
2025-03-04 03:00,0,0,0,0,0,0
2025-03-04 03:15,0,0,0,0,0,0
2025-03-04 03:30,2,1,1,0,0,0
2025-03-04 03:45,0,0,0,0,0,0
2025-03-04 04:00,2,2,0,0,0,0
2025-03-04 04:15,2,2,0,0,0,0
2025-03-04 04:30,1,0,1,0,0,0
2025-03-04 04:45,0,0,0,0,0,0
2025-03-04 05:00,5,0,5,0,0,0
2025-03-04 05:15,1,1,0,0,0,0
2025-03-04 05:30,14,4,10,0,0,0
2025-03-04 05:45,18,7,11,0,0,0
2025-03-04 06:00,11,4,7,0,0,0
2025-03-04 06:15,28,14,14,0,0,0
2025-03-04 06:30,42,19,23,0,0,0
2025-03-04 06:45,67,19,48,0,0,0
2025-03-04 07:00,85,28,57,0,0,0
2025-03-04 07:15,85,20,65,0,0,0
2025-03-04 07:30,150,50,100,0,0,0
2025-03-04 07:45,167,63,104,0,0,0
2025-03-04 08:00,142,49,93,0,0,0
2025-03-04 08:15,125,44,81,0,0,0
2025-03-04 08:30,138,58,80,0,0,0
2025-03-04 08:45,151,51,100,0,0,0
2025-03-04 09:00,114,72,42,0,0,0
2025-03-04 09:15,87,36,51,0,0,0
2025-03-04 09:30,72,41,31,0,0,0
2025-03-04 09:45,100,50,50,0,0,0
2025-03-04 10:00,75,41,34,0,0,0
2025-03-04 10:15,69,31,38,0,0,0
2025-03-04 10:30,101,55,46,0,0,0
2025-03-04 10:45,64,38,26,0,0,0
2025-03-04 11:00,98,49,49,0,0,0
2025-03-04 11:15,75,34,41,0,0,0
2025-03-04 11:30,87,41,46,0,0,0
2025-03-04 11:45,96,40,56,0,0,0
2025-03-04 12:00,83,33,50,0,0,0
2025-03-04 12:15,107,44,63,0,0,0
2025-03-04 12:30,94,23,71,0,0,0
2025-03-04 12:45,99,53,46,0,0,0
2025-03-04 13:00,97,53,44,0,0,0
2025-03-04 13:15,91,50,41,0,0,0
2025-03-04 13:30,87,50,37,0,0,0
2025-03-04 13:45,98,50,48,0,0,0
2025-03-04 14:00,103,50,53,0,0,0
2025-03-04 14:15,128,76,52,0,0,0
2025-03-04 14:30,108,61,47,0,0,0
2025-03-04 14:45,110,58,52,0,0,0
2025-03-04 15:00,113,55,58,0,0,0
2025-03-04 15:15,129,60,69,0,0,0
2025-03-04 15:30,170,80,90,0,0,0
2025-03-04 15:45,132,71,61,0,0,0
2025-03-04 16:00,156,82,74,0,0,0
2025-03-04 16:15,140,75,65,0,0,0
2025-03-04 16:30,156,79,77,0,0,0
2025-03-04 16:45,163,72,91,0,0,0
2025-03-04 17:00,154,62,92,0,0,0
2025-03-04 17:15,148,67,81,0,0,0
2025-03-04 17:30,133,71,62,0,0,0
2025-03-04 17:45,128,54,74,0,0,0
2025-03-04 18:00,123,54,69,0,0,0
2025-03-04 18:15,93,37,56,0,0,0
2025-03-04 18:30,95,38,57,0,0,0
2025-03-04 18:45,116,41,75,0,0,0
2025-03-04 19:00,69,23,46,0,0,0
2025-03-04 19:15,74,26,48,0,0,0
2025-03-04 19:30,65,30,35,0,0,0
2025-03-04 19:45,77,26,51,0,0,0
2025-03-04 20:00,72,17,55,0,0,0
2025-03-04 20:15,49,13,36,0,0,0
2025-03-04 20:30,22,9,13,0,0,0
2025-03-04 20:45,23,12,11,0,0,0
2025-03-04 21:00,43,24,19,0,0,0
2025-03-04 21:15,32,14,18,0,0,0
2025-03-04 21:30,20,6,14,0,0,0
2025-03-04 21:45,42,8,34,0,0,0
2025-03-04 22:00,25,10,15,0,0,0
2025-03-04 22:15,12,4,8,0,0,0
2025-03-04 22:30,20,4,16,0,0,0
2025-03-04 22:45,15,3,12,0,0,0
2025-03-04 23:00,13,5,8,0,0,0
2025-03-04 23:15,16,5,11,0,0,0
2025-03-04 23:30,14,2,12,0,0,0
2025-03-04 23:45,3,1,2,0,0,0
2025-03-05 00:00,4,3,1,0,0,0
2025-03-05 00:15,1,0,1,0,0,0
2025-03-05 00:30,6,0,6,0,0,0
2025-03-05 00:45,0,0,0,0,0,0
2025-03-05 01:00,4,1,3,0,0,0
2025-03-05 01:15,1,1,0,0,0,0
2025-03-05 01:30,2,1,1,0,0,0
2025-03-05 01:45,0,0,0,0,0,0
2025-03-05 02:00,2,0,2,0,0,0
2025-03-05 02:15,0,0,0,0,0,0
2025-03-05 02:30,0,0,0,0,0,0
2025-03-05 02:45,1,1,0,0,0,0
2025-03-05 03:00,0,0,0,0,0,0
2025-03-05 03:15,0,0,0,0,0,0
2025-03-05 03:30,1,1,0,0,0,0
2025-03-05 03:45,3,3,0,0,0,0
2025-03-05 04:00,1,1,0,0,0,0
2025-03-05 04:15,0,0,0,0,0,0
2025-03-05 04:30,0,0,0,0,0,0
2025-03-05 04:45,2,0,2,0,0,0
2025-03-05 05:00,0,0,0,0,0,0
2025-03-05 05:15,4,3,1,0,0,0
2025-03-05 05:30,18,5,13,0,0,0
2025-03-05 05:45,25,7,18,0,0,0
2025-03-05 06:00,12,6,6,0,0,0
2025-03-05 06:15,25,8,17,0,0,0
2025-03-05 06:30,54,18,36,0,0,0
2025-03-05 06:45,60,25,35,0,0,0
2025-03-05 07:00,92,43,49,0,0,0
2025-03-05 07:15,118,63,55,0,0,0
2025-03-05 07:30,271,168,103,0,0,0
2025-03-05 07:45,247,97,150,0,0,0
2025-03-05 08:00,159,63,96,0,0,0
2025-03-05 08:15,139,71,68,0,0,0
2025-03-05 08:30,143,62,81,0,0,0
2025-03-05 08:45,191,84,107,0,0,0
2025-03-05 09:00,130,70,60,0,0,0
2025-03-05 09:15,105,60,45,0,0,0
2025-03-05 09:30,97,55,42,0,0,0
2025-03-05 09:45,124,61,63,0,0,0
2025-03-05 10:00,89,40,49,0,0,0
2025-03-05 10:15,93,46,47,0,0,0
2025-03-05 10:30,81,29,52,0,0,0
2025-03-05 10:45,74,38,36,0,0,0
2025-03-05 11:00,102,50,52,0,0,0
2025-03-05 11:15,71,35,36,0,0,0
2025-03-05 11:30,92,51,41,0,0,0
2025-03-05 11:45,122,66,56,0,0,0
2025-03-05 12:00,107,48,59,0,0,0
2025-03-05 12:15,150,68,82,0,0,0
2025-03-05 12:30,131,53,78,0,0,0
2025-03-05 12:45,141,60,81,0,0,0
2025-03-05 13:00,162,58,104,0,0,0
2025-03-05 13:15,134,48,86,0,0,0
2025-03-05 13:30,122,62,60,0,0,0
2025-03-05 13:45,119,48,71,0,0,0
2025-03-05 14:00,159,55,104,0,0,0
2025-03-05 14:15,106,33,73,0,0,0
2025-03-05 14:30,122,46,76,0,0,0
2025-03-05 14:45,129,51,78,0,0,0
2025-03-05 15:00,154,64,90,0,0,0
2025-03-05 15:15,132,72,60,0,0,0
2025-03-05 15:30,168,61,107,0,0,0
2025-03-05 15:45,156,77,79,0,0,0
2025-03-05 16:00,180,104,76,0,0,0
2025-03-05 16:15,150,78,72,0,0,0
2025-03-05 16:30,124,52,72,0,0,0
2025-03-05 16:45,153,77,76,0,0,0
2025-03-05 17:00,175,109,66,0,0,0
2025-03-05 17:15,172,89,83,0,0,0
2025-03-05 17:30,166,82,84,0,0,0
2025-03-05 17:45,180,81,99,0,0,0
2025-03-05 18:00,123,49,74,0,0,0
2025-03-05 18:15,120,48,72,0,0,0
2025-03-05 18:30,98,37,61,0,0,0
2025-03-05 18:45,106,52,54,0,0,0
2025-03-05 19:00,93,36,57,0,0,0
2025-03-05 19:15,73,37,36,0,0,0
2025-03-05 19:30,98,27,71,0,0,0
2025-03-05 19:45,63,29,34,0,0,0
2025-03-05 20:00,75,17,58,0,0,0
2025-03-05 20:15,51,10,41,0,0,0
2025-03-05 20:30,40,18,22,0,0,0
2025-03-05 20:45,35,17,18,0,0,0
2025-03-05 21:00,35,16,19,0,0,0
2025-03-05 21:15,26,15,11,0,0,0
2025-03-05 21:30,27,9,18,0,0,0
2025-03-05 21:45,30,9,21,0,0,0
2025-03-05 22:00,24,3,21,0,0,0
2025-03-05 22:15,29,11,18,0,0,0
2025-03-05 22:30,45,16,29,0,0,0
2025-03-05 22:45,16,1,15,0,0,0
2025-03-05 23:00,23,1,22,0,0,0
2025-03-05 23:15,28,10,18,0,0,0
2025-03-05 23:30,6,0,6,0,0,0
2025-03-05 23:45,4,1,3,0,0,0
2025-03-06 00:00,8,2,6,0,0,0
2025-03-06 00:15,4,1,3,0,0,0
2025-03-06 00:30,6,0,6,0,0,0
2025-03-06 00:45,0,0,0,0,0,0
2025-03-06 01:00,6,0,6,0,0,0
2025-03-06 01:15,1,1,0,0,0,0
2025-03-06 01:30,2,1,1,0,0,0
2025-03-06 01:45,3,0,3,0,0,0
2025-03-06 02:00,2,0,2,0,0,0
2025-03-06 02:15,2,0,2,0,0,0
2025-03-06 02:30,2,2,0,0,0,0
2025-03-06 02:45,0,0,0,0,0,0
2025-03-06 03:00,0,0,0,0,0,0
2025-03-06 03:15,0,0,0,0,0,0
2025-03-06 03:30,3,3,0,0,0,0
2025-03-06 03:45,7,1,6,0,0,0
2025-03-06 04:00,2,2,0,0,0,0
2025-03-06 04:15,0,0,0,0,0,0
2025-03-06 04:30,0,0,0,0,0,0
2025-03-06 04:45,3,0,3,0,0,0
2025-03-06 05:00,0,0,0,0,0,0
2025-03-06 05:15,7,2,5,0,0,0
2025-03-06 05:30,18,5,13,0,0,0
2025-03-06 05:45,22,5,17,0,0,0
2025-03-06 06:00,15,3,12,0,0,0
2025-03-06 06:15,29,11,18,0,0,0
2025-03-06 06:30,47,11,36,0,0,0
2025-03-06 06:45,49,17,32,0,0,0
2025-03-06 07:00,91,32,59,0,0,0
2025-03-06 07:15,129,80,49,0,0,0
2025-03-06 07:30,304,185,119,0,0,0
2025-03-06 07:45,246,97,149,0,0,0
2025-03-06 08:00,162,73,89,0,0,0
2025-03-06 08:15,146,64,82,0,0,0
2025-03-06 08:30,164,76,88,0,0,0
2025-03-06 08:45,178,90,88,0,0,0
2025-03-06 09:00,135,57,78,0,0,0
2025-03-06 09:15,113,52,61,0,0,0
2025-03-06 09:30,92,43,49,0,0,0
2025-03-06 09:45,112,50,62,0,0,0
2025-03-06 10:00,80,26,54,0,0,0
2025-03-06 10:15,84,49,35,0,0,0
2025-03-06 10:30,80,45,35,0,0,0
2025-03-06 10:45,96,45,51,0,0,0
2025-03-06 11:00,75,40,35,0,0,0
2025-03-06 11:15,92,43,49,0,0,0
2025-03-06 11:30,90,49,41,0,0,0
2025-03-06 11:45,99,52,47,0,0,0
2025-03-06 12:00,100,57,43,0,0,0
2025-03-06 12:15,112,50,62,0,0,0
2025-03-06 12:30,133,46,87,0,0,0
2025-03-06 12:45,120,43,77,0,0,0
2025-03-06 13:00,138,49,89,0,0,0
2025-03-06 13:15,140,65,75,0,0,0
2025-03-06 13:30,132,55,77,0,0,0
2025-03-06 13:45,128,61,67,0,0,0
2025-03-06 14:00,157,52,105,0,0,0
2025-03-06 14:15,136,61,75,0,0,0
2025-03-06 14:30,129,67,62,0,0,0
2025-03-06 14:45,150,63,87,0,0,0
2025-03-06 15:00,157,73,84,0,0,0
2025-03-06 15:15,163,79,84,0,0,0
2025-03-06 15:30,169,81,88,0,0,0
2025-03-06 15:45,186,106,80,0,0,0
2025-03-06 16:00,172,79,93,0,0,0
2025-03-06 16:15,164,91,73,0,0,0
2025-03-06 16:30,149,75,74,0,0,0
2025-03-06 16:45,128,75,53,0,0,0
2025-03-06 17:00,162,75,87,0,0,0
2025-03-06 17:15,145,72,73,0,0,0
2025-03-06 17:30,138,72,66,0,0,0
2025-03-06 17:45,165,80,85,0,0,0
2025-03-06 18:00,145,62,83,0,0,0
2025-03-06 18:15,160,73,87,0,0,0
2025-03-06 18:30,118,55,63,0,0,0
2025-03-06 18:45,96,36,60,0,0,0
2025-03-06 19:00,94,38,56,0,0,0
2025-03-06 19:15,108,43,65,0,0,0
2025-03-06 19:30,79,26,53,0,0,0
2025-03-06 19:45,58,26,32,0,0,0
2025-03-06 20:00,70,21,49,0,0,0
2025-03-06 20:15,55,8,47,0,0,0
2025-03-06 20:30,42,11,31,0,0,0
2025-03-06 20:45,41,7,34,0,0,0
2025-03-06 21:00,50,20,30,0,0,0
2025-03-06 21:15,27,8,19,0,0,0
2025-03-06 21:30,31,8,23,0,0,0
2025-03-06 21:45,47,12,35,0,0,0
2025-03-06 22:00,27,5,22,0,0,0
2025-03-06 22:15,60,21,39,0,0,0
2025-03-06 22:30,46,9,37,0,0,0
2025-03-06 22:45,32,1,31,0,0,0
2025-03-06 23:00,14,6,8,0,0,0
2025-03-06 23:15,20,4,16,0,0,0
2025-03-06 23:30,18,2,16,0,0,0
2025-03-06 23:45,4,3,1,0,0,0
2025-03-07 00:00,1,1,,0,0,
2025-03-07 00:15,0,0,,0,0,
2025-03-07 00:30,4,4,,0,0,
2025-03-07 00:45,0,0,,0,0,
2025-03-07 01:00,0,0,,0,0,
2025-03-07 01:15,0,0,,0,0,
2025-03-07 01:30,1,1,,0,0,
2025-03-07 01:45,0,0,,0,0,
2025-03-07 02:00,2,2,,0,0,
2025-03-07 02:15,0,0,,0,0,
2025-03-07 02:30,0,0,,0,0,
2025-03-07 02:45,2,2,,0,0,
2025-03-07 03:00,0,0,,0,0,
2025-03-07 03:15,0,0,,0,0,
2025-03-07 03:30,0,0,,0,0,
2025-03-07 03:45,2,2,,0,0,
2025-03-07 04:00,3,3,,0,0,
2025-03-07 04:15,0,0,,0,0,
2025-03-07 04:30,0,0,,0,0,
2025-03-07 04:45,0,0,,0,0,
2025-03-07 05:00,0,0,,0,0,
2025-03-07 05:15,2,2,,0,0,
2025-03-07 05:30,4,4,,0,0,
2025-03-07 05:45,4,4,,0,0,
2025-03-07 06:00,4,4,,0,0,
2025-03-07 06:15,7,7,,0,0,
2025-03-07 06:30,14,14,,0,0,
2025-03-07 06:45,21,21,,0,0,
2025-03-07 07:00,29,29,,0,0,
2025-03-07 07:15,59,59,,0,0,
2025-03-07 07:30,173,173,,0,0,
2025-03-07 07:45,112,112,,0,0,
2025-03-07 08:00,40,40,,0,0,
2025-03-07 08:15,59,59,,0,0,
2025-03-07 08:30,61,61,,0,0,
2025-03-07 08:45,67,67,,0,0,
2025-03-07 09:00,47,47,,0,0,
2025-03-07 09:15,43,43,,0,0,
2025-03-07 09:30,42,42,,0,0,
2025-03-07 09:45,69,69,,0,0,
2025-03-07 10:00,39,39,,0,0,
2025-03-07 10:15,32,32,,0,0,
2025-03-07 10:30,52,52,,0,0,
2025-03-07 10:45,42,42,,0,0,
2025-03-07 11:00,25,25,,0,0,
2025-03-07 11:15,67,67,,0,0,
2025-03-07 11:30,46,46,,0,0,
2025-03-07 11:45,49,49,,0,0,
2025-03-07 12:00,55,55,,0,0,
2025-03-07 12:15,46,46,,0,0,
2025-03-07 12:30,43,43,,0,0,
2025-03-07 12:45,57,57,,0,0,
2025-03-07 13:00,60,60,,0,0,
2025-03-07 13:15,43,43,,0,0,
2025-03-07 13:30,40,40,,0,0,
2025-03-07 13:45,79,79,,0,0,
2025-03-07 14:00,65,65,,0,0,
2025-03-07 14:15,66,66,,0,0,
2025-03-07 14:30,67,67,,0,0,
2025-03-07 14:45,75,75,,0,0,
2025-03-07 15:00,81,81,,0,0,
2025-03-07 15:15,92,92,,0,0,
2025-03-07 15:30,98,98,,0,0,
2025-03-07 15:45,73,73,,0,0,
2025-03-07 16:00,91,91,,0,0,
2025-03-07 16:15,85,85,,0,0,
2025-03-07 16:30,71,71,,0,0,
2025-03-07 16:45,80,80,,0,0,
2025-03-07 17:00,70,70,,0,0,
2025-03-07 17:15,48,48,,0,0,
2025-03-07 17:30,61,61,,0,0,
2025-03-07 17:45,60,60,,0,0,
2025-03-07 18:00,39,39,,0,0,
2025-03-07 18:15,45,45,,0,0,
2025-03-07 18:30,35,35,,0,0,
2025-03-07 18:45,44,44,,0,0,
2025-03-07 19:00,45,45,,0,0,
2025-03-07 19:15,34,34,,0,0,
2025-03-07 19:30,32,32,,0,0,
2025-03-07 19:45,33,33,,0,0,
2025-03-07 20:00,25,25,,0,0,
2025-03-07 20:15,16,16,,0,0,
2025-03-07 20:30,12,12,,0,0,
2025-03-07 20:45,17,17,,0,0,
2025-03-07 21:00,6,6,,0,0,
2025-03-07 21:15,15,15,,0,0,
2025-03-07 21:30,10,10,,0,0,
2025-03-07 21:45,11,11,,0,0,
2025-03-07 22:00,6,6,,0,0,
2025-03-07 22:15,11,11,,0,0,
2025-03-07 22:30,1,1,,0,0,
2025-03-07 22:45,9,9,,0,0,
2025-03-07 23:00,10,10,,0,0,
2025-03-07 23:15,1,1,,0,0,
2025-03-07 23:30,2,2,,0,0,
2025-03-07 23:45,4,4,,0,0,
2025-03-08 00:00,4,4,,0,0,
2025-03-08 00:15,11,11,,0,0,
2025-03-08 00:30,5,5,,0,0,
2025-03-08 00:45,5,5,,0,0,
2025-03-08 01:00,9,9,,0,0,
2025-03-08 01:15,1,1,,0,0,
2025-03-08 01:30,1,1,,0,0,
2025-03-08 01:45,6,6,,0,0,
2025-03-08 02:00,1,1,,0,0,
2025-03-08 02:15,1,1,,0,0,
2025-03-08 02:30,3,3,,0,0,
2025-03-08 02:45,0,0,,0,0,
2025-03-08 03:00,2,2,,0,0,
2025-03-08 03:15,1,1,,0,0,
2025-03-08 03:30,1,1,,0,0,
2025-03-08 03:45,1,1,,0,0,
2025-03-08 04:00,2,2,,0,0,
2025-03-08 04:15,0,0,,0,0,
2025-03-08 04:30,2,2,,0,0,
2025-03-08 04:45,0,0,,0,0,
2025-03-08 05:00,0,0,0,0,0,0
2025-03-08 05:15,4,2,2,0,0,0
2025-03-08 05:30,5,4,1,0,0,0
2025-03-08 05:45,13,3,10,0,0,0
2025-03-08 06:00,3,1,2,0,0,0
2025-03-08 06:15,6,2,4,0,0,0
2025-03-08 06:30,9,6,3,0,0,0
2025-03-08 06:45,9,7,2,0,0,0
2025-03-08 07:00,13,11,2,0,0,0
2025-03-08 07:15,8,3,5,0,0,0
2025-03-08 07:30,25,17,8,0,0,0
2025-03-08 07:45,22,13,9,0,0,0
2025-03-08 08:00,28,13,15,0,0,0
2025-03-08 08:15,39,21,18,0,0,0
2025-03-08 08:30,33,24,9,0,0,0
2025-03-08 08:45,55,36,19,0,0,0
2025-03-08 09:00,57,44,13,0,0,0
2025-03-08 09:15,69,49,20,0,0,0
2025-03-08 09:30,99,67,32,0,0,0
2025-03-08 09:45,108,89,19,0,0,0
2025-03-08 10:00,102,72,30,0,0,0
2025-03-08 10:15,76,57,19,0,0,0
2025-03-08 10:30,111,66,45,0,0,0
2025-03-08 10:45,94,64,30,0,0,0
2025-03-08 11:00,110,73,37,0,0,0
2025-03-08 11:15,95,60,35,0,0,0
2025-03-08 11:30,101,64,37,0,0,0
2025-03-08 11:45,136,61,75,0,0,0
2025-03-08 12:00,134,63,71,0,0,0
2025-03-08 12:15,155,86,69,0,0,0
2025-03-08 12:30,160,68,92,0,0,0
2025-03-08 12:45,164,73,91,0,0,0
2025-03-08 13:00,160,59,101,0,0,0
2025-03-08 13:15,102,53,49,0,0,0
2025-03-08 13:30,138,73,65,0,0,0
2025-03-08 13:45,130,57,73,0,0,0
2025-03-08 14:00,114,35,79,0,0,0
2025-03-08 14:15,119,42,77,0,0,0
2025-03-08 14:30,137,49,88,0,0,0
2025-03-08 14:45,136,50,86,0,0,0
2025-03-08 15:00,129,45,84,0,0,0
2025-03-08 15:15,103,38,65,0,0,0
2025-03-08 15:30,109,44,65,0,0,0
2025-03-08 15:45,118,44,74,0,0,0
2025-03-08 16:00,103,33,70,0,0,0
2025-03-08 16:15,92,40,52,0,0,0
2025-03-08 16:30,111,26,85,0,0,0
2025-03-08 16:45,91,40,51,0,0,0
2025-03-08 17:00,111,36,75,0,0,0
2025-03-08 17:15,111,37,74,0,0,0
2025-03-08 17:30,76,29,47,0,0,0
2025-03-08 17:45,82,29,53,0,0,0
2025-03-08 18:00,97,49,48,0,0,0
2025-03-08 18:15,68,31,37,0,0,0
2025-03-08 18:30,53,22,31,0,0,0
2025-03-08 18:45,77,34,43,0,0,0
2025-03-08 19:00,68,35,33,0,0,0
2025-03-08 19:15,63,21,42,0,0,0
2025-03-08 19:30,53,24,29,0,0,0
2025-03-08 19:45,46,14,32,0,0,0
2025-03-08 20:00,43,21,22,0,0,0
2025-03-08 20:15,40,9,31,0,0,0
2025-03-08 20:30,27,9,18,0,0,0
2025-03-08 20:45,49,23,26,0,0,0
2025-03-08 21:00,32,15,17,0,0,0
2025-03-08 21:15,43,15,28,0,0,0
2025-03-08 21:30,26,7,19,0,0,0
2025-03-08 21:45,32,11,21,0,0,0
2025-03-08 22:00,24,4,20,0,0,0
2025-03-08 22:15,24,3,21,0,0,0
2025-03-08 22:30,17,6,11,0,0,0
2025-03-08 22:45,17,3,14,0,0,0
2025-03-08 23:00,20,1,19,0,0,0
2025-03-08 23:15,25,3,22,0,0,0
2025-03-08 23:30,19,4,15,0,0,0
2025-03-08 23:45,26,10,16,0,0,0
2025-03-09 00:00,31,7,24,0,0,0
2025-03-09 00:15,4,0,4,0,0,0
2025-03-09 00:30,20,4,16,0,0,0
2025-03-09 00:45,11,1,10,0,0,0
2025-03-09 01:00,24,8,16,0,0,0
2025-03-09 01:15,9,2,7,0,0,0
2025-03-09 01:30,14,12,2,0,0,0
2025-03-09 01:45,5,1,4,0,0,0
2025-03-09 02:00,6,1,5,0,0,0
2025-03-09 02:15,6,1,5,0,0,0
2025-03-09 02:30,6,0,6,0,0,0
2025-03-09 02:45,1,0,1,0,0,0
2025-03-09 03:00,2,0,2,0,0,0
2025-03-09 03:15,5,0,5,0,0,0
2025-03-09 03:30,9,0,9,0,0,0
2025-03-09 03:45,3,1,2,0,0,0
2025-03-09 04:00,2,0,2,0,0,0
2025-03-09 04:15,2,0,2,0,0,0
2025-03-09 04:30,1,0,1,0,0,0
2025-03-09 04:45,6,0,6,0,0,0
2025-03-09 05:00,1,0,1,0,0,0
2025-03-09 05:15,3,3,0,0,0,0
2025-03-09 05:30,9,2,7,0,0,0
2025-03-09 05:45,2,0,2,0,0,0
2025-03-09 06:00,6,2,4,0,0,0
2025-03-09 06:15,2,2,0,0,0,0
2025-03-09 06:30,3,2,1,0,0,0
2025-03-09 06:45,2,1,1,0,0,0
2025-03-09 07:00,8,4,4,0,0,0
2025-03-09 07:15,4,4,0,0,0,0
2025-03-09 07:30,5,1,4,0,0,0
2025-03-09 07:45,6,2,4,0,0,0
2025-03-09 08:00,9,8,1,0,0,0
2025-03-09 08:15,11,8,3,0,0,0
2025-03-09 08:30,6,6,0,0,0,0
2025-03-09 08:45,20,10,10,0,0,0
2025-03-09 09:00,28,16,12,0,0,0
2025-03-09 09:15,32,26,6,0,0,0
2025-03-09 09:30,29,12,17,0,0,0
2025-03-09 09:45,51,44,7,0,0,0
2025-03-09 10:00,35,18,17,0,0,0
2025-03-09 10:15,34,23,11,0,0,0
2025-03-09 10:30,47,23,24,0,0,0
2025-03-09 10:45,50,35,15,0,0,0
2025-03-09 11:00,17,7,10,0,0,0
2025-03-09 11:15,57,34,23,0,0,0
2025-03-09 11:30,49,19,30,0,0,0
2025-03-09 11:45,56,22,34,0,0,0
2025-03-09 12:00,60,23,37,0,0,0
2025-03-09 12:15,84,30,54,0,0,0
2025-03-09 12:30,73,29,44,0,0,0
2025-03-09 12:45,69,36,33,0,0,0
2025-03-09 13:00,74,42,32,0,0,0
2025-03-09 13:15,87,33,54,0,0,0
2025-03-09 13:30,63,24,39,0,0,0
2025-03-09 13:45,87,41,46,0,0,0
2025-03-09 14:00,118,49,69,0,0,0
2025-03-09 14:15,58,14,44,0,0,0
2025-03-09 14:30,49,6,43,0,0,0
2025-03-09 14:45,65,15,50,0,0,0
2025-03-09 15:00,56,37,19,0,0,0
2025-03-09 15:15,108,47,61,0,0,0
2025-03-09 15:30,88,43,45,0,0,0
2025-03-09 15:45,104,38,66,0,0,0
2025-03-09 16:00,106,37,69,0,0,0
2025-03-09 16:15,85,35,50,0,0,0
2025-03-09 16:30,91,28,63,0,0,0
2025-03-09 16:45,82,28,54,0,0,0
2025-03-09 17:00,79,24,55,0,0,0
2025-03-09 17:15,118,45,73,0,0,0
2025-03-09 17:30,91,40,51,0,0,0
2025-03-09 17:45,60,23,37,0,0,0
2025-03-09 18:00,75,23,52,0,0,0
2025-03-09 18:15,56,15,41,0,0,0
2025-03-09 18:30,52,13,39,0,0,0
2025-03-09 18:45,48,16,32,0,0,0
2025-03-09 19:00,42,13,29,0,0,0
2025-03-09 19:15,39,11,28,0,0,0
2025-03-09 19:30,38,8,30,0,0,0
2025-03-09 19:45,29,10,19,0,0,0
2025-03-09 20:00,36,7,29,0,0,0
2025-03-09 20:15,26,9,17,0,0,0
2025-03-09 20:30,37,5,32,0,0,0
2025-03-09 20:45,21,3,18,0,0,0
2025-03-09 21:00,31,9,22,0,0,0
2025-03-09 21:15,20,7,13,0,0,0
2025-03-09 21:30,19,4,15,0,0,0
2025-03-09 21:45,5,3,2,0,0,0
2025-03-09 22:00,16,0,16,0,0,0
2025-03-09 22:15,3,0,3,0,0,0
2025-03-09 22:30,23,3,20,0,0,0
2025-03-09 22:45,15,1,14,0,0,0
2025-03-09 23:00,12,3,9,0,0,0
2025-03-09 23:15,13,5,8,0,0,0
2025-03-09 23:30,11,1,10,0,0,0
2025-03-09 23:45,1,0,1,0,0,0
2025-03-10 00:00,1,1,0,0,0,0
2025-03-10 00:15,3,1,2,0,0,0
2025-03-10 00:30,0,0,0,0,0,0
2025-03-10 00:45,1,0,1,0,0,0
2025-03-10 01:00,1,0,1,0,0,0
2025-03-10 01:15,2,1,1,0,0,0
2025-03-10 01:30,1,1,0,0,0,0
2025-03-10 01:45,0,0,0,0,0,0
2025-03-10 02:00,0,0,0,0,0,0
2025-03-10 02:15,0,0,0,0,0,0
2025-03-10 02:30,1,1,0,0,0,0
2025-03-10 02:45,0,0,0,0,0,0
2025-03-10 03:00,0,0,0,0,0,0
2025-03-10 03:15,0,0,0,0,0,0
2025-03-10 03:30,1,1,0,0,0,0
2025-03-10 03:45,0,0,0,0,0,0
2025-03-10 04:00,3,1,2,0,0,0
2025-03-10 04:15,0,0,0,0,0,0
2025-03-10 04:30,2,2,0,0,0,0
2025-03-10 04:45,0,0,0,0,0,0
2025-03-10 05:00,2,0,2,0,0,0
2025-03-10 05:15,4,2,2,0,0,0
2025-03-10 05:30,11,3,8,0,0,0
2025-03-10 05:45,16,2,14,0,0,0
2025-03-10 06:00,14,6,8,0,0,0
2025-03-10 06:15,21,7,14,0,0,0
2025-03-10 06:30,65,17,48,0,0,0
2025-03-10 06:45,72,26,46,0,0,0
2025-03-10 07:00,97,42,55,0,0,0
2025-03-10 07:15,134,54,80,0,0,0
2025-03-10 07:30,266,162,104,0,0,0
2025-03-10 07:45,231,101,130,0,0,0
2025-03-10 08:00,183,68,115,0,0,0
2025-03-10 08:15,160,61,99,0,0,0
2025-03-10 08:30,112,47,65,0,0,0
2025-03-10 08:45,155,78,77,0,0,0
2025-03-10 09:00,113,53,60,0,0,0
2025-03-10 09:15,114,49,65,0,0,0
2025-03-10 09:30,111,49,62,0,0,0
2025-03-10 09:45,125,39,86,0,0,0
2025-03-10 10:00,85,30,55,0,0,0
2025-03-10 10:15,73,43,30,0,0,0
2025-03-10 10:30,73,37,36,0,0,0
2025-03-10 10:45,70,44,26,0,0,0
2025-03-10 11:00,76,34,42,0,0,0
2025-03-10 11:15,87,43,44,0,0,0
2025-03-10 11:30,46,7,39,0,0,0
2025-03-10 11:45,59,4,55,0,0,0
2025-03-10 12:00,39,0,39,0,0,0
2025-03-10 12:15,106,48,58,0,0,0
2025-03-10 12:30,116,40,76,0,0,0
2025-03-10 12:45,114,48,66,0,0,0
2025-03-10 13:00,148,55,93,0,0,0
2025-03-10 13:15,152,46,106,0,0,0
2025-03-10 13:30,115,55,60,0,0,0
2025-03-10 13:45,127,62,65,0,0,0
2025-03-10 14:00,142,73,69,0,0,0
2025-03-10 14:15,119,59,60,0,0,0
2025-03-10 14:30,116,50,66,0,0,0
2025-03-10 14:45,142,70,72,0,0,0
2025-03-10 15:00,146,64,82,0,0,0
2025-03-10 15:15,154,78,76,0,0,0
2025-03-10 15:30,198,99,99,0,0,0
2025-03-10 15:45,136,68,68,0,0,0
2025-03-10 16:00,199,122,77,0,0,0
2025-03-10 16:15,187,113,74,0,0,0
2025-03-10 16:30,168,87,81,0,0,0
2025-03-10 16:45,167,78,89,0,0,0
2025-03-10 17:00,152,73,79,0,0,0
2025-03-10 17:15,175,87,88,0,0,0
2025-03-10 17:30,149,71,78,0,0,0
2025-03-10 17:45,171,69,102,0,0,0
2025-03-10 18:00,150,73,77,0,0,0
2025-03-10 18:15,122,48,74,0,0,0
2025-03-10 18:30,95,41,54,0,0,0
2025-03-10 18:45,120,51,69,0,0,0
2025-03-10 19:00,70,22,48,0,0,0
2025-03-10 19:15,86,35,51,0,0,0
2025-03-10 19:30,63,24,39,0,0,0
2025-03-10 19:45,59,25,34,0,0,0
2025-03-10 20:00,53,21,32,0,0,0
2025-03-10 20:15,63,13,50,0,0,0
2025-03-10 20:30,54,9,45,0,0,0
2025-03-10 20:45,51,18,33,0,0,0
2025-03-10 21:00,30,11,19,0,0,0
2025-03-10 21:15,27,13,14,0,0,0
2025-03-10 21:30,25,7,18,0,0,0
2025-03-10 21:45,30,12,18,0,0,0
2025-03-10 22:00,19,6,13,0,0,0
2025-03-10 22:15,17,5,12,0,0,0
2025-03-10 22:30,20,8,12,0,0,0
2025-03-10 22:45,20,4,16,0,0,0
2025-03-10 23:00,10,3,7,0,0,0
2025-03-10 23:15,11,3,8,0,0,0
2025-03-10 23:30,1,1,0,0,0,0
2025-03-10 23:45,3,2,1,0,0,0
2025-03-11 00:00,5,1,4,0,0,0
2025-03-11 00:15,11,2,9,0,0,0
2025-03-11 00:30,1,1,0,0,0,0
2025-03-11 00:45,1,0,1,0,0,0
2025-03-11 01:00,2,1,1,0,0,0
2025-03-11 01:15,1,1,0,0,0,0
2025-03-11 01:30,0,0,0,0,0,0
2025-03-11 01:45,0,0,0,0,0,0
2025-03-11 02:00,0,0,0,0,0,0
2025-03-11 02:15,1,0,1,0,0,0
2025-03-11 02:30,1,1,0,0,0,0
2025-03-11 02:45,0,0,0,0,0,0
2025-03-11 03:00,0,0,0,0,0,0
2025-03-11 03:15,1,1,0,0,0,0
2025-03-11 03:30,0,0,0,0,0,0
2025-03-11 03:45,4,4,0,0,0,0
2025-03-11 04:00,3,3,0,0,0,0
2025-03-11 04:15,1,1,0,0,0,0
2025-03-11 04:30,2,2,0,0,0,0
2025-03-11 04:45,1,0,1,0,0,0
2025-03-11 05:00,0,0,0,0,0,0
2025-03-11 05:15,2,2,0,0,0,0
2025-03-11 05:30,13,6,7,0,0,0
2025-03-11 05:45,22,6,16,0,0,0
2025-03-11 06:00,13,10,3,0,0,0
2025-03-11 06:15,20,8,12,0,0,0
2025-03-11 06:30,53,18,35,0,0,0
2025-03-11 06:45,66,22,44,0,0,0
2025-03-11 07:00,72,21,51,0,0,0
2025-03-11 07:15,136,58,78,0,0,0
2025-03-11 07:30,244,133,111,0,0,0
2025-03-11 07:45,289,120,169,0,0,0
2025-03-11 08:00,181,52,129,0,0,0
2025-03-11 08:15,164,70,94,0,0,0
2025-03-11 08:30,145,49,96,0,0,0
2025-03-11 08:45,146,79,67,0,0,0
2025-03-11 09:00,146,65,81,0,0,0
2025-03-11 09:15,109,50,59,0,0,0
2025-03-11 09:30,112,50,62,0,0,0
2025-03-11 09:45,100,52,48,0,0,0
2025-03-11 10:00,58,29,29,0,0,0
2025-03-11 10:15,82,47,35,0,0,0
2025-03-11 10:30,67,38,29,0,0,0
2025-03-11 10:45,84,38,46,0,0,0
2025-03-11 11:00,84,36,48,0,0,0
2025-03-11 11:15,61,31,30,0,0,0
2025-03-11 11:30,67,30,37,0,0,0
2025-03-11 11:45,108,45,63,0,0,0
2025-03-11 12:00,88,38,50,0,0,0
2025-03-11 12:15,91,38,53,0,0,0
2025-03-11 12:30,102,34,68,0,0,0
2025-03-11 12:45,103,37,66,0,0,0
2025-03-11 13:00,106,37,69,0,0,0
2025-03-11 13:15,141,53,88,0,0,0
2025-03-11 13:30,116,50,66,0,0,0
2025-03-11 13:45,139,73,66,0,0,0
2025-03-11 14:00,131,51,80,0,0,0
2025-03-11 14:15,106,62,44,0,0,0
2025-03-11 14:30,90,53,37,0,0,0
2025-03-11 14:45,117,50,67,0,0,0
2025-03-11 15:00,128,46,82,0,0,0
2025-03-11 15:15,124,78,46,0,0,0
2025-03-11 15:30,136,66,70,0,0,0
2025-03-11 15:45,172,89,83,0,0,0
2025-03-11 16:00,152,101,51,0,0,0
2025-03-11 16:15,127,80,47,0,0,0
2025-03-11 16:30,134,59,75,0,0,0
2025-03-11 16:45,156,89,67,0,0,0
2025-03-11 17:00,153,75,78,0,0,0
2025-03-11 17:15,139,69,70,0,0,0
2025-03-11 17:30,156,86,70,0,0,0
2025-03-11 17:45,128,60,68,0,0,0
2025-03-11 18:00,138,58,80,0,0,0
2025-03-11 18:15,116,49,67,0,0,0
2025-03-11 18:30,108,36,72,0,0,0
2025-03-11 18:45,103,44,59,0,0,0
2025-03-11 19:00,83,36,47,0,0,0
2025-03-11 19:15,90,33,57,0,0,0
2025-03-11 19:30,66,33,33,0,0,0
2025-03-11 19:45,63,26,37,0,0,0
2025-03-11 20:00,61,18,43,0,0,0
2025-03-11 20:15,58,17,41,0,0,0
2025-03-11 20:30,34,10,24,0,0,0
2025-03-11 20:45,31,4,27,0,0,0
2025-03-11 21:00,24,10,14,0,0,0
2025-03-11 21:15,42,16,26,0,0,0
2025-03-11 21:30,30,4,26,0,0,0
2025-03-11 21:45,29,3,26,0,0,0
2025-03-11 22:00,25,8,17,0,0,0
2025-03-11 22:15,26,9,17,0,0,0
2025-03-11 22:30,25,3,22,0,0,0
2025-03-11 22:45,13,1,12,0,0,0
2025-03-11 23:00,29,7,22,0,0,0
2025-03-11 23:15,18,4,14,0,0,0
2025-03-11 23:30,11,1,10,0,0,0
2025-03-11 23:45,14,5,9,0,0,0
2025-03-12 00:00,9,4,5,0,0,0
2025-03-12 00:15,3,0,3,0,0,0
2025-03-12 00:30,2,1,1,0,0,0
2025-03-12 00:45,5,0,5,0,0,0
2025-03-12 01:00,3,2,1,0,0,0
2025-03-12 01:15,5,4,1,0,0,0
2025-03-12 01:30,3,0,3,0,0,0
2025-03-12 01:45,0,0,0,0,0,0
2025-03-12 02:00,0,0,0,0,0,0
2025-03-12 02:15,0,0,0,0,0,0
2025-03-12 02:30,0,0,0,0,0,0
2025-03-12 02:45,1,0,1,0,0,0
2025-03-12 03:00,1,1,0,0,0,0
2025-03-12 03:15,2,2,0,0,0,0
2025-03-12 03:30,2,2,0,0,0,0
2025-03-12 03:45,0,0,0,0,0,0
2025-03-12 04:00,0,0,0,0,0,0
2025-03-12 04:15,1,1,0,0,0,0
2025-03-12 04:30,0,0,0,0,0,0
2025-03-12 04:45,2,2,0,0,0,0
2025-03-12 05:00,0,0,0,0,0,0
2025-03-12 05:15,1,1,0,0,0,0
2025-03-12 05:30,17,5,12,0,0,0
2025-03-12 05:45,16,7,9,0,0,0
2025-03-12 06:00,17,7,10,0,0,0
2025-03-12 06:15,21,9,12,0,0,0
2025-03-12 06:30,52,21,31,0,0,0
2025-03-12 06:45,60,27,33,0,0,0
2025-03-12 07:00,83,29,54,0,0,0
2025-03-12 07:15,135,73,62,0,0,0
2025-03-12 07:30,248,153,95,0,0,0
2025-03-12 07:45,250,106,144,0,0,0
2025-03-12 08:00,175,58,117,0,0,0
2025-03-12 08:15,190,91,99,0,0,0
2025-03-12 08:30,148,70,78,0,0,0
2025-03-12 08:45,190,88,102,0,0,0
2025-03-12 09:00,124,63,61,0,0,0
2025-03-12 09:15,106,62,44,0,0,0
2025-03-12 09:30,114,62,52,0,0,0
2025-03-12 09:45,108,55,53,0,0,0
2025-03-12 10:00,91,46,45,0,0,0
2025-03-12 10:15,107,43,64,0,0,0
2025-03-12 10:30,90,44,46,0,0,0
2025-03-12 10:45,112,64,48,0,0,0
2025-03-12 11:00,98,50,48,0,0,0
2025-03-12 11:15,98,47,51,0,0,0
2025-03-12 11:30,107,47,60,0,0,0
2025-03-12 11:45,134,65,69,0,0,0
2025-03-12 12:00,133,56,77,0,0,0
2025-03-12 12:15,133,47,86,0,0,0
2025-03-12 12:30,158,51,107,0,0,0
2025-03-12 12:45,119,44,75,0,0,0
2025-03-12 13:00,157,47,110,0,0,0
2025-03-12 13:15,199,52,147,0,0,0
2025-03-12 13:30,122,57,65,0,0,0
2025-03-12 13:45,144,54,90,0,0,0
2025-03-12 14:00,172,60,112,0,0,0
2025-03-12 14:15,126,57,69,0,0,0
2025-03-12 14:30,122,56,66,0,0,0
2025-03-12 14:45,124,64,60,0,0,0
2025-03-12 15:00,144,86,58,0,0,0
2025-03-12 15:15,133,59,74,0,0,0
2025-03-12 15:30,142,60,82,0,0,0
2025-03-12 15:45,157,82,75,0,0,0
2025-03-12 16:00,172,94,78,0,0,0
2025-03-12 16:15,172,102,70,0,0,0
2025-03-12 16:30,133,73,60,0,0,0
2025-03-12 16:45,180,77,103,0,0,0
2025-03-12 17:00,158,74,84,0,0,0
2025-03-12 17:15,155,72,83,0,0,0
2025-03-12 17:30,156,59,97,0,0,0
2025-03-12 17:45,140,63,77,0,0,0
2025-03-12 18:00,132,57,75,0,0,0
2025-03-12 18:15,113,55,58,0,0,0
2025-03-12 18:30,97,43,54,0,0,0
2025-03-12 18:45,105,60,45,0,0,0
2025-03-12 19:00,78,37,41,0,0,0
2025-03-12 19:15,62,30,32,0,0,0
2025-03-12 19:30,67,24,43,0,0,0
2025-03-12 19:45,81,32,49,0,0,0
2025-03-12 20:00,71,24,47,0,0,0
2025-03-12 20:15,45,16,29,0,0,0
2025-03-12 20:30,41,20,21,0,0,0
2025-03-12 20:45,36,13,23,0,0,0
2025-03-12 21:00,48,17,31,0,0,0
2025-03-12 21:15,36,18,18,0,0,0
2025-03-12 21:30,32,12,20,0,0,0
2025-03-12 21:45,24,9,15,0,0,0
2025-03-12 22:00,42,4,38,0,0,0
2025-03-12 22:15,30,5,25,0,0,0
2025-03-12 22:30,39,4,35,0,0,0
2025-03-12 22:45,18,1,17,0,0,0
2025-03-12 23:00,28,5,23,0,0,0
2025-03-12 23:15,17,5,12,0,0,0
2025-03-12 23:30,12,3,9,0,0,0
2025-03-12 23:45,15,5,10,0,0,0
2025-03-13 00:00,14,6,8,0,0,0
2025-03-13 00:15,5,4,1,0,0,0
2025-03-13 00:30,2,1,1,0,0,0
2025-03-13 00:45,3,1,2,0,0,0
2025-03-13 01:00,1,0,1,0,0,0
2025-03-13 01:15,1,0,1,0,0,0
2025-03-13 01:30,1,0,1,0,0,0
2025-03-13 01:45,0,0,0,0,0,0
2025-03-13 02:00,3,0,3,0,0,0
2025-03-13 02:15,10,0,10,0,0,0
2025-03-13 02:30,1,1,0,0,0,0
2025-03-13 02:45,0,0,0,0,0,0
2025-03-13 03:00,1,0,1,0,0,0
2025-03-13 03:15,1,0,1,0,0,0
2025-03-13 03:30,0,0,0,0,0,0
2025-03-13 03:45,2,2,0,0,0,0
2025-03-13 04:00,4,2,2,0,0,0
2025-03-13 04:15,0,0,0,0,0,0
2025-03-13 04:30,1,1,0,0,0,0
2025-03-13 04:45,4,0,4,0,0,0
2025-03-13 05:00,0,0,0,0,0,0
2025-03-13 05:15,1,1,0,0,0,0
2025-03-13 05:30,16,7,9,0,0,0
2025-03-13 05:45,17,4,13,0,0,0
2025-03-13 06:00,17,7,10,0,0,0
2025-03-13 06:15,12,7,5,0,0,0
2025-03-13 06:30,54,14,40,0,0,0
2025-03-13 06:45,69,29,40,0,0,0
2025-03-13 07:00,82,27,55,0,0,0
2025-03-13 07:15,109,44,65,0,0,0
2025-03-13 07:30,237,141,96,0,0,0
2025-03-13 07:45,235,104,131,0,0,0
2025-03-13 08:00,163,66,97,0,0,0
2025-03-13 08:15,105,50,55,0,0,0
2025-03-13 08:30,172,69,103,0,0,0
2025-03-13 08:45,173,78,95,0,0,0
2025-03-13 09:00,126,58,68,0,0,0
2025-03-13 09:15,98,48,50,0,0,0
2025-03-13 09:30,96,53,43,0,0,0
2025-03-13 09:45,86,34,52,0,0,0
2025-03-13 10:00,62,22,40,0,0,0
2025-03-13 10:15,59,26,33,0,0,0
2025-03-13 10:30,74,38,36,0,0,0
2025-03-13 10:45,71,35,36,0,0,0
2025-03-13 11:00,65,27,38,0,0,0
2025-03-13 11:15,68,34,34,0,0,0
2025-03-13 11:30,76,28,48,0,0,0
2025-03-13 11:45,82,41,41,0,0,0
2025-03-13 12:00,76,38,38,0,0,0
2025-03-13 12:15,136,48,88,0,0,0
2025-03-13 12:30,83,34,49,0,0,0
2025-03-13 12:45,118,55,63,0,0,0
2025-03-13 13:00,118,43,75,0,0,0
2025-03-13 13:15,137,52,85,0,0,0
2025-03-13 13:30,101,46,55,0,0,0
2025-03-13 13:45,132,70,62,0,0,0
2025-03-13 14:00,105,39,66,0,0,0
2025-03-13 14:15,98,49,49,0,0,0
2025-03-13 14:30,108,73,35,0,0,0
2025-03-13 14:45,131,63,68,0,0,0
2025-03-13 15:00,141,68,73,0,0,0
2025-03-13 15:15,140,67,73,0,0,0
2025-03-13 15:30,153,72,81,0,0,0
2025-03-13 15:45,155,98,57,0,0,0
2025-03-13 16:00,162,81,81,0,0,0
2025-03-13 16:15,151,82,69,0,0,0
2025-03-13 16:30,170,83,87,0,0,0
2025-03-13 16:45,146,70,76,0,0,0
2025-03-13 17:00,153,72,81,0,0,0
2025-03-13 17:15,137,83,54,0,0,0
2025-03-13 17:30,132,58,74,0,0,0
2025-03-13 17:45,158,67,91,0,0,0
2025-03-13 18:00,123,44,79,0,0,0
2025-03-13 18:15,105,30,75,0,0,0
2025-03-13 18:30,118,54,64,0,0,0
2025-03-13 18:45,117,60,57,0,0,0
2025-03-13 19:00,99,45,54,0,0,0
2025-03-13 19:15,80,40,40,0,0,0
2025-03-13 19:30,75,35,40,0,0,0
2025-03-13 19:45,75,30,45,0,0,0
2025-03-13 20:00,73,14,59,0,0,0
2025-03-13 20:15,47,16,31,0,0,0
2025-03-13 20:30,33,7,26,0,0,0
2025-03-13 20:45,36,19,17,0,0,0
2025-03-13 21:00,39,15,24,0,0,0
2025-03-13 21:15,36,14,22,0,0,0
2025-03-13 21:30,37,10,27,0,0,0
2025-03-13 21:45,34,6,28,0,0,0
2025-03-13 22:00,39,11,28,0,0,0
2025-03-13 22:15,38,16,22,0,0,0
2025-03-13 22:30,20,3,17,0,0,0
2025-03-13 22:45,11,1,10,0,0,0
2025-03-13 23:00,34,3,31,0,0,0
2025-03-13 23:15,12,4,8,0,0,0
2025-03-13 23:30,11,2,9,0,0,0
2025-03-13 23:45,7,1,6,0,0,0
2025-03-14 00:00,11,4,7,0,0,0
2025-03-14 00:15,12,2,10,0,0,0
2025-03-14 00:30,2,0,2,0,0,0
2025-03-14 00:45,0,0,0,0,0,0
2025-03-14 01:00,3,0,3,0,0,0
2025-03-14 01:15,5,3,2,0,0,0
2025-03-14 01:30,2,0,2,0,0,0
2025-03-14 01:45,4,1,3,0,0,0
2025-03-14 02:00,2,0,2,0,0,0
2025-03-14 02:15,0,0,0,0,0,0
2025-03-14 02:30,1,1,0,0,0,0
2025-03-14 02:45,0,0,0,0,0,0
2025-03-14 03:00,1,1,0,0,0,0
2025-03-14 03:15,4,3,1,0,0,0
2025-03-14 03:30,0,0,0,0,0,0
2025-03-14 03:45,0,0,0,0,0,0
2025-03-14 04:00,0,0,0,0,0,0
2025-03-14 04:15,0,0,0,0,0,0
2025-03-14 04:30,1,1,0,0,0,0
2025-03-14 04:45,1,0,1,0,0,0
2025-03-14 05:00,0,0,0,0,0,0
2025-03-14 05:15,2,1,1,0,0,0
2025-03-14 05:30,8,3,5,0,0,0
2025-03-14 05:45,18,8,10,0,0,0
2025-03-14 06:00,14,5,9,0,0,0
2025-03-14 06:15,20,8,12,0,0,0
2025-03-14 06:30,40,14,26,0,0,0
2025-03-14 06:45,59,24,35,0,0,0
2025-03-14 07:00,69,24,45,0,0,0
2025-03-14 07:15,113,46,67,0,0,0
2025-03-14 07:30,229,165,64,0,0,0
2025-03-14 07:45,192,64,128,0,0,0
2025-03-14 08:00,143,46,97,0,0,0
2025-03-14 08:15,130,45,85,0,0,0
2025-03-14 08:30,125,54,71,0,0,0
2025-03-14 08:45,145,60,85,0,0,0
2025-03-14 09:00,95,48,47,0,0,0
2025-03-14 09:15,89,55,34,0,0,0
2025-03-14 09:30,93,41,52,0,0,0
2025-03-14 09:45,93,55,38,0,0,0
2025-03-14 10:00,82,48,34,0,0,0
2025-03-14 10:15,82,36,46,0,0,0
2025-03-14 10:30,68,39,29,0,0,0
2025-03-14 10:45,70,40,30,0,0,0
2025-03-14 11:00,87,45,42,0,0,0
2025-03-14 11:15,64,39,25,0,0,0
2025-03-14 11:30,73,42,31,0,0,0
2025-03-14 11:45,95,43,52,0,0,0
2025-03-14 12:00,92,40,52,0,0,0
2025-03-14 12:15,84,47,37,0,0,0
2025-03-14 12:30,112,43,69,0,0,0
2025-03-14 12:45,104,42,62,0,0,0
2025-03-14 13:00,162,60,102,0,0,0
2025-03-14 13:15,138,46,92,0,0,0
2025-03-14 13:30,123,58,65,0,0,0
2025-03-14 13:45,134,70,64,0,0,0
2025-03-14 14:00,140,37,103,0,0,0
2025-03-14 14:15,108,49,59,0,0,0
2025-03-14 14:30,123,50,73,0,0,0
2025-03-14 14:45,120,46,74,0,0,0
2025-03-14 15:00,125,55,70,0,0,0
2025-03-14 15:15,113,66,47,0,0,0
2025-03-14 15:30,123,63,60,0,0,0
2025-03-14 15:45,125,73,52,0,0,0
2025-03-14 16:00,100,67,33,0,0,0
2025-03-14 16:15,124,50,74,0,0,0
2025-03-14 16:30,78,35,43,0,0,0
2025-03-14 16:45,141,75,66,0,0,0
2025-03-14 17:00,116,55,61,0,0,0
2025-03-14 17:15,104,45,59,0,0,0
2025-03-14 17:30,86,34,52,0,0,0
2025-03-14 17:45,95,51,44,0,0,0
2025-03-14 18:00,100,44,56,0,0,0
2025-03-14 18:15,80,48,32,0,0,0
2025-03-14 18:30,60,27,33,0,0,0
2025-03-14 18:45,88,42,46,0,0,0
2025-03-14 19:00,81,56,25,0,0,0
2025-03-14 19:15,69,35,34,0,0,0
2025-03-14 19:30,63,38,25,0,0,0
2025-03-14 19:45,69,32,37,0,0,0
2025-03-14 20:00,54,12,42,0,0,0
2025-03-14 20:15,43,18,25,0,0,0
2025-03-14 20:30,29,17,12,0,0,0
2025-03-14 20:45,39,11,28,0,0,0
2025-03-14 21:00,44,12,32,0,0,0
2025-03-14 21:15,31,11,20,0,0,0
2025-03-14 21:30,28,8,20,0,0,0
2025-03-14 21:45,24,7,17,0,0,0
2025-03-14 22:00,24,9,15,0,0,0
2025-03-14 22:15,36,6,30,0,0,0
2025-03-14 22:30,26,5,21,0,0,0
2025-03-14 22:45,31,1,30,0,0,0
2025-03-14 23:00,15,4,11,0,0,0
2025-03-14 23:15,35,7,28,0,0,0
2025-03-14 23:30,21,6,15,0,0,0
2025-03-14 23:45,18,2,16,0,0,0
2025-03-15 00:00,28,8,20,0,0,0
2025-03-15 00:15,14,3,11,0,0,0
2025-03-15 00:30,8,1,7,0,0,0
2025-03-15 00:45,8,3,5,0,0,0
2025-03-15 01:00,4,1,3,0,0,0
2025-03-15 01:15,23,4,19,0,0,0
2025-03-15 01:30,12,3,9,0,0,0
2025-03-15 01:45,13,5,8,0,0,0
2025-03-15 02:00,7,2,5,0,0,0
2025-03-15 02:15,5,3,2,0,0,0
2025-03-15 02:30,4,0,4,0,0,0
2025-03-15 02:45,6,2,4,0,0,0
2025-03-15 03:00,1,0,1,0,0,0
2025-03-15 03:15,5,3,2,0,0,0
2025-03-15 03:30,6,3,3,0,0,0
2025-03-15 03:45,3,1,2,0,0,0
2025-03-15 04:00,6,0,6,0,0,0
2025-03-15 04:15,2,1,1,0,0,0
2025-03-15 04:30,0,0,0,0,0,0
2025-03-15 04:45,2,2,0,0,0,0
2025-03-15 05:00,6,1,5,0,0,0
2025-03-15 05:15,6,3,3,0,0,0
2025-03-15 05:30,6,2,4,0,0,0
2025-03-15 05:45,10,4,6,0,0,0
2025-03-15 06:00,6,1,5,0,0,0
2025-03-15 06:15,2,1,1,0,0,0
2025-03-15 06:30,5,4,1,0,0,0
2025-03-15 06:45,17,10,7,0,0,0
2025-03-15 07:00,13,7,6,0,0,0
2025-03-15 07:15,10,6,4,0,0,0
2025-03-15 07:30,22,6,16,0,0,0
2025-03-15 07:45,13,7,6,0,0,0
2025-03-15 08:00,25,18,7,0,0,0
2025-03-15 08:15,32,23,9,0,0,0
2025-03-15 08:30,46,31,15,0,0,0
2025-03-15 08:45,42,26,16,0,0,0
2025-03-15 09:00,34,21,13,0,0,0
2025-03-15 09:15,50,34,16,0,0,0
2025-03-15 09:30,57,37,20,0,0,0
2025-03-15 09:45,70,51,19,0,0,0
2025-03-15 10:00,67,52,15,0,0,0
2025-03-15 10:15,66,43,23,0,0,0
2025-03-15 10:30,80,61,19,0,0,0
2025-03-15 10:45,95,59,36,0,0,0
2025-03-15 11:00,75,41,34,0,0,0
2025-03-15 11:15,82,47,35,0,0,0
2025-03-15 11:30,85,25,60,0,0,0
2025-03-15 11:45,80,51,29,0,0,0
2025-03-15 12:00,72,43,29,0,0,0
2025-03-15 12:15,81,41,40,0,0,0
2025-03-15 12:30,104,53,51,0,0,0
2025-03-15 12:45,85,47,38,0,0,0
2025-03-15 13:00,96,51,45,0,0,0
2025-03-15 13:15,64,29,35,0,0,0
2025-03-15 13:30,91,35,56,0,0,0
2025-03-15 13:45,103,40,63,0,0,0
2025-03-15 14:00,89,46,43,0,0,0
2025-03-15 14:15,93,30,63,0,0,0
2025-03-15 14:30,86,30,56,0,0,0
2025-03-15 14:45,69,37,32,0,0,0
2025-03-15 15:00,63,24,39,0,0,0
2025-03-15 15:15,77,29,48,0,0,0
2025-03-15 15:30,62,30,32,0,0,0
2025-03-15 15:45,46,16,30,0,0,0
2025-03-15 16:00,58,19,39,0,0,0
2025-03-15 16:15,59,17,42,0,0,0
2025-03-15 16:30,50,30,20,0,0,0
2025-03-15 16:45,58,23,35,0,0,0
2025-03-15 17:00,63,19,44,0,0,0
2025-03-15 17:15,78,33,45,0,0,0
2025-03-15 17:30,63,23,40,0,0,0
2025-03-15 17:45,80,39,41,0,0,0
2025-03-15 18:00,39,18,21,0,0,0
2025-03-15 18:15,49,14,35,0,0,0
2025-03-15 18:30,60,13,47,0,0,0
2025-03-15 18:45,52,17,35,0,0,0
2025-03-15 19:00,60,30,30,0,0,0
2025-03-15 19:15,56,24,32,0,0,0
2025-03-15 19:30,37,20,17,0,0,0
2025-03-15 19:45,47,22,25,0,0,0
2025-03-15 20:00,38,21,17,0,0,0
2025-03-15 20:15,35,15,20,0,0,0
2025-03-15 20:30,32,17,15,0,0,0
2025-03-15 20:45,34,12,22,0,0,0
2025-03-15 21:00,25,8,17,0,0,0
2025-03-15 21:15,14,4,10,0,0,0
2025-03-15 21:30,25,11,14,0,0,0
2025-03-15 21:45,21,8,13,0,0,0
2025-03-15 22:00,40,5,35,0,0,0
2025-03-15 22:15,14,5,9,0,0,0
2025-03-15 22:30,35,8,27,0,0,0
2025-03-15 22:45,28,7,21,0,0,0
2025-03-15 23:00,17,2,15,0,0,0
2025-03-15 23:15,12,5,7,0,0,0
2025-03-15 23:30,26,10,16,0,0,0
2025-03-15 23:45,19,4,15,0,0,0
2025-03-16 00:00,8,3,5,0,0,0
2025-03-16 00:15,16,7,9,0,0,0
2025-03-16 00:30,14,3,11,0,0,0
2025-03-16 00:45,10,2,8,0,0,0
2025-03-16 01:00,10,1,9,0,0,0
2025-03-16 01:15,11,1,10,0,0,0
2025-03-16 01:30,14,5,9,0,0,0
2025-03-16 01:45,5,2,3,0,0,0
2025-03-16 02:00,8,0,8,0,0,0
2025-03-16 02:15,10,2,8,0,0,0
2025-03-16 02:30,7,2,5,0,0,0
2025-03-16 02:45,1,0,1,0,0,0
2025-03-16 03:00,10,0,10,0,0,0
2025-03-16 03:15,5,0,5,0,0,0
2025-03-16 03:30,2,0,2,0,0,0
2025-03-16 03:45,4,0,4,0,0,0
2025-03-16 04:00,6,0,6,0,0,0
2025-03-16 04:15,8,0,8,0,0,0
2025-03-16 04:30,1,0,1,0,0,0
2025-03-16 04:45,2,0,2,0,0,0
2025-03-16 05:00,4,4,0,0,0,0
2025-03-16 05:15,2,0,2,0,0,0
2025-03-16 05:30,6,1,5,0,0,0
2025-03-16 05:45,6,1,5,0,0,0
2025-03-16 06:00,2,1,1,0,0,0
2025-03-16 06:15,2,1,1,0,0,0
2025-03-16 06:30,5,5,0,0,0,0
2025-03-16 06:45,8,6,2,0,0,0
2025-03-16 07:00,4,1,3,0,0,0
2025-03-16 07:15,4,1,3,0,0,0
2025-03-16 07:30,6,3,3,0,0,0
2025-03-16 07:45,11,5,6,0,0,0
2025-03-16 08:00,7,2,5,0,0,0
2025-03-16 08:15,15,11,4,0,0,0
2025-03-16 08:30,10,8,2,0,0,0
2025-03-16 08:45,11,5,6,0,0,0
2025-03-16 09:00,11,5,6,0,0,0
2025-03-16 09:15,15,11,4,0,0,0
2025-03-16 09:30,18,8,10,0,0,0
2025-03-16 09:45,47,34,13,0,0,0
2025-03-16 10:00,34,20,14,0,0,0
2025-03-16 10:15,23,14,9,0,0,0
2025-03-16 10:30,23,15,8,0,0,0
2025-03-16 10:45,56,39,17,0,0,0
2025-03-16 11:00,29,13,16,0,0,0
2025-03-16 11:15,47,26,21,0,0,0
2025-03-16 11:30,30,13,17,0,0,0
2025-03-16 11:45,30,18,12,0,0,0
2025-03-16 12:00,24,5,19,0,0,0
2025-03-16 12:15,39,16,23,0,0,0
2025-03-16 12:30,60,24,36,0,0,0
2025-03-16 12:45,54,22,32,0,0,0
2025-03-16 13:00,47,19,28,0,0,0
2025-03-16 13:15,64,20,44,0,0,0
2025-03-16 13:30,63,22,41,0,0,0
2025-03-16 13:45,65,33,32,0,0,0
2025-03-16 14:00,49,22,27,0,0,0
2025-03-16 14:15,54,18,36,0,0,0
2025-03-16 14:30,66,32,34,0,0,0
2025-03-16 14:45,53,23,30,0,0,0
2025-03-16 15:00,101,48,53,0,0,0
2025-03-16 15:15,58,34,24,0,0,0
2025-03-16 15:30,54,20,34,0,0,0
2025-03-16 15:45,51,23,28,0,0,0
2025-03-16 16:00,65,35,30,0,0,0
2025-03-16 16:15,56,23,33,0,0,0
2025-03-16 16:30,76,35,41,0,0,0
2025-03-16 16:45,80,31,49,0,0,0
2025-03-16 17:00,72,34,38,0,0,0
2025-03-16 17:15,41,13,28,0,0,0
2025-03-16 17:30,62,20,42,0,0,0
2025-03-16 17:45,60,28,32,0,0,0
2025-03-16 18:00,50,25,25,0,0,0
2025-03-16 18:15,47,24,23,0,0,0
2025-03-16 18:30,48,13,35,0,0,0
2025-03-16 18:45,35,10,25,0,0,0
2025-03-16 19:00,46,17,29,0,0,0
2025-03-16 19:15,41,12,29,0,0,0
2025-03-16 19:30,32,16,16,0,0,0
2025-03-16 19:45,28,12,16,0,0,0
2025-03-16 20:00,57,13,44,0,0,0
2025-03-16 20:15,40,10,30,0,0,0
2025-03-16 20:30,25,8,17,0,0,0
2025-03-16 20:45,22,8,14,0,0,0
2025-03-16 21:00,25,15,10,0,0,0
2025-03-16 21:15,31,9,22,0,0,0
2025-03-16 21:30,14,2,12,0,0,0
2025-03-16 21:45,14,3,11,0,0,0
2025-03-16 22:00,12,7,5,0,0,0
2025-03-16 22:15,10,3,7,0,0,0
2025-03-16 22:30,15,1,14,0,0,0
2025-03-16 22:45,14,3,11,0,0,0
2025-03-16 23:00,7,0,7,0,0,0
2025-03-16 23:15,3,0,3,0,0,0
2025-03-16 23:30,4,0,4,0,0,0
2025-03-16 23:45,3,2,1,0,0,0
2025-03-17 00:00,4,0,4,0,0,0
2025-03-17 00:15,0,0,0,0,0,0
2025-03-17 00:30,2,0,2,0,0,0
2025-03-17 00:45,1,1,0,0,0,0
2025-03-17 01:00,1,0,1,0,0,0
2025-03-17 01:15,2,2,0,0,0,0
2025-03-17 01:30,1,1,0,0,0,0
2025-03-17 01:45,1,0,1,0,0,0
2025-03-17 02:00,2,0,2,0,0,0
2025-03-17 02:15,0,0,0,0,0,0
2025-03-17 02:30,1,1,0,0,0,0
2025-03-17 02:45,0,0,0,0,0,0
2025-03-17 03:00,0,0,0,0,0,0
2025-03-17 03:15,0,0,0,0,0,0
2025-03-17 03:30,2,2,0,0,0,0
2025-03-17 03:45,1,1,0,0,0,0
2025-03-17 04:00,1,1,0,0,0,0
2025-03-17 04:15,1,0,1,0,0,0
2025-03-17 04:30,1,1,0,0,0,0
2025-03-17 04:45,3,3,0,0,0,0
2025-03-17 05:00,5,4,1,0,0,0
2025-03-17 05:15,2,1,1,0,0,0
2025-03-17 05:30,17,6,11,0,0,0
2025-03-17 05:45,24,7,17,0,0,0
2025-03-17 06:00,16,5,11,0,0,0
2025-03-17 06:15,20,8,12,0,0,0
2025-03-17 06:30,66,18,48,0,0,0
2025-03-17 06:45,53,23,30,0,0,0
2025-03-17 07:00,86,38,48,0,0,0
2025-03-17 07:15,106,56,50,0,0,0
2025-03-17 07:30,247,157,90,0,0,0
2025-03-17 07:45,229,86,143,0,0,0
2025-03-17 08:00,154,54,100,0,0,0
2025-03-17 08:15,163,67,96,0,0,0
2025-03-17 08:30,130,64,66,0,0,0
2025-03-17 08:45,179,75,104,0,0,0
2025-03-17 09:00,118,53,65,0,0,0
2025-03-17 09:15,99,52,47,0,0,0
2025-03-17 09:30,68,35,33,0,0,0
2025-03-17 09:45,87,46,41,0,0,0
2025-03-17 10:00,71,33,38,0,0,0
2025-03-17 10:15,59,33,26,0,0,0
2025-03-17 10:30,68,35,33,0,0,0
2025-03-17 10:45,78,39,39,0,0,0
2025-03-17 11:00,70,29,41,0,0,0
2025-03-17 11:15,72,30,42,0,0,0
2025-03-17 11:30,67,42,25,0,0,0
2025-03-17 11:45,91,39,52,0,0,0
2025-03-17 12:00,86,42,44,0,0,0
2025-03-17 12:15,100,41,59,0,0,0
2025-03-17 12:30,104,34,70,0,0,0
2025-03-17 12:45,130,50,80,0,0,0
2025-03-17 13:00,134,40,94,0,0,0
2025-03-17 13:15,132,33,99,0,0,0
2025-03-17 13:30,94,41,53,0,0,0
2025-03-17 13:45,138,68,70,0,0,0
2025-03-17 14:00,134,62,72,0,0,0
2025-03-17 14:15,124,72,52,0,0,0
2025-03-17 14:30,118,61,57,0,0,0
2025-03-17 14:45,141,72,69,0,0,0
2025-03-17 15:00,122,64,58,0,0,0
2025-03-17 15:15,136,73,63,0,0,0
2025-03-17 15:30,162,67,95,0,0,0
2025-03-17 15:45,156,74,82,0,0,0
2025-03-17 16:00,144,73,71,0,0,0
2025-03-17 16:15,140,75,65,0,0,0
2025-03-17 16:30,126,59,67,0,0,0
2025-03-17 16:45,169,71,98,0,0,0
2025-03-17 17:00,166,84,82,0,0,0
2025-03-17 17:15,149,76,73,0,0,0
2025-03-17 17:30,130,56,74,0,0,0
2025-03-17 17:45,137,57,80,0,0,0
2025-03-17 18:00,110,46,64,0,0,0
2025-03-17 18:15,114,50,64,0,0,0
2025-03-17 18:30,93,44,49,0,0,0
2025-03-17 18:45,98,55,43,0,0,0
2025-03-17 19:00,81,32,49,0,0,0
2025-03-17 19:15,47,17,30,0,0,0
2025-03-17 19:30,62,27,35,0,0,0
2025-03-17 19:45,77,23,54,0,0,0
2025-03-17 20:00,47,23,24,0,0,0
2025-03-17 20:15,54,26,28,0,0,0
2025-03-17 20:30,39,4,35,0,0,0
2025-03-17 20:45,31,12,19,0,0,0
2025-03-17 21:00,45,17,28,0,0,0
2025-03-17 21:15,30,13,17,0,0,0
2025-03-17 21:30,28,10,18,0,0,0
2025-03-17 21:45,28,2,26,0,0,0
2025-03-17 22:00,27,12,15,0,0,0
2025-03-17 22:15,23,6,17,0,0,0
2025-03-17 22:30,23,8,15,0,0,0
2025-03-17 22:45,23,3,20,0,0,0
2025-03-17 23:00,9,1,8,0,0,0
2025-03-17 23:15,16,3,13,0,0,0
2025-03-17 23:30,14,4,10,0,0,0
2025-03-17 23:45,9,3,6,0,0,0
2025-03-18 00:00,5,3,2,0,0,0
2025-03-18 00:15,3,1,2,0,0,0
2025-03-18 00:30,1,1,0,0,0,0
2025-03-18 00:45,0,0,0,0,0,0
2025-03-18 01:00,1,0,1,0,0,0
2025-03-18 01:15,2,2,0,0,0,0
2025-03-18 01:30,2,1,1,0,0,0
2025-03-18 01:45,3,1,2,0,0,0
2025-03-18 02:00,1,0,1,0,0,0
2025-03-18 02:15,0,0,0,0,0,0
2025-03-18 02:30,0,0,0,0,0,0
2025-03-18 02:45,0,0,0,0,0,0
2025-03-18 03:00,0,0,0,0,0,0
2025-03-18 03:15,1,1,0,0,0,0
2025-03-18 03:30,3,3,0,0,0,0
2025-03-18 03:45,3,1,2,0,0,0
2025-03-18 04:00,1,1,0,0,0,0
2025-03-18 04:15,0,0,0,0,0,0
2025-03-18 04:30,1,1,0,0,0,0
2025-03-18 04:45,0,0,0,0,0,0
2025-03-18 05:00,6,2,4,0,0,0
2025-03-18 05:15,1,0,1,0,0,0
2025-03-18 05:30,19,10,9,0,0,0
2025-03-18 05:45,18,7,11,0,0,0
2025-03-18 06:00,14,5,9,0,0,0
2025-03-18 06:15,34,11,23,0,0,0
2025-03-18 06:30,44,14,30,0,0,0
2025-03-18 06:45,54,26,28,0,0,0
2025-03-18 07:00,86,27,59,0,0,0
2025-03-18 07:15,113,52,61,0,0,0
2025-03-18 07:30,314,216,98,0,0,0
2025-03-18 07:45,241,101,140,0,0,0
2025-03-18 08:00,186,58,128,0,0,0
2025-03-18 08:15,172,80,92,0,0,0
2025-03-18 08:30,134,58,76,0,0,0
2025-03-18 08:45,184,88,96,0,0,0
2025-03-18 09:00,120,53,67,0,0,0
2025-03-18 09:15,106,53,53,0,0,0
2025-03-18 09:30,102,58,44,0,0,0
2025-03-18 09:45,112,67,45,0,0,0
2025-03-18 10:00,88,40,48,0,0,0
2025-03-18 10:15,57,33,24,0,0,0
2025-03-18 10:30,64,39,25,0,0,0
2025-03-18 10:45,87,51,36,0,0,0
2025-03-18 11:00,90,42,48,0,0,0
2025-03-18 11:15,77,39,38,0,0,0
2025-03-18 11:30,65,21,44,0,0,0
2025-03-18 11:45,94,42,52,0,0,0
2025-03-18 12:00,85,46,39,0,0,0
2025-03-18 12:15,123,49,74,0,0,0
2025-03-18 12:30,99,34,65,0,0,0
2025-03-18 12:45,129,47,82,0,0,0
2025-03-18 13:00,169,57,112,0,0,0
2025-03-18 13:15,117,44,73,0,0,0
2025-03-18 13:30,116,52,64,0,0,0
2025-03-18 13:45,118,54,64,0,0,0
2025-03-18 14:00,136,49,87,0,0,0
2025-03-18 14:15,145,66,79,0,0,0
2025-03-18 14:30,116,59,57,0,0,0
2025-03-18 14:45,141,66,75,0,0,0
2025-03-18 15:00,110,44,66,0,0,0
2025-03-18 15:15,176,102,74,0,0,0
2025-03-18 15:30,129,66,63,0,0,0
2025-03-18 15:45,182,103,79,0,0,0
2025-03-18 16:00,170,98,72,0,0,0
2025-03-18 16:15,180,108,72,0,0,0
2025-03-18 16:30,120,60,60,0,0,0
2025-03-18 16:45,157,72,85,0,0,0
2025-03-18 17:00,131,52,79,0,0,0
2025-03-18 17:15,201,90,111,0,0,0
2025-03-18 17:30,157,68,89,0,0,0
2025-03-18 17:45,167,73,94,0,0,0
2025-03-18 18:00,117,54,63,0,0,0
2025-03-18 18:15,116,48,68,0,0,0
2025-03-18 18:30,104,36,68,0,0,0
2025-03-18 18:45,111,41,70,0,0,0
2025-03-18 19:00,68,27,41,0,0,0
2025-03-18 19:15,66,27,39,0,0,0
2025-03-18 19:30,59,18,41,0,0,0
2025-03-18 19:45,81,36,45,0,0,0
2025-03-18 20:00,53,16,37,0,0,0
2025-03-18 20:15,48,14,34,0,0,0
2025-03-18 20:30,41,17,24,0,0,0
2025-03-18 20:45,29,4,25,0,0,0
2025-03-18 21:00,22,11,11,0,0,0
2025-03-18 21:15,39,12,27,0,0,0
2025-03-18 21:30,24,5,19,0,0,0
2025-03-18 21:45,32,7,25,0,0,0
2025-03-18 22:00,27,3,24,0,0,0
2025-03-18 22:15,27,5,22,0,0,0
2025-03-18 22:30,19,1,18,0,0,0
2025-03-18 22:45,26,5,21,0,0,0
2025-03-18 23:00,16,6,10,0,0,0
2025-03-18 23:15,4,3,1,0,0,0
2025-03-18 23:30,3,2,1,0,0,0
2025-03-18 23:45,3,0,3,0,0,0
2025-03-19 00:00,4,2,2,0,0,0
2025-03-19 00:15,4,2,2,0,0,0
2025-03-19 00:30,0,0,0,0,0,0
2025-03-19 00:45,2,0,2,0,0,0
2025-03-19 01:00,2,0,2,0,0,0
2025-03-19 01:15,1,1,0,0,0,0
2025-03-19 01:30,1,0,1,0,0,0
2025-03-19 01:45,1,1,0,0,0,0
2025-03-19 02:00,0,0,0,0,0,0
2025-03-19 02:15,2,0,2,0,0,0
2025-03-19 02:30,2,0,2,0,0,0
2025-03-19 02:45,2,2,0,0,0,0
2025-03-19 03:00,0,0,0,0,0,0
2025-03-19 03:15,1,1,0,0,0,0
2025-03-19 03:30,3,3,0,0,0,0
2025-03-19 03:45,7,2,5,0,0,0
2025-03-19 04:00,2,1,1,0,0,0
2025-03-19 04:15,3,3,0,0,0,0
2025-03-19 04:30,2,1,1,0,0,0
2025-03-19 04:45,0,0,0,0,0,0
2025-03-19 05:00,1,1,0,0,0,0
2025-03-19 05:15,5,3,2,0,0,0
2025-03-19 05:30,19,5,14,0,0,0
2025-03-19 05:45,11,2,9,0,0,0
2025-03-19 06:00,16,10,6,0,0,0
2025-03-19 06:15,23,9,14,0,0,0
2025-03-19 06:30,46,18,28,0,0,0
2025-03-19 06:45,73,35,38,0,0,0
2025-03-19 07:00,81,30,51,0,0,0
2025-03-19 07:15,131,74,57,0,0,0
2025-03-19 07:30,265,171,94,0,0,0
2025-03-19 07:45,283,137,146,0,0,0
2025-03-19 08:00,176,60,116,0,0,0
2025-03-19 08:15,209,85,124,0,0,0
2025-03-19 08:30,138,50,88,0,0,0
2025-03-19 08:45,195,76,119,0,0,0
2025-03-19 09:00,115,48,67,0,0,0
2025-03-19 09:15,108,70,38,0,0,0
2025-03-19 09:30,124,78,46,0,0,0
2025-03-19 09:45,122,66,56,0,0,0
2025-03-19 10:00,94,41,53,0,0,0
2025-03-19 10:15,64,26,38,0,0,0
2025-03-19 10:30,94,50,44,0,0,0
2025-03-19 10:45,98,63,35,0,0,0
2025-03-19 11:00,110,66,44,0,0,0
2025-03-19 11:15,112,48,64,0,0,0
2025-03-19 11:30,120,63,57,0,0,0
2025-03-19 11:45,100,47,53,0,0,0
2025-03-19 12:00,116,60,56,0,0,0
2025-03-19 12:15,154,71,83,0,0,0
2025-03-19 12:30,124,31,93,0,0,0
2025-03-19 12:45,158,55,103,0,0,0
2025-03-19 13:00,153,49,104,0,0,0
2025-03-19 13:15,133,47,86,0,0,0
2025-03-19 13:30,116,53,63,0,0,0
2025-03-19 13:45,119,50,69,0,0,0
2025-03-19 14:00,165,54,111,0,0,0
2025-03-19 14:15,125,59,66,0,0,0
2025-03-19 14:30,110,60,50,0,0,0
2025-03-19 14:45,146,50,96,0,0,0
2025-03-19 15:00,158,75,83,0,0,0
2025-03-19 15:15,156,67,89,0,0,0
2025-03-19 15:30,146,77,69,0,0,0
2025-03-19 15:45,144,78,66,0,0,0
2025-03-19 16:00,166,78,88,0,0,0
2025-03-19 16:15,187,85,102,0,0,0
2025-03-19 16:30,150,80,70,0,0,0
2025-03-19 16:45,186,86,100,0,0,0
2025-03-19 17:00,151,81,70,0,0,0
2025-03-19 17:15,122,54,68,0,0,0
2025-03-19 17:30,170,68,102,0,0,0
2025-03-19 17:45,154,61,93,0,0,0
2025-03-19 18:00,167,64,103,0,0,0
2025-03-19 18:15,146,63,83,0,0,0
2025-03-19 18:30,109,26,83,0,0,0
2025-03-19 18:45,165,69,96,0,0,0
2025-03-19 19:00,81,35,46,0,0,0
2025-03-19 19:15,87,32,55,0,0,0
2025-03-19 19:30,71,29,42,0,0,0
2025-03-19 19:45,74,33,41,0,0,0
2025-03-19 20:00,61,22,39,0,0,0
2025-03-19 20:15,47,14,33,0,0,0
2025-03-19 20:30,40,8,32,0,0,0
2025-03-19 20:45,32,15,17,0,0,0
2025-03-19 21:00,30,11,19,0,0,0
2025-03-19 21:15,50,26,24,0,0,0
2025-03-19 21:30,33,8,25,0,0,0
2025-03-19 21:45,53,6,47,0,0,0
2025-03-19 22:00,43,6,37,0,0,0
2025-03-19 22:15,36,13,23,0,0,0
2025-03-19 22:30,44,8,36,0,0,0
2025-03-19 22:45,22,7,15,0,0,0
2025-03-19 23:00,26,6,20,0,0,0
2025-03-19 23:15,18,3,15,0,0,0
2025-03-19 23:30,18,5,13,0,0,0
2025-03-19 23:45,9,1,8,0,0,0
2025-03-20 00:00,4,0,4,0,0,0
2025-03-20 00:15,10,6,4,0,0,0
2025-03-20 00:30,8,3,5,0,0,0
2025-03-20 00:45,10,0,10,0,0,0
2025-03-20 01:00,2,0,2,0,0,0
2025-03-20 01:15,5,0,5,0,0,0
2025-03-20 01:30,3,1,2,0,0,0
2025-03-20 01:45,1,0,1,0,0,0
2025-03-20 02:00,6,2,4,0,0,0
2025-03-20 02:15,1,1,0,0,0,0
2025-03-20 02:30,5,0,5,0,0,0
2025-03-20 02:45,1,0,1,0,0,0
2025-03-20 03:00,1,1,0,0,0,0
2025-03-20 03:15,2,2,0,0,0,0
2025-03-20 03:30,5,3,2,0,0,0
2025-03-20 03:45,1,1,0,0,0,0
2025-03-20 04:00,3,0,3,0,0,0
2025-03-20 04:15,2,0,2,0,0,0
2025-03-20 04:30,0,0,0,0,0,0
2025-03-20 04:45,1,1,0,0,0,0
2025-03-20 05:00,1,1,0,0,0,0
2025-03-20 05:15,2,1,1,0,0,0
2025-03-20 05:30,17,4,13,0,0,0
2025-03-20 05:45,18,8,10,0,0,0
2025-03-20 06:00,15,2,13,0,0,0
2025-03-20 06:15,25,11,14,0,0,0
2025-03-20 06:30,52,20,32,0,0,0
2025-03-20 06:45,63,25,38,0,0,0
2025-03-20 07:00,82,33,49,0,0,0
2025-03-20 07:15,128,69,59,0,0,0
2025-03-20 07:30,231,164,67,0,0,0
2025-03-20 07:45,241,102,139,0,0,0
2025-03-20 08:00,166,61,105,0,0,0
2025-03-20 08:15,177,71,106,0,0,0
2025-03-20 08:30,134,51,83,0,0,0
2025-03-20 08:45,163,68,95,0,0,0
2025-03-20 09:00,111,47,64,0,0,0
2025-03-20 09:15,94,52,42,0,0,0
2025-03-20 09:30,92,47,45,0,0,0
2025-03-20 09:45,105,38,67,0,0,0
2025-03-20 10:00,60,28,32,0,0,0
2025-03-20 10:15,70,27,43,0,0,0
2025-03-20 10:30,84,34,50,0,0,0
2025-03-20 10:45,81,49,32,0,0,0
2025-03-20 11:00,72,40,32,0,0,0
2025-03-20 11:15,75,40,35,0,0,0
2025-03-20 11:30,93,39,54,0,0,0
2025-03-20 11:45,98,53,45,0,0,0
2025-03-20 12:00,83,34,49,0,0,0
2025-03-20 12:15,149,62,87,0,0,0
2025-03-20 12:30,108,40,68,0,0,0
2025-03-20 12:45,98,31,67,0,0,0
2025-03-20 13:00,137,37,100,0,0,0
2025-03-20 13:15,149,46,103,0,0,0
2025-03-20 13:30,127,58,69,0,0,0
2025-03-20 13:45,147,73,74,0,0,0
2025-03-20 14:00,135,48,87,0,0,0
2025-03-20 14:15,122,56,66,0,0,0
2025-03-20 14:30,124,57,67,0,0,0
2025-03-20 14:45,151,64,87,0,0,0
2025-03-20 15:00,193,82,111,0,0,0
2025-03-20 15:15,142,90,52,0,0,0
2025-03-20 15:30,152,72,80,0,0,0
2025-03-20 15:45,153,80,73,0,0,0
2025-03-20 16:00,156,77,79,0,0,0
2025-03-20 16:15,158,81,77,0,0,0
2025-03-20 16:30,158,83,75,0,0,0
2025-03-20 16:45,167,70,97,0,0,0
2025-03-20 17:00,148,56,92,0,0,0
2025-03-20 17:15,168,63,105,0,0,0
2025-03-20 17:30,164,81,83,0,0,0
2025-03-20 17:45,115,47,68,0,0,0
2025-03-20 18:00,134,58,76,0,0,0
2025-03-20 18:15,132,77,55,0,0,0
2025-03-20 18:30,93,39,54,0,0,0
2025-03-20 18:45,115,64,51,0,0,0
2025-03-20 19:00,100,34,66,0,0,0
2025-03-20 19:15,66,28,38,0,0,0
2025-03-20 19:30,84,36,48,0,0,0
2025-03-20 19:45,67,23,44,0,0,0
2025-03-20 20:00,44,12,32,0,0,0
2025-03-20 20:15,60,29,31,0,0,0
2025-03-20 20:30,66,11,55,0,0,0
2025-03-20 20:45,38,12,26,0,0,0
2025-03-20 21:00,37,14,23,0,0,0
2025-03-20 21:15,39,4,35,0,0,0
2025-03-20 21:30,28,1,27,0,0,0
2025-03-20 21:45,38,11,27,0,0,0
2025-03-20 22:00,36,11,25,0,0,0
2025-03-20 22:15,42,11,31,0,0,0
2025-03-20 22:30,26,4,22,0,0,0
2025-03-20 22:45,28,4,24,0,0,0
2025-03-20 23:00,25,2,23,0,0,0
2025-03-20 23:15,12,7,5,0,0,0
2025-03-20 23:30,8,2,6,0,0,0
2025-03-20 23:45,6,4,2,0,0,0
2025-03-21 00:00,6,1,5,0,0,0
2025-03-21 00:15,6,2,4,0,0,0
2025-03-21 00:30,6,0,6,0,0,0
2025-03-21 00:45,5,0,5,0,0,0
2025-03-21 01:00,0,0,0,0,0,0
2025-03-21 01:15,5,3,2,0,0,0
2025-03-21 01:30,0,0,0,0,0,0
2025-03-21 01:45,2,1,1,0,0,0
2025-03-21 02:00,2,0,2,0,0,0
2025-03-21 02:15,0,0,0,0,0,0
2025-03-21 02:30,3,1,2,0,0,0
2025-03-21 02:45,0,0,0,0,0,0
2025-03-21 03:00,1,0,1,0,0,0
2025-03-21 03:15,2,1,1,0,0,0
2025-03-21 03:30,3,2,1,0,0,0
2025-03-21 03:45,1,0,1,0,0,0
2025-03-21 04:00,1,1,0,0,0,0
2025-03-21 04:15,0,0,0,0,0,0
2025-03-21 04:30,2,2,0,0,0,0
2025-03-21 04:45,3,3,0,0,0,0
2025-03-21 05:00,2,2,0,0,0,0
2025-03-21 05:15,1,1,0,0,0,0
2025-03-21 05:30,19,8,11,0,0,0
2025-03-21 05:45,20,4,16,0,0,0
2025-03-21 06:00,15,7,8,0,0,0
2025-03-21 06:15,14,5,9,0,0,0
2025-03-21 06:30,43,12,31,0,0,0
2025-03-21 06:45,51,17,34,0,0,0
2025-03-21 07:00,65,24,41,0,0,0
2025-03-21 07:15,94,48,46,0,0,0
2025-03-21 07:30,243,169,74,0,0,0
2025-03-21 07:45,235,91,144,0,0,0
2025-03-21 08:00,151,43,108,0,0,0
2025-03-21 08:15,110,39,71,0,0,0
2025-03-21 08:30,121,58,63,0,0,0
2025-03-21 08:45,153,67,86,0,0,0
2025-03-21 09:00,99,43,56,0,0,0
2025-03-21 09:15,74,36,38,0,0,0
2025-03-21 09:30,91,49,42,0,0,0
2025-03-21 09:45,104,40,64,0,0,0
2025-03-21 10:00,63,29,34,0,0,0
2025-03-21 10:15,53,23,30,0,0,0
2025-03-21 10:30,68,32,36,0,0,0
2025-03-21 10:45,76,40,36,0,0,0
2025-03-21 11:00,88,47,41,0,0,0
2025-03-21 11:15,115,66,49,0,0,0
2025-03-21 11:30,116,67,49,0,0,0
2025-03-21 11:45,89,46,43,0,0,0
2025-03-21 12:00,100,56,44,0,0,0
2025-03-21 12:15,119,63,56,0,0,0
2025-03-21 12:30,153,73,80,0,0,0
2025-03-21 12:45,115,53,62,0,0,0
2025-03-21 13:00,180,58,122,0,0,0
2025-03-21 13:15,178,43,135,0,0,0
2025-03-21 13:30,155,66,89,0,0,0
2025-03-21 13:45,143,62,81,0,0,0
2025-03-21 14:00,146,54,92,0,0,0
2025-03-21 14:15,120,65,55,0,0,0
2025-03-21 14:30,122,51,71,0,0,0
2025-03-21 14:45,144,68,76,0,0,0
2025-03-21 15:00,137,68,69,0,0,0
2025-03-21 15:15,142,81,61,0,0,0
2025-03-21 15:30,155,73,82,0,0,0
2025-03-21 15:45,138,81,57,0,0,0
2025-03-21 16:00,162,80,82,0,0,0
2025-03-21 16:15,158,74,84,0,0,0
2025-03-21 16:30,162,65,97,0,0,0
2025-03-21 16:45,133,69,64,0,0,0
2025-03-21 17:00,137,64,73,0,0,0
2025-03-21 17:15,125,64,61,0,0,0
2025-03-21 17:30,107,58,49,0,0,0
2025-03-21 17:45,133,54,79,0,0,0
2025-03-21 18:00,136,51,85,0,0,0
2025-03-21 18:15,118,57,61,0,0,0
2025-03-21 18:30,100,33,67,0,0,0
2025-03-21 18:45,116,44,72,0,0,0
2025-03-21 19:00,89,41,48,0,0,0
2025-03-21 19:15,106,38,68,0,0,0
2025-03-21 19:30,62,26,36,0,0,0
2025-03-21 19:45,47,20,27,0,0,0
2025-03-21 20:00,78,32,46,0,0,0
2025-03-21 20:15,64,14,50,0,0,0
2025-03-21 20:30,58,23,35,0,0,0
2025-03-21 20:45,33,14,19,0,0,0
2025-03-21 21:00,54,13,41,0,0,0
2025-03-21 21:15,42,10,32,0,0,0
2025-03-21 21:30,57,14,43,0,0,0
2025-03-21 21:45,32,10,22,0,0,0
2025-03-21 22:00,30,6,24,0,0,0
2025-03-21 22:15,25,3,22,0,0,0
2025-03-21 22:30,36,8,28,0,0,0
2025-03-21 22:45,26,11,15,0,0,0
2025-03-21 23:00,37,13,24,0,0,0
2025-03-21 23:15,22,5,17,0,0,0
2025-03-21 23:30,30,6,24,0,0,0
2025-03-21 23:45,23,5,18,0,0,0
2025-03-22 00:00,28,6,22,0,0,0
2025-03-22 00:15,16,2,14,0,0,0
2025-03-22 00:30,23,8,15,0,0,0
2025-03-22 00:45,7,3,4,0,0,0
2025-03-22 01:00,18,2,16,0,0,0
2025-03-22 01:15,11,0,11,0,0,0
2025-03-22 01:30,11,1,10,0,0,0
2025-03-22 01:45,5,1,4,0,0,0
2025-03-22 02:00,7,2,5,0,0,0
2025-03-22 02:15,10,0,10,0,0,0
2025-03-22 02:30,1,1,0,0,0,0
2025-03-22 02:45,7,0,7,0,0,0
2025-03-22 03:00,9,0,9,0,0,0
2025-03-22 03:15,2,0,2,0,0,0
2025-03-22 03:30,10,3,7,0,0,0
2025-03-22 03:45,6,2,4,0,0,0
2025-03-22 04:00,4,2,2,0,0,0
2025-03-22 04:15,3,0,3,0,0,0
2025-03-22 04:30,7,2,5,0,0,0
2025-03-22 04:45,1,0,1,0,0,0
2025-03-22 05:00,2,2,0,0,0,0
2025-03-22 05:15,2,0,2,0,0,0
2025-03-22 05:30,7,3,4,0,0,0
2025-03-22 05:45,14,1,13,0,0,0
2025-03-22 06:00,10,7,3,0,0,0
2025-03-22 06:15,7,3,4,0,0,0
2025-03-22 06:30,12,8,4,0,0,0
2025-03-22 06:45,12,8,4,0,0,0
2025-03-22 07:00,11,11,0,0,0,0
2025-03-22 07:15,11,6,5,0,0,0
2025-03-22 07:30,27,17,10,0,0,0
2025-03-22 07:45,31,17,14,0,0,0
2025-03-22 08:00,20,11,9,0,0,0
2025-03-22 08:15,39,28,11,0,0,0
2025-03-22 08:30,44,30,14,0,0,0
2025-03-22 08:45,54,42,12,0,0,0
2025-03-22 09:00,50,37,13,0,0,0
2025-03-22 09:15,58,27,31,0,0,0
2025-03-22 09:30,65,45,20,0,0,0
2025-03-22 09:45,124,87,37,0,0,0
2025-03-22 10:00,64,45,19,0,0,0
2025-03-22 10:15,96,65,31,0,0,0
2025-03-22 10:30,109,76,33,0,0,0
2025-03-22 10:45,126,83,43,0,0,0
2025-03-22 11:00,77,41,36,0,0,0
2025-03-22 11:15,108,75,33,0,0,0
2025-03-22 11:30,121,78,43,0,0,0
2025-03-22 11:45,114,70,44,0,0,0
2025-03-22 12:00,128,58,70,0,0,0
2025-03-22 12:15,141,64,77,0,0,0
2025-03-22 12:30,136,66,70,0,0,0
2025-03-22 12:45,118,55,63,0,0,0
2025-03-22 13:00,123,41,82,0,0,0
2025-03-22 13:15,116,43,73,0,0,0
2025-03-22 13:30,100,41,59,0,0,0
2025-03-22 13:45,141,60,81,0,0,0
2025-03-22 14:00,110,35,75,0,0,0
2025-03-22 14:15,130,45,85,0,0,0
2025-03-22 14:30,162,51,111,0,0,0
2025-03-22 14:45,127,61,66,0,0,0
2025-03-22 15:00,111,39,72,0,0,0
2025-03-22 15:15,112,39,73,0,0,0
2025-03-22 15:30,101,45,56,0,0,0
2025-03-22 15:45,91,27,64,0,0,0
2025-03-22 16:00,97,26,71,0,0,0
2025-03-22 16:15,107,27,80,0,0,0
2025-03-22 16:30,81,34,47,0,0,0
2025-03-22 16:45,72,22,50,0,0,0
2025-03-22 17:00,96,34,62,0,0,0
2025-03-22 17:15,93,40,53,0,0,0
2025-03-22 17:30,93,36,57,0,0,0
2025-03-22 17:45,95,47,48,0,0,0
2025-03-22 18:00,56,23,33,0,0,0
2025-03-22 18:15,78,29,49,0,0,0
2025-03-22 18:30,68,27,41,0,0,0
2025-03-22 18:45,74,43,31,0,0,0
2025-03-22 19:00,52,24,28,0,0,0
2025-03-22 19:15,55,23,32,0,0,0
2025-03-22 19:30,60,32,28,0,0,0
2025-03-22 19:45,47,13,34,0,0,0
2025-03-22 20:00,37,13,24,0,0,0
2025-03-22 20:15,66,20,46,0,0,0
2025-03-22 20:30,50,20,30,0,0,0
2025-03-22 20:45,31,16,15,0,0,0
2025-03-22 21:00,35,16,19,0,0,0
2025-03-22 21:15,31,9,22,0,0,0
2025-03-22 21:30,34,9,25,0,0,0
2025-03-22 21:45,20,1,19,0,0,0
2025-03-22 22:00,24,6,18,0,0,0
2025-03-22 22:15,20,3,17,0,0,0
2025-03-22 22:30,27,12,15,0,0,0
2025-03-22 22:45,26,5,21,0,0,0
2025-03-22 23:00,21,3,18,0,0,0
2025-03-22 23:15,17,3,14,0,0,0
2025-03-22 23:30,14,5,9,0,0,0
2025-03-22 23:45,19,5,14,0,0,0
2025-03-23 00:00,26,6,20,0,0,0
2025-03-23 00:15,21,9,12,0,0,0
2025-03-23 00:30,19,8,11,0,0,0
2025-03-23 00:45,15,2,13,0,0,0
2025-03-23 01:00,8,0,8,0,0,0
2025-03-23 01:15,9,2,7,0,0,0
2025-03-23 01:30,6,0,6,0,0,0
2025-03-23 01:45,11,5,6,0,0,0
2025-03-23 02:00,10,1,9,0,0,0
2025-03-23 02:15,8,2,6,0,0,0
2025-03-23 02:30,3,1,2,0,0,0
2025-03-23 02:45,10,0,10,0,0,0
2025-03-23 03:00,3,2,1,0,0,0
2025-03-23 03:15,10,2,8,0,0,0
2025-03-23 03:30,3,0,3,0,0,0
2025-03-23 03:45,5,0,5,0,0,0
2025-03-23 04:00,1,0,1,0,0,0
2025-03-23 04:15,3,0,3,0,0,0
2025-03-23 04:30,4,0,4,0,0,0
2025-03-23 04:45,1,1,0,0,0,0
2025-03-23 05:00,3,3,0,0,0,0
2025-03-23 05:15,0,0,0,0,0,0
2025-03-23 05:30,7,1,6,0,0,0
2025-03-23 05:45,20,0,20,0,0,0
2025-03-23 06:00,3,1,2,0,0,0
2025-03-23 06:15,5,4,1,0,0,0
2025-03-23 06:30,4,3,1,0,0,0
2025-03-23 06:45,6,3,3,0,0,0
2025-03-23 07:00,2,1,1,0,0,0
2025-03-23 07:15,7,5,2,0,0,0
2025-03-23 07:30,11,3,8,0,0,0
2025-03-23 07:45,5,2,3,0,0,0
2025-03-23 08:00,4,3,1,0,0,0
2025-03-23 08:15,7,3,4,0,0,0
2025-03-23 08:30,6,4,2,0,0,0
2025-03-23 08:45,12,9,3,0,0,0
2025-03-23 09:00,16,9,7,0,0,0
2025-03-23 09:15,14,9,5,0,0,0
2025-03-23 09:30,23,10,13,0,0,0
2025-03-23 09:45,32,25,7,0,0,0
2025-03-23 10:00,28,19,9,0,0,0
2025-03-23 10:15,30,23,7,0,0,0
2025-03-23 10:30,22,17,5,0,0,0
2025-03-23 10:45,32,24,8,0,0,0
2025-03-23 11:00,18,12,6,0,0,0
2025-03-23 11:15,44,22,22,0,0,0
2025-03-23 11:30,35,18,17,0,0,0
2025-03-23 11:45,45,22,23,0,0,0
2025-03-23 12:00,41,24,17,0,0,0
2025-03-23 12:15,46,27,19,0,0,0
2025-03-23 12:30,50,19,31,0,0,0
2025-03-23 12:45,39,21,18,0,0,0
2025-03-23 13:00,75,28,47,0,0,0
2025-03-23 13:15,53,21,32,0,0,0
2025-03-23 13:30,52,18,34,0,0,0
2025-03-23 13:45,65,27,38,0,0,0
2025-03-23 14:00,69,24,45,0,0,0
2025-03-23 14:15,57,35,22,0,0,0
2025-03-23 14:30,71,28,43,0,0,0
2025-03-23 14:45,80,52,28,0,0,0
2025-03-23 15:00,70,28,42,0,0,0
2025-03-23 15:15,74,41,33,0,0,0
2025-03-23 15:30,64,30,34,0,0,0
2025-03-23 15:45,78,32,46,0,0,0
2025-03-23 16:00,72,29,43,0,0,0
2025-03-23 16:15,59,35,24,0,0,0
2025-03-23 16:30,63,32,31,0,0,0
2025-03-23 16:45,85,48,37,0,0,0
2025-03-23 17:00,85,19,66,0,0,0
2025-03-23 17:15,73,31,42,0,0,0
2025-03-23 17:30,87,38,49,0,0,0
2025-03-23 17:45,101,35,66,0,0,0
2025-03-23 18:00,46,18,28,0,0,0
2025-03-23 18:15,45,24,21,0,0,0
2025-03-23 18:30,54,31,23,0,0,0
2025-03-23 18:45,53,16,37,0,0,0
2025-03-23 19:00,48,11,37,0,0,0
2025-03-23 19:15,51,12,39,0,0,0
2025-03-23 19:30,40,12,28,0,0,0
2025-03-23 19:45,35,10,25,0,0,0
2025-03-23 20:00,36,4,32,0,0,0
2025-03-23 20:15,36,7,29,0,0,0
2025-03-23 20:30,21,3,18,0,0,0
2025-03-23 20:45,20,3,17,0,0,0
2025-03-23 21:00,29,10,19,0,0,0
2025-03-23 21:15,23,6,17,0,0,0
2025-03-23 21:30,29,15,14,0,0,0
2025-03-23 21:45,31,5,26,0,0,0
2025-03-23 22:00,29,4,25,0,0,0
2025-03-23 22:15,10,5,5,0,0,0
2025-03-23 22:30,9,1,8,0,0,0
2025-03-23 22:45,8,1,7,0,0,0
2025-03-23 23:00,10,2,8,0,0,0
2025-03-23 23:15,5,0,5,0,0,0
2025-03-23 23:30,5,0,5,0,0,0
2025-03-23 23:45,0,0,0,0,0,0
