Datetime,100020113 (Wolbecker Straße),101020113 (FR stdteinwärts),102020113 (FR stadtauswärts),100020113-status,101020113-status,102020113-status
2024-07-01 00:00,13,6,7,0,0,0
2024-07-01 00:15,6,3,3,0,0,0
2024-07-01 00:30,6,3,3,0,0,0
2024-07-01 00:45,7,2,5,0,0,0
2024-07-01 01:00,3,2,1,0,0,0
2024-07-01 01:15,4,4,0,0,0,0
2024-07-01 01:30,2,0,2,0,0,0
2024-07-01 01:45,1,1,0,0,0,0
2024-07-01 02:00,1,1,0,0,0,0
2024-07-01 02:15,0,0,0,0,0,0
2024-07-01 02:30,1,0,1,0,0,0
2024-07-01 02:45,1,0,1,0,0,0
2024-07-01 03:00,0,0,0,0,0,0
2024-07-01 03:15,0,0,0,0,0,0
2024-07-01 03:30,2,1,1,0,0,0
2024-07-01 03:45,2,0,2,0,0,0
2024-07-01 04:00,4,1,3,0,0,0
2024-07-01 04:15,1,1,0,0,0,0
2024-07-01 04:30,5,1,4,0,0,0
2024-07-01 04:45,9,2,7,0,0,0
2024-07-01 05:00,10,9,1,0,0,0
2024-07-01 05:15,10,7,3,0,0,0
2024-07-01 05:30,17,8,9,0,0,0
2024-07-01 05:45,20,9,11,0,0,0
2024-07-01 06:00,22,8,14,0,0,0
2024-07-01 06:15,46,21,25,0,0,0
2024-07-01 06:30,62,23,39,0,0,0
2024-07-01 06:45,89,36,53,0,0,0
2024-07-01 07:00,99,38,61,0,0,0
2024-07-01 07:15,174,54,120,0,0,0
2024-07-01 07:30,262,69,193,0,0,0
2024-07-01 07:45,297,87,210,0,0,0
2024-07-01 08:00,221,63,158,0,0,0
2024-07-01 08:15,226,63,163,0,0,0
2024-07-01 08:30,206,48,158,0,0,0
2024-07-01 08:45,193,51,142,0,0,0
2024-07-01 09:00,152,56,96,0,0,0
2024-07-01 09:15,124,35,89,0,0,0
2024-07-01 09:30,119,30,89,0,0,0
2024-07-01 09:45,185,53,132,0,0,0
2024-07-01 10:00,149,52,97,0,0,0
2024-07-01 10:15,137,35,102,0,0,0
2024-07-01 10:30,136,53,83,0,0,0
2024-07-01 10:45,150,46,104,0,0,0
2024-07-01 11:00,135,46,89,0,0,0
2024-07-01 11:15,120,56,64,0,0,0
2024-07-01 11:30,153,64,89,0,0,0
2024-07-01 11:45,205,85,120,0,0,0
2024-07-01 12:00,173,74,99,0,0,0
2024-07-01 12:15,158,78,80,0,0,0
2024-07-01 12:30,135,76,59,0,0,0
2024-07-01 12:45,165,74,91,0,0,0
2024-07-01 13:00,170,105,65,0,0,0
2024-07-01 13:15,151,64,87,0,0,0
2024-07-01 13:30,157,68,89,0,0,0
2024-07-01 13:45,206,96,110,0,0,0
2024-07-01 14:00,205,120,85,0,0,0
2024-07-01 14:15,119,70,49,0,0,0
2024-07-01 14:30,117,62,55,0,0,0
2024-07-01 14:45,177,86,91,0,0,0
2024-07-01 15:00,134,73,61,0,0,0
2024-07-01 15:15,101,55,46,0,0,0
2024-07-01 15:30,161,88,73,0,0,0
2024-07-01 15:45,232,133,99,0,0,0
2024-07-01 16:00,215,128,87,0,0,0
2024-07-01 16:15,213,108,105,0,0,0
2024-07-01 16:30,203,122,81,0,0,0
2024-07-01 16:45,195,112,83,0,0,0
2024-07-01 17:00,236,130,106,0,0,0
2024-07-01 17:15,237,130,107,0,0,0
2024-07-01 17:30,143,93,50,0,0,0
2024-07-01 17:45,208,118,90,0,0,0
2024-07-01 18:00,242,137,105,0,0,0
2024-07-01 18:15,211,122,89,0,0,0
2024-07-01 18:30,160,83,77,0,0,0
2024-07-01 18:45,177,104,73,0,0,0
2024-07-01 19:00,136,79,57,0,0,0
2024-07-01 19:15,125,73,52,0,0,0
2024-07-01 19:30,99,53,46,0,0,0
2024-07-01 19:45,127,63,64,0,0,0
2024-07-01 20:00,108,61,47,0,0,0
2024-07-01 20:15,88,44,44,0,0,0
2024-07-01 20:30,82,53,29,0,0,0
2024-07-01 20:45,60,39,21,0,0,0
2024-07-01 21:00,76,38,38,0,0,0
2024-07-01 21:15,66,30,36,0,0,0
2024-07-01 21:30,59,31,28,0,0,0
2024-07-01 21:45,56,33,23,0,0,0
2024-07-01 22:00,52,32,20,0,0,0
2024-07-01 22:15,60,31,29,0,0,0
2024-07-01 22:30,46,21,25,0,0,0
2024-07-01 22:45,40,20,20,0,0,0
2024-07-01 23:00,35,13,22,0,0,0
2024-07-01 23:15,21,9,12,0,0,0
2024-07-01 23:30,13,5,8,0,0,0
2024-07-01 23:45,33,18,15,0,0,0
2024-07-02 00:00,28,16,12,0,0,0
2024-07-02 00:15,21,11,10,0,0,0
2024-07-02 00:30,12,5,7,0,0,0
2024-07-02 00:45,8,4,4,0,0,0
2024-07-02 01:00,5,2,3,0,0,0
2024-07-02 01:15,4,4,0,0,0,0
2024-07-02 01:30,3,0,3,0,0,0
2024-07-02 01:45,4,3,1,0,0,0
2024-07-02 02:00,1,1,0,0,0,0
2024-07-02 02:15,4,2,2,0,0,0
2024-07-02 02:30,1,0,1,0,0,0
2024-07-02 02:45,5,2,3,0,0,0
2024-07-02 03:00,2,0,2,0,0,0
2024-07-02 03:15,3,1,2,0,0,0
2024-07-02 03:30,3,0,3,0,0,0
2024-07-02 03:45,4,0,4,0,0,0
2024-07-02 04:00,1,1,0,0,0,0
2024-07-02 04:15,3,2,1,0,0,0
2024-07-02 04:30,3,2,1,0,0,0
2024-07-02 04:45,13,4,9,0,0,0
2024-07-02 05:00,5,5,0,0,0,0
2024-07-02 05:15,13,8,5,0,0,0
2024-07-02 05:30,9,2,7,0,0,0
2024-07-02 05:45,38,12,26,0,0,0
2024-07-02 06:00,18,8,10,0,0,0
2024-07-02 06:15,43,13,30,0,0,0
2024-07-02 06:30,62,27,35,0,0,0
2024-07-02 06:45,88,32,56,0,0,0
2024-07-02 07:00,98,40,58,0,0,0
2024-07-02 07:15,170,46,124,0,0,0
2024-07-02 07:30,261,63,198,0,0,0
2024-07-02 07:45,300,89,211,0,0,0
2024-07-02 08:00,225,59,166,0,0,0
2024-07-02 08:15,213,54,159,0,0,0
2024-07-02 08:30,208,57,151,0,0,0
2024-07-02 08:45,236,79,157,0,0,0
2024-07-02 09:00,136,34,102,0,0,0
2024-07-02 09:15,105,30,75,0,0,0
2024-07-02 09:30,174,55,119,0,0,0
2024-07-02 09:45,167,48,119,0,0,0
2024-07-02 10:00,190,56,134,0,0,0
2024-07-02 10:15,126,53,73,0,0,0
2024-07-02 10:30,86,30,56,0,0,0
2024-07-02 10:45,72,27,45,0,0,0
2024-07-02 11:00,68,26,42,0,0,0
2024-07-02 11:15,84,34,50,0,0,0
2024-07-02 11:30,102,41,61,0,0,0
2024-07-02 11:45,144,72,72,0,0,0
2024-07-02 12:00,138,85,53,0,0,0
2024-07-02 12:15,98,52,46,0,0,0
2024-07-02 12:30,115,65,50,0,0,0
2024-07-02 12:45,132,70,62,0,0,0
2024-07-02 13:00,145,84,61,0,0,0
2024-07-02 13:15,119,62,57,0,0,0
2024-07-02 13:30,139,59,80,0,0,0
2024-07-02 13:45,189,95,94,0,0,0
2024-07-02 14:00,164,90,74,0,0,0
2024-07-02 14:15,138,68,70,0,0,0
2024-07-02 14:30,147,74,73,0,0,0
2024-07-02 14:45,169,70,99,0,0,0
2024-07-02 15:00,153,79,74,0,0,0
2024-07-02 15:15,153,79,74,0,0,0
2024-07-02 15:30,198,119,79,0,0,0
2024-07-02 15:45,228,108,120,0,0,0
2024-07-02 16:00,178,92,86,0,0,0
2024-07-02 16:15,233,129,104,0,0,0
2024-07-02 16:30,224,105,119,0,0,0
2024-07-02 16:45,215,106,109,0,0,0
2024-07-02 17:00,236,113,123,0,0,0
2024-07-02 17:15,227,119,108,0,0,0
2024-07-02 17:30,211,107,104,0,0,0
2024-07-02 17:45,269,131,138,0,0,0
2024-07-02 18:00,251,147,104,0,0,0
2024-07-02 18:15,196,117,79,0,0,0
2024-07-02 18:30,205,96,109,0,0,0
2024-07-02 18:45,187,100,87,0,0,0
2024-07-02 19:00,183,101,82,0,0,0
2024-07-02 19:15,190,110,80,0,0,0
2024-07-02 19:30,143,90,53,0,0,0
2024-07-02 19:45,164,97,67,0,0,0
2024-07-02 20:00,134,76,58,0,0,0
2024-07-02 20:15,98,49,49,0,0,0
2024-07-02 20:30,120,75,45,0,0,0
2024-07-02 20:45,85,50,35,0,0,0
2024-07-02 21:00,90,44,46,0,0,0
2024-07-02 21:15,86,45,41,0,0,0
2024-07-02 21:30,78,33,45,0,0,0
2024-07-02 21:45,84,39,45,0,0,0
2024-07-02 22:00,92,52,40,0,0,0
2024-07-02 22:15,89,48,41,0,0,0
2024-07-02 22:30,70,35,35,0,0,0
2024-07-02 22:45,39,23,16,0,0,0
2024-07-02 23:00,45,28,17,0,0,0
2024-07-02 23:15,42,21,21,0,0,0
2024-07-02 23:30,29,13,16,0,0,0
2024-07-02 23:45,17,14,3,0,0,0
2024-07-03 00:00,36,16,20,0,0,0
2024-07-03 00:15,15,6,9,0,0,0
2024-07-03 00:30,11,6,5,0,0,0
2024-07-03 00:45,7,4,3,0,0,0
2024-07-03 01:00,5,4,1,0,0,0
2024-07-03 01:15,7,5,2,0,0,0
2024-07-03 01:30,3,0,3,0,0,0
2024-07-03 01:45,2,2,0,0,0,0
2024-07-03 02:00,8,5,3,0,0,0
2024-07-03 02:15,1,1,0,0,0,0
2024-07-03 02:30,1,0,1,0,0,0
2024-07-03 02:45,1,1,0,0,0,0
2024-07-03 03:00,4,2,2,0,0,0
2024-07-03 03:15,1,1,0,0,0,0
2024-07-03 03:30,1,1,0,0,0,0
2024-07-03 03:45,1,0,1,0,0,0
2024-07-03 04:00,1,0,1,0,0,0
2024-07-03 04:15,0,0,0,0,0,0
2024-07-03 04:30,7,2,5,0,0,0
2024-07-03 04:45,11,6,5,0,0,0
2024-07-03 05:00,5,4,1,0,0,0
2024-07-03 05:15,7,3,4,0,0,0
2024-07-03 05:30,13,5,8,0,0,0
2024-07-03 05:45,44,14,30,0,0,0
2024-07-03 06:00,16,8,8,0,0,0
2024-07-03 06:15,60,19,41,0,0,0
2024-07-03 06:30,51,20,31,0,0,0
2024-07-03 06:45,74,32,42,0,0,0
2024-07-03 07:00,93,43,50,0,0,0
2024-07-03 07:15,199,64,135,0,0,0
2024-07-03 07:30,266,67,199,0,0,0
2024-07-03 07:45,289,69,220,0,0,0
2024-07-03 08:00,256,74,182,0,0,0
2024-07-03 08:15,232,67,165,0,0,0
2024-07-03 08:30,264,67,197,0,0,0
2024-07-03 08:45,238,71,167,0,0,0
2024-07-03 09:00,171,48,123,0,0,0
2024-07-03 09:15,155,48,107,0,0,0
2024-07-03 09:30,149,37,112,0,0,0
2024-07-03 09:45,226,56,170,0,0,0
2024-07-03 10:00,201,55,146,0,0,0
2024-07-03 10:15,160,58,102,0,0,0
2024-07-03 10:30,133,58,75,0,0,0
2024-07-03 10:45,155,70,85,0,0,0
2024-07-03 11:00,119,53,66,0,0,0
2024-07-03 11:15,162,68,94,0,0,0
2024-07-03 11:30,172,75,97,0,0,0
2024-07-03 11:45,175,68,107,0,0,0
2024-07-03 12:00,194,78,116,0,0,0
2024-07-03 12:15,195,96,99,0,0,0
2024-07-03 12:30,202,110,92,0,0,0
2024-07-03 12:45,196,101,95,0,0,0
2024-07-03 13:00,166,93,73,0,0,0
2024-07-03 13:15,153,98,55,0,0,0
2024-07-03 13:30,170,88,82,0,0,0
2024-07-03 13:45,175,95,80,0,0,0
2024-07-03 14:00,168,107,61,0,0,0
2024-07-03 14:15,161,90,71,0,0,0
2024-07-03 14:30,125,76,49,0,0,0
2024-07-03 14:45,125,69,56,0,0,0
2024-07-03 15:00,123,68,55,0,0,0
2024-07-03 15:15,142,82,60,0,0,0
2024-07-03 15:30,155,74,81,0,0,0
2024-07-03 15:45,183,85,98,0,0,0
2024-07-03 16:00,200,107,93,0,0,0
2024-07-03 16:15,187,111,76,0,0,0
2024-07-03 16:30,194,112,82,0,0,0
2024-07-03 16:45,182,91,91,0,0,0
2024-07-03 17:00,179,95,84,0,0,0
2024-07-03 17:15,212,107,105,0,0,0
2024-07-03 17:30,224,131,93,0,0,0
2024-07-03 17:45,234,144,90,0,0,0
2024-07-03 18:00,228,136,92,0,0,0
2024-07-03 18:15,189,111,78,0,0,0
2024-07-03 18:30,193,119,74,0,0,0
2024-07-03 18:45,204,112,92,0,0,0
2024-07-03 19:00,165,94,71,0,0,0
2024-07-03 19:15,151,74,77,0,0,0
2024-07-03 19:30,142,83,59,0,0,0
2024-07-03 19:45,129,74,55,0,0,0
2024-07-03 20:00,148,78,70,0,0,0
2024-07-03 20:15,108,57,51,0,0,0
2024-07-03 20:30,116,68,48,0,0,0
2024-07-03 20:45,98,52,46,0,0,0
2024-07-03 21:00,83,52,31,0,0,0
2024-07-03 21:15,81,42,39,0,0,0
2024-07-03 21:30,114,69,45,0,0,0
2024-07-03 21:45,87,50,37,0,0,0
2024-07-03 22:00,76,39,37,0,0,0
2024-07-03 22:15,85,39,46,0,0,0
2024-07-03 22:30,63,32,31,0,0,0
2024-07-03 22:45,60,31,29,0,0,0
2024-07-03 23:00,47,26,21,0,0,0
2024-07-03 23:15,41,22,19,0,0,0
2024-07-03 23:30,46,21,25,0,0,0
2024-07-03 23:45,31,16,15,0,0,0
2024-07-04 00:00,45,20,25,0,0,0
2024-07-04 00:15,19,10,9,0,0,0
2024-07-04 00:30,25,14,11,0,0,0
2024-07-04 00:45,24,12,12,0,0,0
2024-07-04 01:00,9,5,4,0,0,0
2024-07-04 01:15,22,7,15,0,0,0
2024-07-04 01:30,23,12,11,0,0,0
2024-07-04 01:45,15,4,11,0,0,0
2024-07-04 02:00,10,6,4,0,0,0
2024-07-04 02:15,15,8,7,0,0,0
2024-07-04 02:30,7,3,4,0,0,0
2024-07-04 02:45,7,2,5,0,0,0
2024-07-04 03:00,4,3,1,0,0,0
2024-07-04 03:15,5,1,4,0,0,0
2024-07-04 03:30,3,3,0,0,0,0
2024-07-04 03:45,3,1,2,0,0,0
2024-07-04 04:00,2,1,1,0,0,0
2024-07-04 04:15,4,2,2,0,0,0
2024-07-04 04:30,10,6,4,0,0,0
2024-07-04 04:45,11,4,7,0,0,0
2024-07-04 05:00,7,6,1,0,0,0
2024-07-04 05:15,8,5,3,0,0,0
2024-07-04 05:30,15,8,7,0,0,0
2024-07-04 05:45,31,9,22,0,0,0
2024-07-04 06:00,17,8,9,0,0,0
2024-07-04 06:15,40,13,27,0,0,0
2024-07-04 06:30,54,18,36,0,0,0
2024-07-04 06:45,80,36,44,0,0,0
2024-07-04 07:00,88,29,59,0,0,0
2024-07-04 07:15,128,44,84,0,0,0
2024-07-04 07:30,216,56,160,0,0,0
2024-07-04 07:45,261,80,181,0,0,0
2024-07-04 08:00,220,62,158,0,0,0
2024-07-04 08:15,178,55,123,0,0,0
2024-07-04 08:30,184,51,133,0,0,0
2024-07-04 08:45,205,53,152,0,0,0
2024-07-04 09:00,132,35,97,0,0,0
2024-07-04 09:15,125,28,97,0,0,0
2024-07-04 09:30,103,29,74,0,0,0
2024-07-04 09:45,155,41,114,0,0,0
2024-07-04 10:00,149,53,96,0,0,0
2024-07-04 10:15,104,36,68,0,0,0
2024-07-04 10:30,86,36,50,0,0,0
2024-07-04 10:45,124,47,77,0,0,0
2024-07-04 11:00,134,48,86,0,0,0
2024-07-04 11:15,123,49,74,0,0,0
2024-07-04 11:30,100,42,58,0,0,0
2024-07-04 11:45,144,69,75,0,0,0
2024-07-04 12:00,141,57,84,0,0,0
2024-07-04 12:15,182,92,90,0,0,0
2024-07-04 12:30,160,73,87,0,0,0
2024-07-04 12:45,159,79,80,0,0,0
2024-07-04 13:00,197,94,103,0,0,0
2024-07-04 13:15,152,77,75,0,0,0
2024-07-04 13:30,149,62,87,0,0,0
2024-07-04 13:45,183,82,101,0,0,0
2024-07-04 14:00,204,98,106,0,0,0
2024-07-04 14:15,146,78,68,0,0,0
2024-07-04 14:30,172,77,95,0,0,0
2024-07-04 14:45,173,82,91,0,0,0
2024-07-04 15:00,184,77,107,0,0,0
2024-07-04 15:15,206,102,104,0,0,0
2024-07-04 15:30,200,97,103,0,0,0
2024-07-04 15:45,223,119,104,0,0,0
2024-07-04 16:00,223,126,97,0,0,0
2024-07-04 16:15,227,140,87,0,0,0
2024-07-04 16:30,221,93,128,0,0,0
2024-07-04 16:45,239,126,113,0,0,0
2024-07-04 17:00,226,115,111,0,0,0
2024-07-04 17:15,287,149,138,0,0,0
2024-07-04 17:30,243,131,112,0,0,0
2024-07-04 17:45,302,181,121,0,0,0
2024-07-04 18:00,220,130,90,0,0,0
2024-07-04 18:15,244,146,98,0,0,0
2024-07-04 18:30,220,112,108,0,0,0
2024-07-04 18:45,211,109,102,0,0,0
2024-07-04 19:00,196,106,90,0,0,0
2024-07-04 19:15,160,83,77,0,0,0
2024-07-04 19:30,157,90,67,0,0,0
2024-07-04 19:45,152,82,70,0,0,0
2024-07-04 20:00,139,68,71,0,0,0
2024-07-04 20:15,129,67,62,0,0,0
2024-07-04 20:30,129,76,53,0,0,0
2024-07-04 20:45,85,46,39,0,0,0
2024-07-04 21:00,82,55,27,0,0,0
2024-07-04 21:15,82,53,29,0,0,0
2024-07-04 21:30,97,55,42,0,0,0
2024-07-04 21:45,105,62,43,0,0,0
2024-07-04 22:00,104,46,58,0,0,0
2024-07-04 22:15,80,35,45,0,0,0
2024-07-04 22:30,52,23,29,0,0,0
2024-07-04 22:45,68,34,34,0,0,0
2024-07-04 23:00,61,28,33,0,0,0
2024-07-04 23:15,46,36,10,0,0,0
2024-07-04 23:30,43,21,22,0,0,0
2024-07-04 23:45,42,21,21,0,0,0
2024-07-05 00:00,37,21,16,0,0,0
2024-07-05 00:15,35,16,19,0,0,0
2024-07-05 00:30,15,8,7,0,0,0
2024-07-05 00:45,28,15,13,0,0,0
2024-07-05 01:00,15,7,8,0,0,0
2024-07-05 01:15,12,10,2,0,0,0
2024-07-05 01:30,13,9,4,0,0,0
2024-07-05 01:45,8,3,5,0,0,0
2024-07-05 02:00,8,4,4,0,0,0
2024-07-05 02:15,8,6,2,0,0,0
2024-07-05 02:30,3,3,0,0,0,0
2024-07-05 02:45,2,1,1,0,0,0
2024-07-05 03:00,3,2,1,0,0,0
2024-07-05 03:15,2,2,0,0,0,0
2024-07-05 03:30,1,1,0,0,0,0
2024-07-05 03:45,1,0,1,0,0,0
2024-07-05 04:00,5,2,3,0,0,0
2024-07-05 04:15,3,1,2,0,0,0
2024-07-05 04:30,2,1,1,0,0,0
2024-07-05 04:45,6,2,4,0,0,0
2024-07-05 05:00,6,5,1,0,0,0
2024-07-05 05:15,9,6,3,0,0,0
2024-07-05 05:30,11,2,9,0,0,0
2024-07-05 05:45,32,12,20,0,0,0
2024-07-05 06:00,10,6,4,0,0,0
2024-07-05 06:15,37,16,21,0,0,0
2024-07-05 06:30,55,24,31,0,0,0
2024-07-05 06:45,75,30,45,0,0,0
2024-07-05 07:00,84,30,54,0,0,0
2024-07-05 07:15,147,47,100,0,0,0
2024-07-05 07:30,242,51,191,0,0,0
2024-07-05 07:45,261,82,179,0,0,0
2024-07-05 08:00,162,47,115,0,0,0
2024-07-05 08:15,187,50,137,0,0,0
2024-07-05 08:30,200,50,150,0,0,0
2024-07-05 08:45,201,45,156,0,0,0
2024-07-05 09:00,142,47,95,0,0,0
2024-07-05 09:15,138,46,92,0,0,0
2024-07-05 09:30,127,28,99,0,0,0
2024-07-05 09:45,181,47,134,0,0,0
2024-07-05 10:00,140,35,105,0,0,0
2024-07-05 10:15,154,80,74,0,0,0
2024-07-05 10:30,173,100,73,0,0,0
2024-07-05 10:45,190,94,96,0,0,0
2024-07-05 11:00,163,67,96,0,0,0
2024-07-05 11:15,150,58,92,0,0,0
2024-07-05 11:30,167,63,104,0,0,0
2024-07-05 11:45,184,77,107,0,0,0
2024-07-05 12:00,187,101,86,0,0,0
2024-07-05 12:15,214,102,112,0,0,0
2024-07-05 12:30,192,87,105,0,0,0
2024-07-05 12:45,191,91,100,0,0,0
2024-07-05 13:00,214,121,93,0,0,0
2024-07-05 13:15,211,100,111,0,0,0
2024-07-05 13:30,181,103,78,0,0,0
2024-07-05 13:45,187,100,87,0,0,0
2024-07-05 14:00,219,127,92,0,0,0
2024-07-05 14:15,185,96,89,0,0,0
2024-07-05 14:30,197,101,96,0,0,0
2024-07-05 14:45,189,89,100,0,0,0
2024-07-05 15:00,185,105,80,0,0,0
2024-07-05 15:15,183,98,85,0,0,0
2024-07-05 15:30,168,91,77,0,0,0
2024-07-05 15:45,173,103,70,0,0,0
2024-07-05 16:00,202,107,95,0,0,0
2024-07-05 16:15,244,138,106,0,0,0
2024-07-05 16:30,197,110,87,0,0,0
2024-07-05 16:45,273,130,143,0,0,0
2024-07-05 17:00,243,123,120,0,0,0
2024-07-05 17:15,298,141,157,0,0,0
2024-07-05 17:30,294,145,149,0,0,0
2024-07-05 17:45,212,108,104,0,0,0
2024-07-05 18:00,143,73,70,0,0,0
2024-07-05 18:15,99,66,33,0,0,0
2024-07-05 18:30,81,47,34,0,0,0
2024-07-05 18:45,84,43,41,0,0,0
2024-07-05 19:00,80,40,40,0,0,0
2024-07-05 19:15,61,32,29,0,0,0
2024-07-05 19:30,39,21,18,0,0,0
2024-07-05 19:45,42,19,23,0,0,0
2024-07-05 20:00,40,29,11,0,0,0
2024-07-05 20:15,29,17,12,0,0,0
2024-07-05 20:30,35,20,15,0,0,0
2024-07-05 20:45,191,106,85,0,0,0
2024-07-05 21:00,242,133,109,0,0,0
2024-07-05 21:15,184,94,90,0,0,0
2024-07-05 21:30,103,60,43,0,0,0
2024-07-05 21:45,131,41,90,0,0,0
2024-07-05 22:00,115,48,67,0,0,0
2024-07-05 22:15,58,36,22,0,0,0
2024-07-05 22:30,92,47,45,0,0,0
2024-07-05 22:45,70,40,30,0,0,0
2024-07-05 23:00,75,36,39,0,0,0
2024-07-05 23:15,53,29,24,0,0,0
2024-07-05 23:30,50,17,33,0,0,0
2024-07-05 23:45,74,35,39,0,0,0
2024-07-06 00:00,95,27,68,0,0,0
2024-07-06 00:15,63,38,25,0,0,0
2024-07-06 00:30,48,22,26,0,0,0
2024-07-06 00:45,47,17,30,0,0,0
2024-07-06 01:00,47,30,17,0,0,0
2024-07-06 01:15,30,18,12,0,0,0
2024-07-06 01:30,35,15,20,0,0,0
2024-07-06 01:45,30,21,9,0,0,0
2024-07-06 02:00,19,7,12,0,0,0
2024-07-06 02:15,23,17,6,0,0,0
2024-07-06 02:30,8,6,2,0,0,0
2024-07-06 02:45,16,12,4,0,0,0
2024-07-06 03:00,17,7,10,0,0,0
2024-07-06 03:15,11,7,4,0,0,0
2024-07-06 03:30,13,6,7,0,0,0
2024-07-06 03:45,9,3,6,0,0,0
2024-07-06 04:00,4,0,4,0,0,0
2024-07-06 04:15,9,5,4,0,0,0
2024-07-06 04:30,6,3,3,0,0,0
2024-07-06 04:45,14,4,10,0,0,0
2024-07-06 05:00,7,3,4,0,0,0
2024-07-06 05:15,7,5,2,0,0,0
2024-07-06 05:30,11,2,9,0,0,0
2024-07-06 05:45,12,3,9,0,0,0
2024-07-06 06:00,11,4,7,0,0,0
2024-07-06 06:15,20,5,15,0,0,0
2024-07-06 06:30,17,9,8,0,0,0
2024-07-06 06:45,11,3,8,0,0,0
2024-07-06 07:00,16,4,12,0,0,0
2024-07-06 07:15,16,8,8,0,0,0
2024-07-06 07:30,34,12,22,0,0,0
2024-07-06 07:45,34,8,26,0,0,0
2024-07-06 08:00,25,8,17,0,0,0
2024-07-06 08:15,38,12,26,0,0,0
2024-07-06 08:30,58,26,32,0,0,0
2024-07-06 08:45,81,31,50,0,0,0
2024-07-06 09:00,60,20,40,0,0,0
2024-07-06 09:15,91,27,64,0,0,0
2024-07-06 09:30,116,29,87,0,0,0
2024-07-06 09:45,139,40,99,0,0,0
2024-07-06 10:00,136,29,107,0,0,0
2024-07-06 10:15,148,44,104,0,0,0
2024-07-06 10:30,156,57,99,0,0,0
2024-07-06 10:45,189,75,114,0,0,0
2024-07-06 11:00,163,60,103,0,0,0
2024-07-06 11:15,174,51,123,0,0,0
2024-07-06 11:30,184,74,110,0,0,0
2024-07-06 11:45,171,73,98,0,0,0
2024-07-06 12:00,176,64,112,0,0,0
2024-07-06 12:15,168,56,112,0,0,0
2024-07-06 12:30,169,88,81,0,0,0
2024-07-06 12:45,221,89,132,0,0,0
2024-07-06 13:00,195,87,108,0,0,0
2024-07-06 13:15,168,78,90,0,0,0
2024-07-06 13:30,187,80,107,0,0,0
2024-07-06 13:45,164,80,84,0,0,0
2024-07-06 14:00,159,84,75,0,0,0
2024-07-06 14:15,205,124,81,0,0,0
2024-07-06 14:30,188,111,77,0,0,0
2024-07-06 14:45,149,97,52,0,0,0
2024-07-06 15:00,130,71,59,0,0,0
2024-07-06 15:15,139,78,61,0,0,0
2024-07-06 15:30,137,72,65,0,0,0
2024-07-06 15:45,129,67,62,0,0,0
2024-07-06 16:00,141,79,62,0,0,0
2024-07-06 16:15,109,67,42,0,0,0
2024-07-06 16:30,123,68,55,0,0,0
2024-07-06 16:45,158,88,70,0,0,0
2024-07-06 17:00,146,90,56,0,0,0
2024-07-06 17:15,146,78,68,0,0,0
2024-07-06 17:30,118,62,56,0,0,0
2024-07-06 17:45,149,94,55,0,0,0
2024-07-06 18:00,148,85,63,0,0,0
2024-07-06 18:15,122,72,50,0,0,0
2024-07-06 18:30,124,54,70,0,0,0
2024-07-06 18:45,130,69,61,0,0,0
2024-07-06 19:00,106,57,49,0,0,0
2024-07-06 19:15,133,70,63,0,0,0
2024-07-06 19:30,89,47,42,0,0,0
2024-07-06 19:45,89,53,36,0,0,0
2024-07-06 20:00,70,46,24,0,0,0
2024-07-06 20:15,87,45,42,0,0,0
2024-07-06 20:30,72,43,29,0,0,0
2024-07-06 20:45,78,40,38,0,0,0
2024-07-06 21:00,90,41,49,0,0,0
2024-07-06 21:15,48,29,19,0,0,0
2024-07-06 21:30,71,34,37,0,0,0
2024-07-06 21:45,75,36,39,0,0,0
2024-07-06 22:00,63,24,39,0,0,0
2024-07-06 22:15,59,15,44,0,0,0
2024-07-06 22:30,40,13,27,0,0,0
2024-07-06 22:45,95,36,59,0,0,0
2024-07-06 23:00,89,34,55,0,0,0
2024-07-06 23:15,50,21,29,0,0,0
2024-07-06 23:30,58,20,38,0,0,0
2024-07-06 23:45,61,18,43,0,0,0
2024-07-07 00:00,49,24,25,0,0,0
2024-07-07 00:15,28,11,17,0,0,0
2024-07-07 00:30,46,24,22,0,0,0
2024-07-07 00:45,46,27,19,0,0,0
2024-07-07 01:00,32,17,15,0,0,0
2024-07-07 01:15,30,17,13,0,0,0
2024-07-07 01:30,30,13,17,0,0,0
2024-07-07 01:45,23,5,18,0,0,0
2024-07-07 02:00,18,9,9,0,0,0
2024-07-07 02:15,21,8,13,0,0,0
2024-07-07 02:30,14,6,8,0,0,0
2024-07-07 02:45,13,7,6,0,0,0
2024-07-07 03:00,6,2,4,0,0,0
2024-07-07 03:15,14,9,5,0,0,0
2024-07-07 03:30,5,1,4,0,0,0
2024-07-07 03:45,11,6,5,0,0,0
2024-07-07 04:00,10,3,7,0,0,0
2024-07-07 04:15,11,6,5,0,0,0
2024-07-07 04:30,3,1,2,0,0,0
2024-07-07 04:45,5,3,2,0,0,0
2024-07-07 05:00,12,5,7,0,0,0
2024-07-07 05:15,8,3,5,0,0,0
2024-07-07 05:30,9,2,7,0,0,0
2024-07-07 05:45,9,3,6,0,0,0
2024-07-07 06:00,6,4,2,0,0,0
2024-07-07 06:15,7,4,3,0,0,0
2024-07-07 06:30,10,4,6,0,0,0
2024-07-07 06:45,5,1,4,0,0,0
2024-07-07 07:00,3,1,2,0,0,0
2024-07-07 07:15,11,5,6,0,0,0
2024-07-07 07:30,11,4,7,0,0,0
2024-07-07 07:45,9,3,6,0,0,0
2024-07-07 08:00,14,4,10,0,0,0
2024-07-07 08:15,20,9,11,0,0,0
2024-07-07 08:30,30,8,22,0,0,0
2024-07-07 08:45,29,11,18,0,0,0
2024-07-07 09:00,43,22,21,0,0,0
2024-07-07 09:15,37,18,19,0,0,0
2024-07-07 09:30,42,21,21,0,0,0
2024-07-07 09:45,77,30,47,0,0,0
2024-07-07 10:00,76,33,43,0,0,0
2024-07-07 10:15,85,36,49,0,0,0
2024-07-07 10:30,66,18,48,0,0,0
2024-07-07 10:45,78,25,53,0,0,0
2024-07-07 11:00,79,41,38,0,0,0
2024-07-07 11:15,74,25,49,0,0,0
2024-07-07 11:30,71,29,42,0,0,0
2024-07-07 11:45,92,51,41,0,0,0
2024-07-07 12:00,85,43,42,0,0,0
2024-07-07 12:15,94,38,56,0,0,0
2024-07-07 12:30,104,48,56,0,0,0
2024-07-07 12:45,94,41,53,0,0,0
2024-07-07 13:00,104,41,63,0,0,0
2024-07-07 13:15,98,43,55,0,0,0
2024-07-07 13:30,105,59,46,0,0,0
2024-07-07 13:45,109,55,54,0,0,0
2024-07-07 14:00,84,42,42,0,0,0
2024-07-07 14:15,114,53,61,0,0,0
2024-07-07 14:30,113,47,66,0,0,0
2024-07-07 14:45,120,58,62,0,0,0
2024-07-07 15:00,118,61,57,0,0,0
2024-07-07 15:15,109,60,49,0,0,0
2024-07-07 15:30,90,46,44,0,0,0
2024-07-07 15:45,104,59,45,0,0,0
2024-07-07 16:00,114,52,62,0,0,0
2024-07-07 16:15,103,56,47,0,0,0
2024-07-07 16:30,114,59,55,0,0,0
2024-07-07 16:45,125,61,64,0,0,0
2024-07-07 17:00,114,57,57,0,0,0
2024-07-07 17:15,130,56,74,0,0,0
2024-07-07 17:30,156,77,79,0,0,0
2024-07-07 17:45,144,60,84,0,0,0
2024-07-07 18:00,134,76,58,0,0,0
2024-07-07 18:15,121,54,67,0,0,0
2024-07-07 18:30,125,48,77,0,0,0
2024-07-07 18:45,111,36,75,0,0,0
2024-07-07 19:00,130,69,61,0,0,0
2024-07-07 19:15,111,39,72,0,0,0
2024-07-07 19:30,76,44,32,0,0,0
2024-07-07 19:45,86,38,48,0,0,0
2024-07-07 20:00,89,36,53,0,0,0
2024-07-07 20:15,92,56,36,0,0,0
2024-07-07 20:30,100,50,50,0,0,0
2024-07-07 20:45,86,33,53,0,0,0
2024-07-07 21:00,76,44,32,0,0,0
2024-07-07 21:15,66,36,30,0,0,0
2024-07-07 21:30,52,35,17,0,0,0
2024-07-07 21:45,60,23,37,0,0,0
2024-07-07 22:00,44,25,19,0,0,0
2024-07-07 22:15,58,18,40,0,0,0
2024-07-07 22:30,34,9,25,0,0,0
2024-07-07 22:45,35,10,25,0,0,0
2024-07-07 23:00,27,9,18,0,0,0
2024-07-07 23:15,24,11,13,0,0,0
2024-07-07 23:30,22,10,12,0,0,0
2024-07-07 23:45,3,2,1,0,0,0
2024-07-08 00:00,20,8,12,0,0,0
2024-07-08 00:15,12,5,7,0,0,0
2024-07-08 00:30,5,3,2,0,0,0
2024-07-08 00:45,8,4,4,0,0,0
2024-07-08 01:00,8,0,8,0,0,0
2024-07-08 01:15,5,2,3,0,0,0
2024-07-08 01:30,3,1,2,0,0,0
2024-07-08 01:45,7,4,3,0,0,0
2024-07-08 02:00,2,1,1,0,0,0
2024-07-08 02:15,3,0,3,0,0,0
2024-07-08 02:30,0,0,0,0,0,0
2024-07-08 02:45,1,0,1,0,0,0
2024-07-08 03:00,0,0,0,0,0,0
2024-07-08 03:15,0,0,0,0,0,0
2024-07-08 03:30,1,0,1,0,0,0
2024-07-08 03:45,2,0,2,0,0,0
2024-07-08 04:00,1,0,1,0,0,0
2024-07-08 04:15,1,1,0,0,0,0
2024-07-08 04:30,2,0,2,0,0,0
2024-07-08 04:45,10,4,6,0,0,0
2024-07-08 05:00,3,3,0,0,0,0
2024-07-08 05:15,10,4,6,0,0,0
2024-07-08 05:30,9,4,5,0,0,0
2024-07-08 05:45,23,8,15,0,0,0
2024-07-08 06:00,26,10,16,0,0,0
2024-07-08 06:15,60,21,39,0,0,0
2024-07-08 06:30,56,26,30,0,0,0
2024-07-08 06:45,87,39,48,0,0,0
2024-07-08 07:00,89,40,49,0,0,0
2024-07-08 07:15,126,39,87,0,0,0
2024-07-08 07:30,155,53,102,0,0,0
2024-07-08 07:45,209,67,142,0,0,0
2024-07-08 08:00,203,51,152,0,0,0
2024-07-08 08:15,200,64,136,0,0,0
2024-07-08 08:30,193,52,141,0,0,0
2024-07-08 08:45,184,53,131,0,0,0
2024-07-08 09:00,132,39,93,0,0,0
2024-07-08 09:15,155,46,109,0,0,0
2024-07-08 09:30,148,49,99,0,0,0
2024-07-08 09:45,205,45,160,0,0,0
2024-07-08 10:00,157,45,112,0,0,0
2024-07-08 10:15,119,48,71,0,0,0
2024-07-08 10:30,135,44,91,0,0,0
2024-07-08 10:45,136,54,82,0,0,0
2024-07-08 11:00,136,55,81,0,0,0
2024-07-08 11:15,157,59,98,0,0,0
2024-07-08 11:30,158,60,98,0,0,0
2024-07-08 11:45,175,65,110,0,0,0
2024-07-08 12:00,163,71,92,0,0,0
2024-07-08 12:15,165,76,89,0,0,0
2024-07-08 12:30,163,74,89,0,0,0
2024-07-08 12:45,151,72,79,0,0,0
2024-07-08 13:00,182,93,89,0,0,0
2024-07-08 13:15,161,93,68,0,0,0
2024-07-08 13:30,180,65,115,0,0,0
2024-07-08 13:45,184,69,115,0,0,0
2024-07-08 14:00,161,83,78,0,0,0
2024-07-08 14:15,157,75,82,0,0,0
2024-07-08 14:30,183,88,95,0,0,0
2024-07-08 14:45,174,82,92,0,0,0
2024-07-08 15:00,148,83,65,0,0,0
2024-07-08 15:15,197,105,92,0,0,0
2024-07-08 15:30,208,100,108,0,0,0
2024-07-08 15:45,241,125,116,0,0,0
2024-07-08 16:00,233,128,105,0,0,0
2024-07-08 16:15,261,132,129,0,0,0
2024-07-08 16:30,230,112,118,0,0,0
2024-07-08 16:45,219,120,99,0,0,0
2024-07-08 17:00,255,146,109,0,0,0
2024-07-08 17:15,254,138,116,0,0,0
2024-07-08 17:30,237,129,108,0,0,0
2024-07-08 17:45,241,128,113,0,0,0
2024-07-08 18:00,272,163,109,0,0,0
2024-07-08 18:15,205,118,87,0,0,0
2024-07-08 18:30,201,118,83,0,0,0
2024-07-08 18:45,203,112,91,0,0,0
2024-07-08 19:00,185,100,85,0,0,0
2024-07-08 19:15,161,109,52,0,0,0
2024-07-08 19:30,166,97,69,0,0,0
2024-07-08 19:45,133,73,60,0,0,0
2024-07-08 20:00,131,87,44,0,0,0
2024-07-08 20:15,137,82,55,0,0,0
2024-07-08 20:30,115,65,50,0,0,0
2024-07-08 20:45,86,54,32,0,0,0
2024-07-08 21:00,66,42,24,0,0,0
2024-07-08 21:15,88,56,32,0,0,0
2024-07-08 21:30,82,34,48,0,0,0
2024-07-08 21:45,48,29,19,0,0,0
2024-07-08 22:00,65,33,32,0,0,0
2024-07-08 22:15,64,34,30,0,0,0
2024-07-08 22:30,73,38,35,0,0,0
2024-07-08 22:45,36,15,21,0,0,0
2024-07-08 23:00,49,16,33,0,0,0
2024-07-08 23:15,33,16,17,0,0,0
2024-07-08 23:30,12,7,5,0,0,0
2024-07-08 23:45,22,10,12,0,0,0
2024-07-09 00:00,25,10,15,0,0,0
2024-07-09 00:15,9,3,6,0,0,0
2024-07-09 00:30,13,9,4,0,0,0
2024-07-09 00:45,8,2,6,0,0,0
2024-07-09 01:00,8,5,3,0,0,0
2024-07-09 01:15,5,3,2,0,0,0
2024-07-09 01:30,5,4,1,0,0,0
2024-07-09 01:45,3,2,1,0,0,0
2024-07-09 02:00,3,0,3,0,0,0
2024-07-09 02:15,4,2,2,0,0,0
2024-07-09 02:30,5,3,2,0,0,0
2024-07-09 02:45,0,0,0,0,0,0
2024-07-09 03:00,4,2,2,0,0,0
2024-07-09 03:15,1,1,0,0,0,0
2024-07-09 03:30,0,0,0,0,0,0
2024-07-09 03:45,0,0,0,0,0,0
2024-07-09 04:00,2,1,1,0,0,0
2024-07-09 04:15,3,0,3,0,0,0
2024-07-09 04:30,9,4,5,0,0,0
2024-07-09 04:45,6,3,3,0,0,0
2024-07-09 05:00,7,5,2,0,0,0
2024-07-09 05:15,12,7,5,0,0,0
2024-07-09 05:30,13,7,6,0,0,0
2024-07-09 05:45,33,12,21,0,0,0
2024-07-09 06:00,22,6,16,0,0,0
2024-07-09 06:15,70,28,42,0,0,0
2024-07-09 06:30,75,23,52,0,0,0
2024-07-09 06:45,90,45,45,0,0,0
2024-07-09 07:00,89,34,55,0,0,0
2024-07-09 07:15,119,48,71,0,0,0
2024-07-09 07:30,179,49,130,0,0,0
2024-07-09 07:45,258,66,192,0,0,0
2024-07-09 08:00,210,63,147,0,0,0
2024-07-09 08:15,214,78,136,0,0,0
2024-07-09 08:30,237,70,167,0,0,0
2024-07-09 08:45,246,58,188,0,0,0
2024-07-09 09:00,171,52,119,0,0,0
2024-07-09 09:15,141,49,92,0,0,0
2024-07-09 09:30,161,44,117,0,0,0
2024-07-09 09:45,209,56,153,0,0,0
2024-07-09 10:00,169,49,120,0,0,0
2024-07-09 10:15,147,61,86,0,0,0
2024-07-09 10:30,154,63,91,0,0,0
2024-07-09 10:45,139,37,102,0,0,0
2024-07-09 11:00,127,42,85,0,0,0
2024-07-09 11:15,152,62,90,0,0,0
2024-07-09 11:30,171,74,97,0,0,0
2024-07-09 11:45,164,80,84,0,0,0
2024-07-09 12:00,180,86,94,0,0,0
2024-07-09 12:15,161,86,75,0,0,0
2024-07-09 12:30,167,90,77,0,0,0
2024-07-09 12:45,204,113,91,0,0,0
2024-07-09 13:00,165,82,83,0,0,0
2024-07-09 13:15,149,77,72,0,0,0
2024-07-09 13:30,161,79,82,0,0,0
2024-07-09 13:45,176,88,88,0,0,0
2024-07-09 14:00,163,86,77,0,0,0
2024-07-09 14:15,197,99,98,0,0,0
2024-07-09 14:30,189,89,100,0,0,0
2024-07-09 14:45,191,100,91,0,0,0
2024-07-09 15:00,190,109,81,0,0,0
2024-07-09 15:15,189,96,93,0,0,0
2024-07-09 15:30,200,109,91,0,0,0
2024-07-09 15:45,287,162,125,0,0,0
2024-07-09 16:00,277,160,117,0,0,0
2024-07-09 16:15,271,160,111,0,0,0
2024-07-09 16:30,262,150,112,0,0,0
2024-07-09 16:45,264,148,116,0,0,0
2024-07-09 17:00,282,161,121,0,0,0
2024-07-09 17:15,276,163,113,0,0,0
2024-07-09 17:30,257,149,108,0,0,0
2024-07-09 17:45,308,187,121,0,0,0
2024-07-09 18:00,282,198,84,0,0,0
2024-07-09 18:15,256,156,100,0,0,0
2024-07-09 18:30,230,136,94,0,0,0
2024-07-09 18:45,232,119,113,0,0,0
2024-07-09 19:00,217,118,99,0,0,0
2024-07-09 19:15,214,113,101,0,0,0
2024-07-09 19:30,188,101,87,0,0,0
2024-07-09 19:45,214,106,108,0,0,0
2024-07-09 20:00,189,88,101,0,0,0
2024-07-09 20:15,229,88,141,0,0,0
2024-07-09 20:30,174,76,98,0,0,0
2024-07-09 20:45,200,62,138,0,0,0
2024-07-09 21:00,173,64,109,0,0,0
2024-07-09 21:15,113,45,68,0,0,0
2024-07-09 21:30,90,30,60,0,0,0
2024-07-09 21:45,129,40,89,0,0,0
2024-07-09 22:00,113,49,64,0,0,0
2024-07-09 22:15,135,39,96,0,0,0
2024-07-09 22:30,177,55,122,0,0,0
2024-07-09 22:45,61,24,37,0,0,0
2024-07-09 23:00,122,51,71,0,0,0
2024-07-09 23:15,34,14,20,0,0,0
2024-07-09 23:30,36,18,18,0,0,0
2024-07-09 23:45,23,14,9,0,0,0
2024-07-10 00:00,8,6,2,0,0,0
2024-07-10 00:15,7,4,3,0,0,0
2024-07-10 00:30,6,2,4,0,0,0
2024-07-10 00:45,13,5,8,0,0,0
2024-07-10 01:00,11,7,4,0,0,0
2024-07-10 01:15,8,3,5,0,0,0
2024-07-10 01:30,5,4,1,0,0,0
2024-07-10 01:45,7,3,4,0,0,0
2024-07-10 02:00,2,2,0,0,0,0
2024-07-10 02:15,2,2,0,0,0,0
2024-07-10 02:30,4,1,3,0,0,0
2024-07-10 02:45,3,3,0,0,0,0
2024-07-10 03:00,2,2,0,0,0,0
2024-07-10 03:15,0,0,0,0,0,0
2024-07-10 03:30,0,0,0,0,0,0
2024-07-10 03:45,6,3,3,0,0,0
2024-07-10 04:00,3,2,1,0,0,0
2024-07-10 04:15,2,1,1,0,0,0
2024-07-10 04:30,4,2,2,0,0,0
2024-07-10 04:45,8,3,5,0,0,0
2024-07-10 05:00,10,7,3,0,0,0
2024-07-10 05:15,9,6,3,0,0,0
2024-07-10 05:30,11,6,5,0,0,0
2024-07-10 05:45,32,12,20,0,0,0
2024-07-10 06:00,15,3,12,0,0,0
2024-07-10 06:15,33,13,20,0,0,0
2024-07-10 06:30,39,15,24,0,0,0
2024-07-10 06:45,87,32,55,0,0,0
2024-07-10 07:00,85,32,53,0,0,0
2024-07-10 07:15,96,31,65,0,0,0
2024-07-10 07:30,128,39,89,0,0,0
2024-07-10 07:45,213,58,155,0,0,0
2024-07-10 08:00,137,28,109,0,0,0
2024-07-10 08:15,150,49,101,0,0,0
2024-07-10 08:30,156,34,122,0,0,0
2024-07-10 08:45,209,43,166,0,0,0
2024-07-10 09:00,149,46,103,0,0,0
2024-07-10 09:15,124,34,90,0,0,0
2024-07-10 09:30,130,33,97,0,0,0
2024-07-10 09:45,192,53,139,0,0,0
2024-07-10 10:00,162,45,117,0,0,0
2024-07-10 10:15,133,33,100,0,0,0
2024-07-10 10:30,130,43,87,0,0,0
2024-07-10 10:45,157,59,98,0,0,0
2024-07-10 11:00,145,49,96,0,0,0
2024-07-10 11:15,144,53,91,0,0,0
2024-07-10 11:30,142,50,92,0,0,0
2024-07-10 11:45,190,84,106,0,0,0
2024-07-10 12:00,208,88,120,0,0,0
2024-07-10 12:15,185,79,106,0,0,0
2024-07-10 12:30,172,82,90,0,0,0
2024-07-10 12:45,213,90,123,0,0,0
2024-07-10 13:00,184,97,87,0,0,0
2024-07-10 13:15,169,86,83,0,0,0
2024-07-10 13:30,173,89,84,0,0,0
2024-07-10 13:45,182,94,88,0,0,0
2024-07-10 14:00,177,81,96,0,0,0
2024-07-10 14:15,171,85,86,0,0,0
2024-07-10 14:30,187,98,89,0,0,0
2024-07-10 14:45,157,88,69,0,0,0
2024-07-10 15:00,148,85,63,0,0,0
2024-07-10 15:15,184,95,89,0,0,0
2024-07-10 15:30,182,87,95,0,0,0
2024-07-10 15:45,213,122,91,0,0,0
2024-07-10 16:00,194,108,86,0,0,0
2024-07-10 16:15,178,113,65,0,0,0
2024-07-10 16:30,206,106,100,0,0,0
2024-07-10 16:45,211,115,96,0,0,0
2024-07-10 17:00,232,125,107,0,0,0
2024-07-10 17:15,261,139,122,0,0,0
2024-07-10 17:30,222,125,97,0,0,0
2024-07-10 17:45,233,139,94,0,0,0
2024-07-10 18:00,218,130,88,0,0,0
2024-07-10 18:15,213,126,87,0,0,0
2024-07-10 18:30,156,93,63,0,0,0
2024-07-10 18:45,207,115,92,0,0,0
2024-07-10 19:00,162,105,57,0,0,0
2024-07-10 19:15,153,79,74,0,0,0
2024-07-10 19:30,143,83,60,0,0,0
2024-07-10 19:45,177,95,82,0,0,0
2024-07-10 20:00,177,86,91,0,0,0
2024-07-10 20:15,131,66,65,0,0,0
2024-07-10 20:30,122,75,47,0,0,0
2024-07-10 20:45,115,63,52,0,0,0
2024-07-10 21:00,104,54,50,0,0,0
2024-07-10 21:15,89,42,47,0,0,0
2024-07-10 21:30,73,30,43,0,0,0
2024-07-10 21:45,69,43,26,0,0,0
2024-07-10 22:00,89,52,37,0,0,0
2024-07-10 22:15,66,42,24,0,0,0
2024-07-10 22:30,47,21,26,0,0,0
2024-07-10 22:45,47,23,24,0,0,0
2024-07-10 23:00,105,55,50,0,0,0
2024-07-10 23:15,71,47,24,0,0,0
2024-07-10 23:30,50,20,30,0,0,0
2024-07-10 23:45,53,22,31,0,0,0
2024-07-11 00:00,44,21,23,0,0,0
2024-07-11 00:15,28,17,11,0,0,0
2024-07-11 00:30,23,10,13,0,0,0
2024-07-11 00:45,27,10,17,0,0,0
2024-07-11 01:00,11,8,3,0,0,0
2024-07-11 01:15,7,7,0,0,0,0
2024-07-11 01:30,15,12,3,0,0,0
2024-07-11 01:45,15,7,8,0,0,0
2024-07-11 02:00,6,6,0,0,0,0
2024-07-11 02:15,10,8,2,0,0,0
2024-07-11 02:30,5,4,1,0,0,0
2024-07-11 02:45,5,4,1,0,0,0
2024-07-11 03:00,8,5,3,0,0,0
2024-07-11 03:15,1,0,1,0,0,0
2024-07-11 03:30,6,5,1,0,0,0
2024-07-11 03:45,4,0,4,0,0,0
2024-07-11 04:00,4,0,4,0,0,0
2024-07-11 04:15,6,4,2,0,0,0
2024-07-11 04:30,5,3,2,0,0,0
2024-07-11 04:45,8,3,5,0,0,0
2024-07-11 05:00,10,6,4,0,0,0
2024-07-11 05:15,10,8,2,0,0,0
2024-07-11 05:30,11,4,7,0,0,0
2024-07-11 05:45,33,12,21,0,0,0
2024-07-11 06:00,24,9,15,0,0,0
2024-07-11 06:15,52,18,34,0,0,0
2024-07-11 06:30,62,22,40,0,0,0
2024-07-11 06:45,82,36,46,0,0,0
2024-07-11 07:00,85,39,46,0,0,0
2024-07-11 07:15,104,35,69,0,0,0
2024-07-11 07:30,171,49,122,0,0,0
2024-07-11 07:45,217,58,159,0,0,0
2024-07-11 08:00,174,43,131,0,0,0
2024-07-11 08:15,205,68,137,0,0,0
2024-07-11 08:30,184,56,128,0,0,0
2024-07-11 08:45,200,53,147,0,0,0
2024-07-11 09:00,132,38,94,0,0,0
2024-07-11 09:15,145,43,102,0,0,0
2024-07-11 09:30,143,44,99,0,0,0
2024-07-11 09:45,202,49,153,0,0,0
2024-07-11 10:00,173,46,127,0,0,0
2024-07-11 10:15,146,61,85,0,0,0
2024-07-11 10:30,127,46,81,0,0,0
2024-07-11 10:45,162,59,103,0,0,0
2024-07-11 11:00,122,45,77,0,0,0
2024-07-11 11:15,136,48,88,0,0,0
2024-07-11 11:30,121,50,71,0,0,0
2024-07-11 11:45,175,63,112,0,0,0
2024-07-11 12:00,195,91,104,0,0,0
2024-07-11 12:15,164,71,93,0,0,0
2024-07-11 12:30,175,86,89,0,0,0
2024-07-11 12:45,157,68,89,0,0,0
2024-07-11 13:00,165,71,94,0,0,0
2024-07-11 13:15,143,60,83,0,0,0
2024-07-11 13:30,178,90,88,0,0,0
2024-07-11 13:45,194,95,99,0,0,0
2024-07-11 14:00,191,106,85,0,0,0
2024-07-11 14:15,157,90,67,0,0,0
2024-07-11 14:30,170,100,70,0,0,0
2024-07-11 14:45,202,105,97,0,0,0
2024-07-11 15:00,181,94,87,0,0,0
2024-07-11 15:15,202,111,91,0,0,0
2024-07-11 15:30,216,99,117,0,0,0
2024-07-11 15:45,213,112,101,0,0,0
2024-07-11 16:00,237,132,105,0,0,0
2024-07-11 16:15,224,131,93,0,0,0
2024-07-11 16:30,244,139,105,0,0,0
2024-07-11 16:45,237,132,105,0,0,0
2024-07-11 17:00,262,155,107,0,0,0
2024-07-11 17:15,263,143,120,0,0,0
2024-07-11 17:30,248,131,117,0,0,0
2024-07-11 17:45,255,131,124,0,0,0
2024-07-11 18:00,257,155,102,0,0,0
2024-07-11 18:15,224,138,86,0,0,0
2024-07-11 18:30,211,115,96,0,0,0
2024-07-11 18:45,255,127,128,0,0,0
2024-07-11 19:00,183,106,77,0,0,0
2024-07-11 19:15,157,89,68,0,0,0
2024-07-11 19:30,174,96,78,0,0,0
2024-07-11 19:45,167,106,61,0,0,0
2024-07-11 20:00,144,77,67,0,0,0
2024-07-11 20:15,136,68,68,0,0,0
2024-07-11 20:30,109,56,53,0,0,0
2024-07-11 20:45,98,47,51,0,0,0
2024-07-11 21:00,93,63,30,0,0,0
2024-07-11 21:15,129,65,64,0,0,0
2024-07-11 21:30,102,49,53,0,0,0
2024-07-11 21:45,107,54,53,0,0,0
2024-07-11 22:00,91,50,41,0,0,0
2024-07-11 22:15,80,57,23,0,0,0
2024-07-11 22:30,67,25,42,0,0,0
2024-07-11 22:45,65,32,33,0,0,0
2024-07-11 23:00,64,26,38,0,0,0
2024-07-11 23:15,63,29,34,0,0,0
2024-07-11 23:30,34,20,14,0,0,0
2024-07-11 23:45,28,12,16,0,0,0
2024-07-12 00:00,23,6,17,0,0,0
2024-07-12 00:15,24,7,17,0,0,0
2024-07-12 00:30,13,6,7,0,0,0
2024-07-12 00:45,14,7,7,0,0,0
2024-07-12 01:00,18,6,12,0,0,0
2024-07-12 01:15,10,7,3,0,0,0
2024-07-12 01:30,14,8,6,0,0,0
2024-07-12 01:45,10,3,7,0,0,0
2024-07-12 02:00,5,1,4,0,0,0
2024-07-12 02:15,5,2,3,0,0,0
2024-07-12 02:30,1,1,0,0,0,0
2024-07-12 02:45,4,3,1,0,0,0
2024-07-12 03:00,4,1,3,0,0,0
2024-07-12 03:15,2,0,2,0,0,0
2024-07-12 03:30,2,2,0,0,0,0
2024-07-12 03:45,1,0,1,0,0,0
2024-07-12 04:00,0,0,0,0,0,0
2024-07-12 04:15,3,1,2,0,0,0
2024-07-12 04:30,5,2,3,0,0,0
2024-07-12 04:45,6,2,4,0,0,0
2024-07-12 05:00,7,5,2,0,0,0
2024-07-12 05:15,13,9,4,0,0,0
2024-07-12 05:30,11,3,8,0,0,0
2024-07-12 05:45,27,10,17,0,0,0
2024-07-12 06:00,18,4,14,0,0,0
2024-07-12 06:15,42,16,26,0,0,0
2024-07-12 06:30,46,19,27,0,0,0
2024-07-12 06:45,50,20,30,0,0,0
2024-07-12 07:00,68,29,39,0,0,0
2024-07-12 07:15,92,38,54,0,0,0
2024-07-12 07:30,121,33,88,0,0,0
2024-07-12 07:45,195,55,140,0,0,0
2024-07-12 08:00,121,36,85,0,0,0
2024-07-12 08:15,153,45,108,0,0,0
2024-07-12 08:30,133,36,97,0,0,0
2024-07-12 08:45,175,53,122,0,0,0
2024-07-12 09:00,133,33,100,0,0,0
2024-07-12 09:15,103,39,64,0,0,0
2024-07-12 09:30,104,31,73,0,0,0
2024-07-12 09:45,114,39,75,0,0,0
2024-07-12 10:00,97,35,62,0,0,0
2024-07-12 10:15,98,40,58,0,0,0
2024-07-12 10:30,74,25,49,0,0,0
2024-07-12 10:45,124,43,81,0,0,0
2024-07-12 11:00,108,44,64,0,0,0
2024-07-12 11:15,100,41,59,0,0,0
2024-07-12 11:30,111,47,64,0,0,0
2024-07-12 11:45,151,75,76,0,0,0
2024-07-12 12:00,107,55,52,0,0,0
2024-07-12 12:15,73,32,41,0,0,0
2024-07-12 12:30,73,43,30,0,0,0
2024-07-12 12:45,141,77,64,0,0,0
2024-07-12 13:00,155,65,90,0,0,0
2024-07-12 13:15,151,71,80,0,0,0
2024-07-12 13:30,123,57,66,0,0,0
2024-07-12 13:45,167,73,94,0,0,0
2024-07-12 14:00,153,78,75,0,0,0
2024-07-12 14:15,148,75,73,0,0,0
2024-07-12 14:30,136,70,66,0,0,0
2024-07-12 14:45,137,72,65,0,0,0
2024-07-12 15:00,119,67,52,0,0,0
2024-07-12 15:15,123,65,58,0,0,0
2024-07-12 15:30,55,29,26,0,0,0
2024-07-12 15:45,148,78,70,0,0,0
2024-07-12 16:00,155,83,72,0,0,0
2024-07-12 16:15,152,83,69,0,0,0
2024-07-12 16:30,138,82,56,0,0,0
2024-07-12 16:45,140,85,55,0,0,0
2024-07-12 17:00,127,74,53,0,0,0
2024-07-12 17:15,138,78,60,0,0,0
2024-07-12 17:30,149,81,68,0,0,0
2024-07-12 17:45,174,93,81,0,0,0
2024-07-12 18:00,139,81,58,0,0,0
2024-07-12 18:15,133,80,53,0,0,0
2024-07-12 18:30,134,74,60,0,0,0
2024-07-12 18:45,127,70,57,0,0,0
2024-07-12 19:00,138,87,51,0,0,0
2024-07-12 19:15,122,62,60,0,0,0
2024-07-12 19:30,124,66,58,0,0,0
2024-07-12 19:45,122,72,50,0,0,0
2024-07-12 20:00,122,83,39,0,0,0
2024-07-12 20:15,85,43,42,0,0,0
2024-07-12 20:30,77,42,35,0,0,0
2024-07-12 20:45,73,33,40,0,0,0
2024-07-12 21:00,55,31,24,0,0,0
2024-07-12 21:15,62,31,31,0,0,0
2024-07-12 21:30,66,32,34,0,0,0
2024-07-12 21:45,69,35,34,0,0,0
2024-07-12 22:00,54,26,28,0,0,0
2024-07-12 22:15,53,27,26,0,0,0
2024-07-12 22:30,65,39,26,0,0,0
2024-07-12 22:45,49,26,23,0,0,0
2024-07-12 23:00,44,21,23,0,0,0
2024-07-12 23:15,53,24,29,0,0,0
2024-07-12 23:30,43,25,18,0,0,0
2024-07-12 23:45,49,22,27,0,0,0
2024-07-13 00:00,54,20,34,0,0,0
2024-07-13 00:15,28,13,15,0,0,0
2024-07-13 00:30,37,11,26,0,0,0
2024-07-13 00:45,39,22,17,0,0,0
2024-07-13 01:00,32,22,10,0,0,0
2024-07-13 01:15,21,9,12,0,0,0
2024-07-13 01:30,40,16,24,0,0,0
2024-07-13 01:45,19,8,11,0,0,0
2024-07-13 02:00,17,11,6,0,0,0
2024-07-13 02:15,13,6,7,0,0,0
2024-07-13 02:30,16,7,9,0,0,0
2024-07-13 02:45,12,5,7,0,0,0
2024-07-13 03:00,12,8,4,0,0,0
2024-07-13 03:15,11,7,4,0,0,0
2024-07-13 03:30,6,4,2,0,0,0
2024-07-13 03:45,8,5,3,0,0,0
2024-07-13 04:00,10,5,5,0,0,0
2024-07-13 04:15,10,4,6,0,0,0
2024-07-13 04:30,13,3,10,0,0,0
2024-07-13 04:45,7,4,3,0,0,0
2024-07-13 05:00,4,0,4,0,0,0
2024-07-13 05:15,8,3,5,0,0,0
2024-07-13 05:30,9,6,3,0,0,0
2024-07-13 05:45,19,5,14,0,0,0
2024-07-13 06:00,13,5,8,0,0,0
2024-07-13 06:15,18,9,9,0,0,0
2024-07-13 06:30,16,8,8,0,0,0
2024-07-13 06:45,10,4,6,0,0,0
2024-07-13 07:00,15,5,10,0,0,0
2024-07-13 07:15,16,9,7,0,0,0
2024-07-13 07:30,30,11,19,0,0,0
2024-07-13 07:45,36,6,30,0,0,0
2024-07-13 08:00,44,15,29,0,0,0
2024-07-13 08:15,37,13,24,0,0,0
2024-07-13 08:30,56,26,30,0,0,0
2024-07-13 08:45,61,21,40,0,0,0
2024-07-13 09:00,54,20,34,0,0,0
2024-07-13 09:15,81,29,52,0,0,0
2024-07-13 09:30,85,22,63,0,0,0
2024-07-13 09:45,136,41,95,0,0,0
2024-07-13 10:00,119,38,81,0,0,0
2024-07-13 10:15,139,31,108,0,0,0
2024-07-13 10:30,124,43,81,0,0,0
2024-07-13 10:45,132,48,84,0,0,0
2024-07-13 11:00,149,50,99,0,0,0
2024-07-13 11:15,139,51,88,0,0,0
2024-07-13 11:30,153,52,101,0,0,0
2024-07-13 11:45,155,53,102,0,0,0
2024-07-13 12:00,145,55,90,0,0,0
2024-07-13 12:15,131,52,79,0,0,0
2024-07-13 12:30,177,76,101,0,0,0
2024-07-13 12:45,191,87,104,0,0,0
2024-07-13 13:00,134,66,68,0,0,0
2024-07-13 13:15,134,59,75,0,0,0
2024-07-13 13:30,135,75,60,0,0,0
2024-07-13 13:45,152,76,76,0,0,0
2024-07-13 14:00,143,74,69,0,0,0
2024-07-13 14:15,132,67,65,0,0,0
2024-07-13 14:30,130,71,59,0,0,0
2024-07-13 14:45,165,85,80,0,0,0
2024-07-13 15:00,128,66,62,0,0,0
2024-07-13 15:15,144,87,57,0,0,0
2024-07-13 15:30,124,56,68,0,0,0
2024-07-13 15:45,127,66,61,0,0,0
2024-07-13 16:00,138,87,51,0,0,0
2024-07-13 16:15,146,61,85,0,0,0
2024-07-13 16:30,109,57,52,0,0,0
2024-07-13 16:45,120,70,50,0,0,0
2024-07-13 17:00,112,73,39,0,0,0
2024-07-13 17:15,120,73,47,0,0,0
2024-07-13 17:30,116,56,60,0,0,0
2024-07-13 17:45,154,99,55,0,0,0
2024-07-13 18:00,118,68,50,0,0,0
2024-07-13 18:15,118,77,41,0,0,0
2024-07-13 18:30,113,55,58,0,0,0
2024-07-13 18:45,118,58,60,0,0,0
2024-07-13 19:00,134,72,62,0,0,0
2024-07-13 19:15,101,52,49,0,0,0
2024-07-13 19:30,96,51,45,0,0,0
2024-07-13 19:45,105,56,49,0,0,0
2024-07-13 20:00,102,56,46,0,0,0
2024-07-13 20:15,78,42,36,0,0,0
2024-07-13 20:30,82,42,40,0,0,0
2024-07-13 20:45,77,37,40,0,0,0
2024-07-13 21:00,70,38,32,0,0,0
2024-07-13 21:15,75,39,36,0,0,0
2024-07-13 21:30,65,39,26,0,0,0
2024-07-13 21:45,57,18,39,0,0,0
2024-07-13 22:00,68,33,35,0,0,0
2024-07-13 22:15,72,32,40,0,0,0
2024-07-13 22:30,66,24,42,0,0,0
2024-07-13 22:45,59,33,26,0,0,0
2024-07-13 23:00,50,30,20,0,0,0
2024-07-13 23:15,56,21,35,0,0,0
2024-07-13 23:30,39,13,26,0,0,0
2024-07-13 23:45,47,22,25,0,0,0
2024-07-14 00:00,45,26,19,0,0,0
2024-07-14 00:15,37,23,14,0,0,0
2024-07-14 00:30,46,18,28,0,0,0
2024-07-14 00:45,40,19,21,0,0,0
2024-07-14 01:00,32,18,14,0,0,0
2024-07-14 01:15,27,10,17,0,0,0
2024-07-14 01:30,33,23,10,0,0,0
2024-07-14 01:45,23,11,12,0,0,0
2024-07-14 02:00,25,14,11,0,0,0
2024-07-14 02:15,29,17,12,0,0,0
2024-07-14 02:30,25,11,14,0,0,0
2024-07-14 02:45,19,12,7,0,0,0
2024-07-14 03:00,11,4,7,0,0,0
2024-07-14 03:15,17,8,9,0,0,0
2024-07-14 03:30,19,4,15,0,0,0
2024-07-14 03:45,8,2,6,0,0,0
2024-07-14 04:00,6,1,5,0,0,0
2024-07-14 04:15,12,2,10,0,0,0
2024-07-14 04:30,9,4,5,0,0,0
2024-07-14 04:45,11,3,8,0,0,0
2024-07-14 05:00,3,1,2,0,0,0
2024-07-14 05:15,11,2,9,0,0,0
2024-07-14 05:30,6,2,4,0,0,0
2024-07-14 05:45,5,2,3,0,0,0
2024-07-14 06:00,15,10,5,0,0,0
2024-07-14 06:15,7,2,5,0,0,0
2024-07-14 06:30,6,3,3,0,0,0
2024-07-14 06:45,7,3,4,0,0,0
2024-07-14 07:00,9,5,4,0,0,0
2024-07-14 07:15,11,3,8,0,0,0
2024-07-14 07:30,14,3,11,0,0,0
2024-07-14 07:45,19,6,13,0,0,0
2024-07-14 08:00,18,6,12,0,0,0
2024-07-14 08:15,23,4,19,0,0,0
2024-07-14 08:30,14,3,11,0,0,0
2024-07-14 08:45,28,12,16,0,0,0
2024-07-14 09:00,32,14,18,0,0,0
2024-07-14 09:15,39,16,23,0,0,0
2024-07-14 09:30,49,18,31,0,0,0
2024-07-14 09:45,69,17,52,0,0,0
2024-07-14 10:00,59,25,34,0,0,0
2024-07-14 10:15,72,21,51,0,0,0
2024-07-14 10:30,78,32,46,0,0,0
2024-07-14 10:45,84,32,52,0,0,0
2024-07-14 11:00,67,26,41,0,0,0
2024-07-14 11:15,83,39,44,0,0,0
2024-07-14 11:30,61,27,34,0,0,0
2024-07-14 11:45,89,45,44,0,0,0
2024-07-14 12:00,80,40,40,0,0,0
2024-07-14 12:15,93,33,60,0,0,0
2024-07-14 12:30,87,49,38,0,0,0
2024-07-14 12:45,76,41,35,0,0,0
2024-07-14 13:00,81,34,47,0,0,0
2024-07-14 13:15,93,36,57,0,0,0
2024-07-14 13:30,97,41,56,0,0,0
2024-07-14 13:45,108,44,64,0,0,0
2024-07-14 14:00,103,56,47,0,0,0
2024-07-14 14:15,96,40,56,0,0,0
2024-07-14 14:30,108,44,64,0,0,0
2024-07-14 14:45,129,54,75,0,0,0
2024-07-14 15:00,141,66,75,0,0,0
2024-07-14 15:15,104,45,59,0,0,0
2024-07-14 15:30,116,54,62,0,0,0
2024-07-14 15:45,101,47,54,0,0,0
2024-07-14 16:00,93,35,58,0,0,0
2024-07-14 16:15,108,37,71,0,0,0
2024-07-14 16:30,81,34,47,0,0,0
2024-07-14 16:45,124,71,53,0,0,0
2024-07-14 17:00,104,62,42,0,0,0
2024-07-14 17:15,116,55,61,0,0,0
2024-07-14 17:30,129,70,59,0,0,0
2024-07-14 17:45,141,66,75,0,0,0
2024-07-14 18:00,110,53,57,0,0,0
2024-07-14 18:15,98,50,48,0,0,0
2024-07-14 18:30,114,50,64,0,0,0
2024-07-14 18:45,126,70,56,0,0,0
2024-07-14 19:00,125,71,54,0,0,0
2024-07-14 19:15,104,59,45,0,0,0
2024-07-14 19:30,116,55,61,0,0,0
2024-07-14 19:45,107,50,57,0,0,0
2024-07-14 20:00,109,44,65,0,0,0
2024-07-14 20:15,125,54,71,0,0,0
2024-07-14 20:30,111,56,55,0,0,0
2024-07-14 20:45,108,59,49,0,0,0
2024-07-14 21:00,75,42,33,0,0,0
2024-07-14 21:15,54,27,27,0,0,0
2024-07-14 21:30,51,23,28,0,0,0
2024-07-14 21:45,51,30,21,0,0,0
2024-07-14 22:00,35,15,20,0,0,0
2024-07-14 22:15,26,9,17,0,0,0
2024-07-14 22:30,30,16,14,0,0,0
2024-07-14 22:45,25,11,14,0,0,0
2024-07-14 23:00,116,56,60,0,0,0
2024-07-14 23:15,95,58,37,0,0,0
2024-07-14 23:30,84,43,41,0,0,0
2024-07-14 23:45,52,23,29,0,0,0
2024-07-15 00:00,26,17,9,0,0,0
2024-07-15 00:15,20,14,6,0,0,0
2024-07-15 00:30,4,2,2,0,0,0
2024-07-15 00:45,3,2,1,0,0,0
2024-07-15 01:00,10,6,4,0,0,0
2024-07-15 01:15,5,3,2,0,0,0
2024-07-15 01:30,3,2,1,0,0,0
2024-07-15 01:45,5,3,2,0,0,0
2024-07-15 02:00,0,0,0,0,0,0
2024-07-15 02:15,6,1,5,0,0,0
2024-07-15 02:30,4,1,3,0,0,0
2024-07-15 02:45,4,3,1,0,0,0
2024-07-15 03:00,0,0,0,0,0,0
2024-07-15 03:15,6,2,4,0,0,0
2024-07-15 03:30,1,0,1,0,0,0
2024-07-15 03:45,3,0,3,0,0,0
2024-07-15 04:00,2,2,0,0,0,0
2024-07-15 04:15,4,3,1,0,0,0
2024-07-15 04:30,7,1,6,0,0,0
2024-07-15 04:45,6,3,3,0,0,0
2024-07-15 05:00,3,3,0,0,0,0
2024-07-15 05:15,6,4,2,0,0,0
2024-07-15 05:30,11,3,8,0,0,0
2024-07-15 05:45,31,13,18,0,0,0
2024-07-15 06:00,21,6,15,0,0,0
2024-07-15 06:15,47,17,30,0,0,0
2024-07-15 06:30,69,28,41,0,0,0
2024-07-15 06:45,83,38,45,0,0,0
2024-07-15 07:00,97,32,65,0,0,0
2024-07-15 07:15,108,38,70,0,0,0
2024-07-15 07:30,156,41,115,0,0,0
2024-07-15 07:45,225,52,173,0,0,0
2024-07-15 08:00,173,51,122,0,0,0
2024-07-15 08:15,177,62,115,0,0,0
2024-07-15 08:30,187,46,141,0,0,0
2024-07-15 08:45,193,58,135,0,0,0
2024-07-15 09:00,119,26,93,0,0,0
2024-07-15 09:15,125,48,77,0,0,0
2024-07-15 09:30,128,38,90,0,0,0
2024-07-15 09:45,154,60,94,0,0,0
2024-07-15 10:00,168,59,109,0,0,0
2024-07-15 10:15,112,46,66,0,0,0
2024-07-15 10:30,109,40,69,0,0,0
2024-07-15 10:45,141,47,94,0,0,0
2024-07-15 11:00,133,50,83,0,0,0
2024-07-15 11:15,137,60,77,0,0,0
2024-07-15 11:30,142,64,78,0,0,0
2024-07-15 11:45,165,64,101,0,0,0
2024-07-15 12:00,167,64,103,0,0,0
2024-07-15 12:15,159,75,84,0,0,0
2024-07-15 12:30,148,77,71,0,0,0
2024-07-15 12:45,182,77,105,0,0,0
2024-07-15 13:00,158,73,85,0,0,0
2024-07-15 13:15,161,74,87,0,0,0
2024-07-15 13:30,179,83,96,0,0,0
2024-07-15 13:45,176,76,100,0,0,0
2024-07-15 14:00,147,69,78,0,0,0
2024-07-15 14:15,164,70,94,0,0,0
2024-07-15 14:30,158,87,71,0,0,0
2024-07-15 14:45,189,113,76,0,0,0
2024-07-15 15:00,151,65,86,0,0,0
2024-07-15 15:15,190,97,93,0,0,0
2024-07-15 15:30,178,87,91,0,0,0
2024-07-15 15:45,224,113,111,0,0,0
2024-07-15 16:00,227,130,97,0,0,0
2024-07-15 16:15,255,159,96,0,0,0
2024-07-15 16:30,231,125,106,0,0,0
2024-07-15 16:45,246,133,113,0,0,0
2024-07-15 17:00,246,132,114,0,0,0
2024-07-15 17:15,249,127,122,0,0,0
2024-07-15 17:30,239,131,108,0,0,0
2024-07-15 17:45,240,142,98,0,0,0
2024-07-15 18:00,257,159,98,0,0,0
2024-07-15 18:15,227,132,95,0,0,0
2024-07-15 18:30,182,110,72,0,0,0
2024-07-15 18:45,214,124,90,0,0,0
2024-07-15 19:00,189,119,70,0,0,0
2024-07-15 19:15,175,101,74,0,0,0
2024-07-15 19:30,152,85,67,0,0,0
2024-07-15 19:45,143,82,61,0,0,0
2024-07-15 20:00,147,86,61,0,0,0
2024-07-15 20:15,146,72,74,0,0,0
2024-07-15 20:30,104,58,46,0,0,0
2024-07-15 20:45,94,43,51,0,0,0
2024-07-15 21:00,96,41,55,0,0,0
2024-07-15 21:15,96,51,45,0,0,0
2024-07-15 21:30,87,54,33,0,0,0
2024-07-15 21:45,80,32,48,0,0,0
2024-07-15 22:00,78,33,45,0,0,0
2024-07-15 22:15,64,29,35,0,0,0
2024-07-15 22:30,56,25,31,0,0,0
2024-07-15 22:45,46,21,25,0,0,0
2024-07-15 23:00,56,23,33,0,0,0
2024-07-15 23:15,33,14,19,0,0,0
2024-07-15 23:30,25,13,12,0,0,0
2024-07-15 23:45,27,16,11,0,0,0
2024-07-16 00:00,21,11,10,0,0,0
2024-07-16 00:15,12,7,5,0,0,0
2024-07-16 00:30,12,1,11,0,0,0
2024-07-16 00:45,15,7,8,0,0,0
2024-07-16 01:00,5,2,3,0,0,0
2024-07-16 01:15,7,3,4,0,0,0
2024-07-16 01:30,1,1,0,0,0,0
2024-07-16 01:45,3,1,2,0,0,0
2024-07-16 02:00,3,0,3,0,0,0
2024-07-16 02:15,2,2,0,0,0,0
2024-07-16 02:30,2,1,1,0,0,0
2024-07-16 02:45,1,0,1,0,0,0
2024-07-16 03:00,2,2,0,0,0,0
2024-07-16 03:15,2,0,2,0,0,0
2024-07-16 03:30,2,1,1,0,0,0
2024-07-16 03:45,1,1,0,0,0,0
2024-07-16 04:00,4,3,1,0,0,0
2024-07-16 04:15,5,1,4,0,0,0
2024-07-16 04:30,5,3,2,0,0,0
2024-07-16 04:45,6,4,2,0,0,0
2024-07-16 05:00,5,5,0,0,0,0
2024-07-16 05:15,9,4,5,0,0,0
2024-07-16 05:30,18,8,10,0,0,0
2024-07-16 05:45,32,11,21,0,0,0
2024-07-16 06:00,19,7,12,0,0,0
2024-07-16 06:15,53,25,28,0,0,0
2024-07-16 06:30,60,23,37,0,0,0
2024-07-16 06:45,72,30,42,0,0,0
2024-07-16 07:00,96,38,58,0,0,0
2024-07-16 07:15,113,41,72,0,0,0
2024-07-16 07:30,142,41,101,0,0,0
2024-07-16 07:45,234,67,167,0,0,0
2024-07-16 08:00,199,50,149,0,0,0
2024-07-16 08:15,195,64,131,0,0,0
2024-07-16 08:30,181,54,127,0,0,0
2024-07-16 08:45,195,52,143,0,0,0
2024-07-16 09:00,131,37,94,0,0,0
2024-07-16 09:15,138,33,105,0,0,0
2024-07-16 09:30,132,31,101,0,0,0
2024-07-16 09:45,192,42,150,0,0,0
2024-07-16 10:00,146,46,100,0,0,0
2024-07-16 10:15,95,46,49,0,0,0
2024-07-16 10:30,117,46,71,0,0,0
2024-07-16 10:45,116,40,76,0,0,0
2024-07-16 11:00,143,58,85,0,0,0
2024-07-16 11:15,141,51,90,0,0,0
2024-07-16 11:30,135,52,83,0,0,0
2024-07-16 11:45,166,76,90,0,0,0
2024-07-16 12:00,137,56,81,0,0,0
2024-07-16 12:15,123,53,70,0,0,0
2024-07-16 12:30,141,65,76,0,0,0
2024-07-16 12:45,154,71,83,0,0,0
2024-07-16 13:00,133,68,65,0,0,0
2024-07-16 13:15,147,67,80,0,0,0
2024-07-16 13:30,161,76,85,0,0,0
2024-07-16 13:45,174,69,105,0,0,0
2024-07-16 14:00,170,84,86,0,0,0
2024-07-16 14:15,178,91,87,0,0,0
2024-07-16 14:30,121,69,52,0,0,0
2024-07-16 14:45,75,39,36,0,0,0
2024-07-16 15:00,145,88,57,0,0,0
2024-07-16 15:15,193,90,103,0,0,0
2024-07-16 15:30,177,88,89,0,0,0
2024-07-16 15:45,204,105,99,0,0,0
2024-07-16 16:00,210,118,92,0,0,0
2024-07-16 16:15,185,109,76,0,0,0
2024-07-16 16:30,245,149,96,0,0,0
2024-07-16 16:45,253,142,111,0,0,0
2024-07-16 17:00,197,107,90,0,0,0
2024-07-16 17:15,228,129,99,0,0,0
2024-07-16 17:30,172,91,81,0,0,0
2024-07-16 17:45,203,123,80,0,0,0
2024-07-16 18:00,238,147,91,0,0,0
2024-07-16 18:15,224,124,100,0,0,0
2024-07-16 18:30,179,109,70,0,0,0
2024-07-16 18:45,196,121,75,0,0,0
2024-07-16 19:00,193,117,76,0,0,0
2024-07-16 19:15,148,83,65,0,0,0
2024-07-16 19:30,106,55,51,0,0,0
2024-07-16 19:45,138,80,58,0,0,0
2024-07-16 20:00,141,84,57,0,0,0
2024-07-16 20:15,107,64,43,0,0,0
2024-07-16 20:30,103,58,45,0,0,0
2024-07-16 20:45,107,62,45,0,0,0
2024-07-16 21:00,100,46,54,0,0,0
2024-07-16 21:15,82,38,44,0,0,0
2024-07-16 21:30,66,34,32,0,0,0
2024-07-16 21:45,87,46,41,0,0,0
2024-07-16 22:00,66,25,41,0,0,0
2024-07-16 22:15,76,33,43,0,0,0
2024-07-16 22:30,34,22,12,0,0,0
2024-07-16 22:45,60,22,38,0,0,0
2024-07-16 23:00,33,16,17,0,0,0
2024-07-16 23:15,31,12,19,0,0,0
2024-07-16 23:30,34,21,13,0,0,0
2024-07-16 23:45,26,14,12,0,0,0
2024-07-17 00:00,20,8,12,0,0,0
2024-07-17 00:15,10,8,2,0,0,0
2024-07-17 00:30,15,6,9,0,0,0
2024-07-17 00:45,9,3,6,0,0,0
2024-07-17 01:00,10,5,5,0,0,0
2024-07-17 01:15,7,2,5,0,0,0
2024-07-17 01:30,10,6,4,0,0,0
2024-07-17 01:45,5,3,2,0,0,0
2024-07-17 02:00,2,0,2,0,0,0
2024-07-17 02:15,3,2,1,0,0,0
2024-07-17 02:30,2,1,1,0,0,0
2024-07-17 02:45,2,1,1,0,0,0
2024-07-17 03:00,1,1,0,0,0,0
2024-07-17 03:15,0,0,0,0,0,0
2024-07-17 03:30,1,0,1,0,0,0
2024-07-17 03:45,3,1,2,0,0,0
2024-07-17 04:00,2,0,2,0,0,0
2024-07-17 04:15,2,1,1,0,0,0
2024-07-17 04:30,4,1,3,0,0,0
2024-07-17 04:45,8,6,2,0,0,0
2024-07-17 05:00,4,2,2,0,0,0
2024-07-17 05:15,8,4,4,0,0,0
2024-07-17 05:30,14,9,5,0,0,0
2024-07-17 05:45,32,10,22,0,0,0
2024-07-17 06:00,27,9,18,0,0,0
2024-07-17 06:15,43,16,27,0,0,0
2024-07-17 06:30,63,26,37,0,0,0
2024-07-17 06:45,75,32,43,0,0,0
2024-07-17 07:00,101,38,63,0,0,0
2024-07-17 07:15,122,35,87,0,0,0
2024-07-17 07:30,170,56,114,0,0,0
2024-07-17 07:45,217,63,154,0,0,0
2024-07-17 08:00,180,44,136,0,0,0
2024-07-17 08:15,171,53,118,0,0,0
2024-07-17 08:30,174,48,126,0,0,0
2024-07-17 08:45,204,52,152,0,0,0
2024-07-17 09:00,149,46,103,0,0,0
2024-07-17 09:15,156,57,99,0,0,0
2024-07-17 09:30,141,41,100,0,0,0
2024-07-17 09:45,167,41,126,0,0,0
2024-07-17 10:00,170,51,119,0,0,0
2024-07-17 10:15,142,55,87,0,0,0
2024-07-17 10:30,150,41,109,0,0,0
2024-07-17 10:45,170,56,114,0,0,0
2024-07-17 11:00,152,67,85,0,0,0
2024-07-17 11:15,155,58,97,0,0,0
2024-07-17 11:30,156,60,96,0,0,0
2024-07-17 11:45,206,81,125,0,0,0
2024-07-17 12:00,183,87,96,0,0,0
2024-07-17 12:15,177,75,102,0,0,0
2024-07-17 12:30,150,80,70,0,0,0
2024-07-17 12:45,156,70,86,0,0,0
2024-07-17 13:00,141,76,65,0,0,0
2024-07-17 13:15,189,88,101,0,0,0
2024-07-17 13:30,165,91,74,0,0,0
2024-07-17 13:45,161,89,72,0,0,0
2024-07-17 14:00,173,89,84,0,0,0
2024-07-17 14:15,153,86,67,0,0,0
2024-07-17 14:30,180,99,81,0,0,0
2024-07-17 14:45,180,101,79,0,0,0
2024-07-17 15:00,164,95,69,0,0,0
2024-07-17 15:15,186,115,71,0,0,0
2024-07-17 15:30,183,82,101,0,0,0
2024-07-17 15:45,207,101,106,0,0,0
2024-07-17 16:00,213,129,84,0,0,0
2024-07-17 16:15,207,104,103,0,0,0
2024-07-17 16:30,204,99,105,0,0,0
2024-07-17 16:45,223,116,107,0,0,0
2024-07-17 17:00,194,105,89,0,0,0
2024-07-17 17:15,258,146,112,0,0,0
2024-07-17 17:30,221,122,99,0,0,0
2024-07-17 17:45,257,147,110,0,0,0
2024-07-17 18:00,246,155,91,0,0,0
2024-07-17 18:15,210,124,86,0,0,0
2024-07-17 18:30,171,93,78,0,0,0
2024-07-17 18:45,194,97,97,0,0,0
2024-07-17 19:00,171,103,68,0,0,0
2024-07-17 19:15,170,100,70,0,0,0
2024-07-17 19:30,137,72,65,0,0,0
2024-07-17 19:45,149,88,61,0,0,0
2024-07-17 20:00,119,63,56,0,0,0
2024-07-17 20:15,131,67,64,0,0,0
2024-07-17 20:30,108,69,39,0,0,0
2024-07-17 20:45,92,48,44,0,0,0
2024-07-17 21:00,100,49,51,0,0,0
2024-07-17 21:15,88,46,42,0,0,0
2024-07-17 21:30,88,47,41,0,0,0
2024-07-17 21:45,88,47,41,0,0,0
2024-07-17 22:00,76,44,32,0,0,0
2024-07-17 22:15,77,24,53,0,0,0
2024-07-17 22:30,71,31,40,0,0,0
2024-07-17 22:45,59,39,20,0,0,0
2024-07-17 23:00,63,24,39,0,0,0
2024-07-17 23:15,48,24,24,0,0,0
2024-07-17 23:30,28,15,13,0,0,0
2024-07-17 23:45,35,17,18,0,0,0
2024-07-18 00:00,40,19,21,0,0,0
2024-07-18 00:15,23,11,12,0,0,0
2024-07-18 00:30,19,9,10,0,0,0
2024-07-18 00:45,26,11,15,0,0,0
2024-07-18 01:00,13,2,11,0,0,0
2024-07-18 01:15,11,6,5,0,0,0
2024-07-18 01:30,9,2,7,0,0,0
2024-07-18 01:45,2,1,1,0,0,0
2024-07-18 02:00,6,2,4,0,0,0
2024-07-18 02:15,4,3,1,0,0,0
2024-07-18 02:30,5,2,3,0,0,0
2024-07-18 02:45,5,3,2,0,0,0
2024-07-18 03:00,8,4,4,0,0,0
2024-07-18 03:15,2,1,1,0,0,0
2024-07-18 03:30,3,3,0,0,0,0
2024-07-18 03:45,6,3,3,0,0,0
2024-07-18 04:00,3,1,2,0,0,0
2024-07-18 04:15,1,1,0,0,0,0
2024-07-18 04:30,5,1,4,0,0,0
2024-07-18 04:45,7,4,3,0,0,0
2024-07-18 05:00,3,2,1,0,0,0
2024-07-18 05:15,7,4,3,0,0,0
2024-07-18 05:30,20,11,9,0,0,0
2024-07-18 05:45,27,9,18,0,0,0
2024-07-18 06:00,23,15,8,0,0,0
2024-07-18 06:15,60,20,40,0,0,0
2024-07-18 06:30,54,23,31,0,0,0
2024-07-18 06:45,77,29,48,0,0,0
2024-07-18 07:00,79,23,56,0,0,0
2024-07-18 07:15,122,41,81,0,0,0
2024-07-18 07:30,175,46,129,0,0,0
2024-07-18 07:45,220,47,173,0,0,0
2024-07-18 08:00,181,50,131,0,0,0
2024-07-18 08:15,169,59,110,0,0,0
2024-07-18 08:30,177,49,128,0,0,0
2024-07-18 08:45,217,60,157,0,0,0
2024-07-18 09:00,133,44,89,0,0,0
2024-07-18 09:15,140,50,90,0,0,0
2024-07-18 09:30,144,52,92,0,0,0
2024-07-18 09:45,143,44,99,0,0,0
2024-07-18 10:00,135,45,90,0,0,0
2024-07-18 10:15,107,30,77,0,0,0
2024-07-18 10:30,112,39,73,0,0,0
2024-07-18 10:45,146,52,94,0,0,0
2024-07-18 11:00,131,59,72,0,0,0
2024-07-18 11:15,135,46,89,0,0,0
2024-07-18 11:30,152,65,87,0,0,0
2024-07-18 11:45,157,62,95,0,0,0
2024-07-18 12:00,175,74,101,0,0,0
2024-07-18 12:15,139,74,65,0,0,0
2024-07-18 12:30,166,78,88,0,0,0
2024-07-18 12:45,158,75,83,0,0,0
2024-07-18 13:00,154,81,73,0,0,0
2024-07-18 13:15,156,90,66,0,0,0
2024-07-18 13:30,154,81,73,0,0,0
2024-07-18 13:45,170,87,83,0,0,0
2024-07-18 14:00,182,99,83,0,0,0
2024-07-18 14:15,182,93,89,0,0,0
2024-07-18 14:30,140,66,74,0,0,0
2024-07-18 14:45,182,91,91,0,0,0
2024-07-18 15:00,166,86,80,0,0,0
2024-07-18 15:15,200,118,82,0,0,0
2024-07-18 15:30,195,109,86,0,0,0
2024-07-18 15:45,202,105,97,0,0,0
2024-07-18 16:00,231,114,117,0,0,0
2024-07-18 16:15,225,110,115,0,0,0
2024-07-18 16:30,239,128,111,0,0,0
2024-07-18 16:45,252,134,118,0,0,0
2024-07-18 17:00,228,131,97,0,0,0
2024-07-18 17:15,276,152,124,0,0,0
2024-07-18 17:30,271,148,123,0,0,0
2024-07-18 17:45,258,154,104,0,0,0
2024-07-18 18:00,265,167,98,0,0,0
2024-07-18 18:15,201,110,91,0,0,0
2024-07-18 18:30,209,118,91,0,0,0
2024-07-18 18:45,224,130,94,0,0,0
2024-07-18 19:00,199,107,92,0,0,0
2024-07-18 19:15,196,104,92,0,0,0
2024-07-18 19:30,160,94,66,0,0,0
2024-07-18 19:45,141,88,53,0,0,0
2024-07-18 20:00,172,97,75,0,0,0
2024-07-18 20:15,133,70,63,0,0,0
2024-07-18 20:30,119,62,57,0,0,0
2024-07-18 20:45,118,55,63,0,0,0
2024-07-18 21:00,111,48,63,0,0,0
2024-07-18 21:15,119,63,56,0,0,0
2024-07-18 21:30,95,48,47,0,0,0
2024-07-18 21:45,120,50,70,0,0,0
2024-07-18 22:00,103,46,57,0,0,0
2024-07-18 22:15,101,42,59,0,0,0
2024-07-18 22:30,93,47,46,0,0,0
2024-07-18 22:45,87,37,50,0,0,0
2024-07-18 23:00,57,26,31,0,0,0
2024-07-18 23:15,53,24,29,0,0,0
2024-07-18 23:30,41,18,23,0,0,0
2024-07-18 23:45,40,12,28,0,0,0
2024-07-19 00:00,22,3,19,0,0,0
2024-07-19 00:15,16,10,6,0,0,0
2024-07-19 00:30,11,5,6,0,0,0
2024-07-19 00:45,16,6,10,0,0,0
2024-07-19 01:00,13,8,5,0,0,0
2024-07-19 01:15,15,5,10,0,0,0
2024-07-19 01:30,6,3,3,0,0,0
2024-07-19 01:45,9,6,3,0,0,0
2024-07-19 02:00,7,2,5,0,0,0
2024-07-19 02:15,6,1,5,0,0,0
2024-07-19 02:30,8,3,5,0,0,0
2024-07-19 02:45,3,3,0,0,0,0
2024-07-19 03:00,1,0,1,0,0,0
2024-07-19 03:15,0,0,0,0,0,0
2024-07-19 03:30,1,1,0,0,0,0
2024-07-19 03:45,1,0,1,0,0,0
2024-07-19 04:00,7,4,3,0,0,0
2024-07-19 04:15,6,0,6,0,0,0
2024-07-19 04:30,5,2,3,0,0,0
2024-07-19 04:45,5,1,4,0,0,0
2024-07-19 05:00,4,2,2,0,0,0
2024-07-19 05:15,8,6,2,0,0,0
2024-07-19 05:30,16,7,9,0,0,0
2024-07-19 05:45,21,7,14,0,0,0
2024-07-19 06:00,29,11,18,0,0,0
2024-07-19 06:15,38,11,27,0,0,0
2024-07-19 06:30,53,23,30,0,0,0
2024-07-19 06:45,69,28,41,0,0,0
2024-07-19 07:00,69,18,51,0,0,0
2024-07-19 07:15,99,41,58,0,0,0
2024-07-19 07:30,129,37,92,0,0,0
2024-07-19 07:45,172,43,129,0,0,0
2024-07-19 08:00,130,36,94,0,0,0
2024-07-19 08:15,132,39,93,0,0,0
2024-07-19 08:30,155,58,97,0,0,0
2024-07-19 08:45,178,43,135,0,0,0
2024-07-19 09:00,110,36,74,0,0,0
2024-07-19 09:15,127,38,89,0,0,0
2024-07-19 09:30,120,30,90,0,0,0
2024-07-19 09:45,142,52,90,0,0,0
2024-07-19 10:00,139,51,88,0,0,0
2024-07-19 10:15,114,50,64,0,0,0
2024-07-19 10:30,125,44,81,0,0,0
2024-07-19 10:45,120,47,73,0,0,0
2024-07-19 11:00,114,47,67,0,0,0
2024-07-19 11:15,131,45,86,0,0,0
2024-07-19 11:30,135,62,73,0,0,0
2024-07-19 11:45,134,64,70,0,0,0
2024-07-19 12:00,196,103,93,0,0,0
2024-07-19 12:15,141,66,75,0,0,0
2024-07-19 12:30,152,77,75,0,0,0
2024-07-19 12:45,157,70,87,0,0,0
2024-07-19 13:00,169,93,76,0,0,0
2024-07-19 13:15,166,75,91,0,0,0
2024-07-19 13:30,155,78,77,0,0,0
2024-07-19 13:45,212,103,109,0,0,0
2024-07-19 14:00,163,89,74,0,0,0
2024-07-19 14:15,174,93,81,0,0,0
2024-07-19 14:30,152,78,74,0,0,0
2024-07-19 14:45,174,96,78,0,0,0
2024-07-19 15:00,174,97,77,0,0,0
2024-07-19 15:15,183,99,84,0,0,0
2024-07-19 15:30,174,90,84,0,0,0
2024-07-19 15:45,195,106,89,0,0,0
2024-07-19 16:00,183,98,85,0,0,0
2024-07-19 16:15,170,80,90,0,0,0
2024-07-19 16:30,172,93,79,0,0,0
2024-07-19 16:45,168,90,78,0,0,0
2024-07-19 17:00,191,97,94,0,0,0
2024-07-19 17:15,209,127,82,0,0,0
2024-07-19 17:30,160,76,84,0,0,0
2024-07-19 17:45,165,98,67,0,0,0
2024-07-19 18:00,194,115,79,0,0,0
2024-07-19 18:15,198,118,80,0,0,0
2024-07-19 18:30,162,84,78,0,0,0
2024-07-19 18:45,189,87,102,0,0,0
2024-07-19 19:00,180,113,67,0,0,0
2024-07-19 19:15,155,84,71,0,0,0
2024-07-19 19:30,185,102,83,0,0,0
2024-07-19 19:45,162,75,87,0,0,0
2024-07-19 20:00,164,85,79,0,0,0
2024-07-19 20:15,129,62,67,0,0,0
2024-07-19 20:30,143,59,84,0,0,0
2024-07-19 20:45,131,59,72,0,0,0
2024-07-19 21:00,95,41,54,0,0,0
2024-07-19 21:15,118,52,66,0,0,0
2024-07-19 21:30,94,42,52,0,0,0
2024-07-19 21:45,105,28,77,0,0,0
2024-07-19 22:00,108,44,64,0,0,0
2024-07-19 22:15,94,43,51,0,0,0
2024-07-19 22:30,106,27,79,0,0,0
2024-07-19 22:45,79,33,46,0,0,0
2024-07-19 23:00,83,55,28,0,0,0
2024-07-19 23:15,90,59,31,0,0,0
2024-07-19 23:30,77,43,34,0,0,0
2024-07-19 23:45,64,39,25,0,0,0
2024-07-20 00:00,61,37,24,0,0,0
2024-07-20 00:15,63,29,34,0,0,0
2024-07-20 00:30,43,21,22,0,0,0
2024-07-20 00:45,46,20,26,0,0,0
2024-07-20 01:00,36,18,18,0,0,0
2024-07-20 01:15,31,15,16,0,0,0
2024-07-20 01:30,42,25,17,0,0,0
2024-07-20 01:45,20,8,12,0,0,0
2024-07-20 02:00,26,9,17,0,0,0
2024-07-20 02:15,26,15,11,0,0,0
2024-07-20 02:30,27,17,10,0,0,0
2024-07-20 02:45,20,12,8,0,0,0
2024-07-20 03:00,7,3,4,0,0,0
2024-07-20 03:15,11,5,6,0,0,0
2024-07-20 03:30,12,7,5,0,0,0
2024-07-20 03:45,7,3,4,0,0,0
2024-07-20 04:00,9,4,5,0,0,0
2024-07-20 04:15,9,6,3,0,0,0
2024-07-20 04:30,12,4,8,0,0,0
2024-07-20 04:45,12,5,7,0,0,0
2024-07-20 05:00,5,3,2,0,0,0
2024-07-20 05:15,5,4,1,0,0,0
2024-07-20 05:30,9,0,9,0,0,0
2024-07-20 05:45,11,4,7,0,0,0
2024-07-20 06:00,15,6,9,0,0,0
2024-07-20 06:15,15,3,12,0,0,0
2024-07-20 06:30,12,7,5,0,0,0
2024-07-20 06:45,16,6,10,0,0,0
2024-07-20 07:00,18,5,13,0,0,0
2024-07-20 07:15,21,6,15,0,0,0
2024-07-20 07:30,40,10,30,0,0,0
2024-07-20 07:45,47,12,35,0,0,0
2024-07-20 08:00,62,23,39,0,0,0
2024-07-20 08:15,52,19,33,0,0,0
2024-07-20 08:30,84,26,58,0,0,0
2024-07-20 08:45,101,33,68,0,0,0
2024-07-20 09:00,76,30,46,0,0,0
2024-07-20 09:15,95,37,58,0,0,0
2024-07-20 09:30,128,35,93,0,0,0
2024-07-20 09:45,148,36,112,0,0,0
2024-07-20 10:00,134,41,93,0,0,0
2024-07-20 10:15,128,41,87,0,0,0
2024-07-20 10:30,174,49,125,0,0,0
2024-07-20 10:45,193,82,111,0,0,0
2024-07-20 11:00,134,53,81,0,0,0
2024-07-20 11:15,154,64,90,0,0,0
2024-07-20 11:30,166,70,96,0,0,0
2024-07-20 11:45,193,66,127,0,0,0
2024-07-20 12:00,125,57,68,0,0,0
2024-07-20 12:15,175,82,93,0,0,0
2024-07-20 12:30,166,97,69,0,0,0
2024-07-20 12:45,178,82,96,0,0,0
2024-07-20 13:00,160,74,86,0,0,0
2024-07-20 13:15,183,89,94,0,0,0
2024-07-20 13:30,158,96,62,0,0,0
2024-07-20 13:45,190,87,103,0,0,0
2024-07-20 14:00,169,120,49,0,0,0
2024-07-20 14:15,167,104,63,0,0,0
2024-07-20 14:30,154,96,58,0,0,0
2024-07-20 14:45,149,91,58,0,0,0
2024-07-20 15:00,161,97,64,0,0,0
2024-07-20 15:15,155,93,62,0,0,0
2024-07-20 15:30,155,84,71,0,0,0
2024-07-20 15:45,151,105,46,0,0,0
2024-07-20 16:00,145,89,56,0,0,0
2024-07-20 16:15,133,85,48,0,0,0
2024-07-20 16:30,139,70,69,0,0,0
2024-07-20 16:45,149,84,65,0,0,0
2024-07-20 17:00,171,92,79,0,0,0
2024-07-20 17:15,173,89,84,0,0,0
2024-07-20 17:30,126,68,58,0,0,0
2024-07-20 17:45,164,97,67,0,0,0
2024-07-20 18:00,174,95,79,0,0,0
2024-07-20 18:15,152,81,71,0,0,0
2024-07-20 18:30,147,85,62,0,0,0
2024-07-20 18:45,168,74,94,0,0,0
2024-07-20 19:00,155,57,98,0,0,0
2024-07-20 19:15,168,65,103,0,0,0
2024-07-20 19:30,146,73,73,0,0,0
2024-07-20 19:45,145,50,95,0,0,0
2024-07-20 20:00,139,62,77,0,0,0
2024-07-20 20:15,146,63,83,0,0,0
2024-07-20 20:30,106,51,55,0,0,0
2024-07-20 20:45,106,38,68,0,0,0
2024-07-20 21:00,130,52,78,0,0,0
2024-07-20 21:15,112,51,61,0,0,0
2024-07-20 21:30,110,28,82,0,0,0
2024-07-20 21:45,107,39,68,0,0,0
2024-07-20 22:00,82,40,42,0,0,0
2024-07-20 22:15,104,32,72,0,0,0
2024-07-20 22:30,79,35,44,0,0,0
2024-07-20 22:45,78,36,42,0,0,0
2024-07-20 23:00,81,43,38,0,0,0
2024-07-20 23:15,71,34,37,0,0,0
2024-07-20 23:30,73,27,46,0,0,0
2024-07-20 23:45,77,28,49,0,0,0
2024-07-21 00:00,62,30,32,0,0,0
2024-07-21 00:15,62,31,31,0,0,0
2024-07-21 00:30,51,23,28,0,0,0
2024-07-21 00:45,27,9,18,0,0,0
2024-07-21 01:00,36,12,24,0,0,0
2024-07-21 01:15,21,7,14,0,0,0
2024-07-21 01:30,19,4,15,0,0,0
2024-07-21 01:45,22,7,15,0,0,0
2024-07-21 02:00,25,10,15,0,0,0
2024-07-21 02:15,29,11,18,0,0,0
2024-07-21 02:30,15,8,7,0,0,0
2024-07-21 02:45,16,8,8,0,0,0
2024-07-21 03:00,11,5,6,0,0,0
2024-07-21 03:15,21,5,16,0,0,0
2024-07-21 03:30,13,3,10,0,0,0
2024-07-21 03:45,12,4,8,0,0,0
2024-07-21 04:00,10,6,4,0,0,0
2024-07-21 04:15,10,1,9,0,0,0
2024-07-21 04:30,9,2,7,0,0,0
2024-07-21 04:45,6,2,4,0,0,0
2024-07-21 05:00,4,2,2,0,0,0
2024-07-21 05:15,11,1,10,0,0,0
2024-07-21 05:30,13,2,11,0,0,0
2024-07-21 05:45,11,3,8,0,0,0
2024-07-21 06:00,7,4,3,0,0,0
2024-07-21 06:15,6,0,6,0,0,0
2024-07-21 06:30,7,4,3,0,0,0
2024-07-21 06:45,11,5,6,0,0,0
2024-07-21 07:00,6,6,0,0,0,0
2024-07-21 07:15,11,7,4,0,0,0
2024-07-21 07:30,8,2,6,0,0,0
2024-07-21 07:45,18,3,15,0,0,0
2024-07-21 08:00,22,9,13,0,0,0
2024-07-21 08:15,21,14,7,0,0,0
2024-07-21 08:30,20,6,14,0,0,0
2024-07-21 08:45,44,18,26,0,0,0
2024-07-21 09:00,25,9,16,0,0,0
2024-07-21 09:15,40,16,24,0,0,0
2024-07-21 09:30,24,0,24,0,0,0
2024-07-21 09:45,24,4,20,0,0,0
2024-07-21 10:00,89,32,57,0,0,0
2024-07-21 10:15,54,22,32,0,0,0
2024-07-21 10:30,84,30,54,0,0,0
2024-07-21 10:45,71,25,46,0,0,0
2024-07-21 11:00,78,31,47,0,0,0
2024-07-21 11:15,83,36,47,0,0,0
2024-07-21 11:30,85,39,46,0,0,0
2024-07-21 11:45,107,37,70,0,0,0
2024-07-21 12:00,80,47,33,0,0,0
2024-07-21 12:15,87,44,43,0,0,0
2024-07-21 12:30,78,35,43,0,0,0
2024-07-21 12:45,78,33,45,0,0,0
2024-07-21 13:00,65,30,35,0,0,0
2024-07-21 13:15,38,17,21,0,0,0
2024-07-21 13:30,59,32,27,0,0,0
2024-07-21 13:45,69,36,33,0,0,0
2024-07-21 14:00,89,38,51,0,0,0
2024-07-21 14:15,69,34,35,0,0,0
2024-07-21 14:30,85,42,43,0,0,0
2024-07-21 14:45,72,33,39,0,0,0
2024-07-21 15:00,83,52,31,0,0,0
2024-07-21 15:15,80,42,38,0,0,0
2024-07-21 15:30,58,26,32,0,0,0
2024-07-21 15:45,75,36,39,0,0,0
2024-07-21 16:00,62,28,34,0,0,0
2024-07-21 16:15,63,35,28,0,0,0
2024-07-21 16:30,83,47,36,0,0,0
2024-07-21 16:45,87,28,59,0,0,0
2024-07-21 17:00,90,46,44,0,0,0
2024-07-21 17:15,115,55,60,0,0,0
2024-07-21 17:30,103,59,44,0,0,0
2024-07-21 17:45,92,37,55,0,0,0
2024-07-21 18:00,77,38,39,0,0,0
2024-07-21 18:15,66,36,30,0,0,0
2024-07-21 18:30,70,33,37,0,0,0
2024-07-21 18:45,87,58,29,0,0,0
2024-07-21 19:00,85,38,47,0,0,0
2024-07-21 19:15,75,43,32,0,0,0
2024-07-21 19:30,68,30,38,0,0,0
2024-07-21 19:45,62,27,35,0,0,0
2024-07-21 20:00,81,33,48,0,0,0
2024-07-21 20:15,52,35,17,0,0,0
2024-07-21 20:30,55,19,36,0,0,0
2024-07-21 20:45,41,19,22,0,0,0
2024-07-21 21:00,34,20,14,0,0,0
2024-07-21 21:15,39,14,25,0,0,0
2024-07-21 21:30,41,19,22,0,0,0
2024-07-21 21:45,35,14,21,0,0,0
2024-07-21 22:00,38,21,17,0,0,0
2024-07-21 22:15,19,6,13,0,0,0
2024-07-21 22:30,18,6,12,0,0,0
2024-07-21 22:45,10,4,6,0,0,0
2024-07-21 23:00,15,8,7,0,0,0
2024-07-21 23:15,13,6,7,0,0,0
2024-07-21 23:30,11,7,4,0,0,0
2024-07-21 23:45,8,5,3,0,0,0
2024-07-22 00:00,8,4,4,0,0,0
2024-07-22 00:15,7,1,6,0,0,0
2024-07-22 00:30,5,3,2,0,0,0
2024-07-22 00:45,2,2,0,0,0,0
2024-07-22 01:00,1,1,0,0,0,0
2024-07-22 01:15,0,0,0,0,0,0
2024-07-22 01:30,2,2,0,0,0,0
2024-07-22 01:45,1,1,0,0,0,0
2024-07-22 02:00,2,0,2,0,0,0
2024-07-22 02:15,4,2,2,0,0,0
2024-07-22 02:30,2,0,2,0,0,0
2024-07-22 02:45,6,3,3,0,0,0
2024-07-22 03:00,0,0,0,0,0,0
2024-07-22 03:15,0,0,0,0,0,0
2024-07-22 03:30,0,0,0,0,0,0
2024-07-22 03:45,2,0,2,0,0,0
2024-07-22 04:00,1,1,0,0,0,0
2024-07-22 04:15,3,2,1,0,0,0
2024-07-22 04:30,4,0,4,0,0,0
2024-07-22 04:45,4,3,1,0,0,0
2024-07-22 05:00,5,3,2,0,0,0
2024-07-22 05:15,12,8,4,0,0,0
2024-07-22 05:30,16,5,11,0,0,0
2024-07-22 05:45,28,5,23,0,0,0
2024-07-22 06:00,26,12,14,0,0,0
2024-07-22 06:15,38,13,25,0,0,0
2024-07-22 06:30,75,29,46,0,0,0
2024-07-22 06:45,85,38,47,0,0,0
2024-07-22 07:00,81,38,43,0,0,0
2024-07-22 07:15,101,27,74,0,0,0
2024-07-22 07:30,138,34,104,0,0,0
2024-07-22 07:45,199,63,136,0,0,0
2024-07-22 08:00,144,42,102,0,0,0
2024-07-22 08:15,159,52,107,0,0,0
2024-07-22 08:30,167,50,117,0,0,0
2024-07-22 08:45,171,51,120,0,0,0
2024-07-22 09:00,137,35,102,0,0,0
2024-07-22 09:15,109,34,75,0,0,0
2024-07-22 09:30,110,32,78,0,0,0
2024-07-22 09:45,144,49,95,0,0,0
2024-07-22 10:00,113,41,72,0,0,0
2024-07-22 10:15,102,45,57,0,0,0
2024-07-22 10:30,134,54,80,0,0,0
2024-07-22 10:45,126,45,81,0,0,0
2024-07-22 11:00,122,45,77,0,0,0
2024-07-22 11:15,117,45,72,0,0,0
2024-07-22 11:30,132,53,79,0,0,0
2024-07-22 11:45,135,57,78,0,0,0
2024-07-22 12:00,138,77,61,0,0,0
2024-07-22 12:15,130,57,73,0,0,0
2024-07-22 12:30,112,54,58,0,0,0
2024-07-22 12:45,146,72,74,0,0,0
2024-07-22 13:00,147,75,72,0,0,0
2024-07-22 13:15,129,64,65,0,0,0
2024-07-22 13:30,142,50,92,0,0,0
2024-07-22 13:45,145,65,80,0,0,0
2024-07-22 14:00,121,55,66,0,0,0
2024-07-22 14:15,174,74,100,0,0,0
2024-07-22 14:30,128,69,59,0,0,0
2024-07-22 14:45,184,86,98,0,0,0
2024-07-22 15:00,188,102,86,0,0,0
2024-07-22 15:15,169,90,79,0,0,0
2024-07-22 15:30,186,92,94,0,0,0
2024-07-22 15:45,188,91,97,0,0,0
2024-07-22 16:00,217,115,102,0,0,0
2024-07-22 16:15,238,134,104,0,0,0
2024-07-22 16:30,203,94,109,0,0,0
2024-07-22 16:45,254,125,129,0,0,0
2024-07-22 17:00,234,131,103,0,0,0
2024-07-22 17:15,236,125,111,0,0,0
2024-07-22 17:30,200,119,81,0,0,0
2024-07-22 17:45,255,141,114,0,0,0
2024-07-22 18:00,229,123,106,0,0,0
2024-07-22 18:15,193,102,91,0,0,0
2024-07-22 18:30,223,139,84,0,0,0
2024-07-22 18:45,215,127,88,0,0,0
2024-07-22 19:00,177,98,79,0,0,0
2024-07-22 19:15,139,79,60,0,0,0
2024-07-22 19:30,128,66,62,0,0,0
2024-07-22 19:45,160,90,70,0,0,0
2024-07-22 20:00,130,85,45,0,0,0
2024-07-22 20:15,105,66,39,0,0,0
2024-07-22 20:30,103,56,47,0,0,0
2024-07-22 20:45,71,29,42,0,0,0
2024-07-22 21:00,68,36,32,0,0,0
2024-07-22 21:15,75,45,30,0,0,0
2024-07-22 21:30,73,46,27,0,0,0
2024-07-22 21:45,78,45,33,0,0,0
2024-07-22 22:00,49,28,21,0,0,0
2024-07-22 22:15,64,36,28,0,0,0
2024-07-22 22:30,57,23,34,0,0,0
2024-07-22 22:45,51,21,30,0,0,0
2024-07-22 23:00,41,24,17,0,0,0
2024-07-22 23:15,30,13,17,0,0,0
2024-07-22 23:30,28,14,14,0,0,0
2024-07-22 23:45,34,21,13,0,0,0
2024-07-23 00:00,14,12,2,0,0,0
2024-07-23 00:15,10,5,5,0,0,0
2024-07-23 00:30,24,11,13,0,0,0
2024-07-23 00:45,10,3,7,0,0,0
2024-07-23 01:00,12,6,6,0,0,0
2024-07-23 01:15,9,2,7,0,0,0
2024-07-23 01:30,6,3,3,0,0,0
2024-07-23 01:45,4,3,1,0,0,0
2024-07-23 02:00,1,0,1,0,0,0
2024-07-23 02:15,3,2,1,0,0,0
2024-07-23 02:30,6,4,2,0,0,0
2024-07-23 02:45,1,0,1,0,0,0
2024-07-23 03:00,1,1,0,0,0,0
2024-07-23 03:15,2,1,1,0,0,0
2024-07-23 03:30,2,1,1,0,0,0
2024-07-23 03:45,0,0,0,0,0,0
2024-07-23 04:00,1,0,1,0,0,0
2024-07-23 04:15,1,0,1,0,0,0
2024-07-23 04:30,8,4,4,0,0,0
2024-07-23 04:45,5,2,3,0,0,0
2024-07-23 05:00,6,5,1,0,0,0
2024-07-23 05:15,13,9,4,0,0,0
2024-07-23 05:30,12,4,8,0,0,0
2024-07-23 05:45,27,7,20,0,0,0
2024-07-23 06:00,22,10,12,0,0,0
2024-07-23 06:15,47,19,28,0,0,0
2024-07-23 06:30,58,20,38,0,0,0
2024-07-23 06:45,66,24,42,0,0,0
2024-07-23 07:00,81,38,43,0,0,0
2024-07-23 07:15,99,31,68,0,0,0
2024-07-23 07:30,149,47,102,0,0,0
2024-07-23 07:45,188,54,134,0,0,0
2024-07-23 08:00,148,43,105,0,0,0
2024-07-23 08:15,186,62,124,0,0,0
2024-07-23 08:30,170,50,120,0,0,0
2024-07-23 08:45,153,41,112,0,0,0
2024-07-23 09:00,124,41,83,0,0,0
2024-07-23 09:15,66,16,50,0,0,0
2024-07-23 09:30,71,23,48,0,0,0
2024-07-23 09:45,82,30,52,0,0,0
2024-07-23 10:00,56,23,33,0,0,0
2024-07-23 10:15,38,18,20,0,0,0
2024-07-23 10:30,39,23,16,0,0,0
2024-07-23 10:45,30,11,19,0,0,0
2024-07-23 11:00,32,16,16,0,0,0
2024-07-23 11:15,42,21,21,0,0,0
2024-07-23 11:30,71,33,38,0,0,0
2024-07-23 11:45,98,44,54,0,0,0
2024-07-23 12:00,78,39,39,0,0,0
2024-07-23 12:15,73,27,46,0,0,0
2024-07-23 12:30,80,34,46,0,0,0
2024-07-23 12:45,90,39,51,0,0,0
2024-07-23 13:00,104,41,63,0,0,0
2024-07-23 13:15,107,40,67,0,0,0
2024-07-23 13:30,94,47,47,0,0,0
2024-07-23 13:45,110,51,59,0,0,0
2024-07-23 14:00,115,54,61,0,0,0
2024-07-23 14:15,117,67,50,0,0,0
2024-07-23 14:30,120,51,69,0,0,0
2024-07-23 14:45,136,65,71,0,0,0
2024-07-23 15:00,130,78,52,0,0,0
2024-07-23 15:15,143,76,67,0,0,0
2024-07-23 15:30,152,77,75,0,0,0
2024-07-23 15:45,150,76,74,0,0,0
2024-07-23 16:00,132,75,57,0,0,0
2024-07-23 16:15,192,97,95,0,0,0
2024-07-23 16:30,168,86,82,0,0,0
2024-07-23 16:45,211,105,106,0,0,0
2024-07-23 17:00,164,80,84,0,0,0
2024-07-23 17:15,170,86,84,0,0,0
2024-07-23 17:30,180,105,75,0,0,0
2024-07-23 17:45,216,119,97,0,0,0
2024-07-23 18:00,194,115,79,0,0,0
2024-07-23 18:15,147,77,70,0,0,0
2024-07-23 18:30,165,92,73,0,0,0
2024-07-23 18:45,147,80,67,0,0,0
2024-07-23 19:00,134,68,66,0,0,0
2024-07-23 19:15,138,71,67,0,0,0
2024-07-23 19:30,115,56,59,0,0,0
2024-07-23 19:45,122,72,50,0,0,0
2024-07-23 20:00,91,45,46,0,0,0
2024-07-23 20:15,63,30,33,0,0,0
2024-07-23 20:30,54,25,29,0,0,0
2024-07-23 20:45,47,27,20,0,0,0
2024-07-23 21:00,47,27,20,0,0,0
2024-07-23 21:15,74,38,36,0,0,0
2024-07-23 21:30,57,33,24,0,0,0
2024-07-23 21:45,51,26,25,0,0,0
2024-07-23 22:00,37,23,14,0,0,0
2024-07-23 22:15,44,24,20,0,0,0
2024-07-23 22:30,55,31,24,0,0,0
2024-07-23 22:45,43,15,28,0,0,0
2024-07-23 23:00,39,15,24,0,0,0
2024-07-23 23:15,30,14,16,0,0,0
2024-07-23 23:30,15,9,6,0,0,0
2024-07-23 23:45,19,8,11,0,0,0
2024-07-24 00:00,17,9,8,0,0,0
2024-07-24 00:15,12,6,6,0,0,0
2024-07-24 00:30,7,3,4,0,0,0
2024-07-24 00:45,5,2,3,0,0,0
2024-07-24 01:00,5,3,2,0,0,0
2024-07-24 01:15,6,1,5,0,0,0
2024-07-24 01:30,6,4,2,0,0,0
2024-07-24 01:45,8,4,4,0,0,0
2024-07-24 02:00,6,2,4,0,0,0
2024-07-24 02:15,3,1,2,0,0,0
2024-07-24 02:30,4,3,1,0,0,0
2024-07-24 02:45,3,2,1,0,0,0
2024-07-24 03:00,0,0,0,0,0,0
2024-07-24 03:15,3,2,1,0,0,0
2024-07-24 03:30,2,1,1,0,0,0
2024-07-24 03:45,4,0,4,0,0,0
2024-07-24 04:00,0,0,0,0,0,0
2024-07-24 04:15,2,1,1,0,0,0
2024-07-24 04:30,3,2,1,0,0,0
2024-07-24 04:45,1,0,1,0,0,0
2024-07-24 05:00,11,7,4,0,0,0
2024-07-24 05:15,17,13,4,0,0,0
2024-07-24 05:30,19,10,9,0,0,0
2024-07-24 05:45,33,14,19,0,0,0
2024-07-24 06:00,28,9,19,0,0,0
2024-07-24 06:15,48,12,36,0,0,0
2024-07-24 06:30,59,17,42,0,0,0
2024-07-24 06:45,77,33,44,0,0,0
2024-07-24 07:00,80,29,51,0,0,0
2024-07-24 07:15,113,41,72,0,0,0
2024-07-24 07:30,157,39,118,0,0,0
2024-07-24 07:45,195,63,132,0,0,0
2024-07-24 08:00,160,49,111,0,0,0
2024-07-24 08:15,149,50,99,0,0,0
2024-07-24 08:30,160,55,105,0,0,0
2024-07-24 08:45,179,56,123,0,0,0
2024-07-24 09:00,126,37,89,0,0,0
2024-07-24 09:15,136,31,105,0,0,0
2024-07-24 09:30,148,39,109,0,0,0
2024-07-24 09:45,156,49,107,0,0,0
2024-07-24 10:00,139,36,103,0,0,0
2024-07-24 10:15,130,39,91,0,0,0
2024-07-24 10:30,149,50,99,0,0,0
2024-07-24 10:45,156,53,103,0,0,0
2024-07-24 11:00,142,48,94,0,0,0
2024-07-24 11:15,140,59,81,0,0,0
2024-07-24 11:30,157,69,88,0,0,0
2024-07-24 11:45,156,69,87,0,0,0
2024-07-24 12:00,144,59,85,0,0,0
2024-07-24 12:15,147,66,81,0,0,0
2024-07-24 12:30,166,74,92,0,0,0
2024-07-24 12:45,200,89,111,0,0,0
2024-07-24 13:00,173,101,72,0,0,0
2024-07-24 13:15,163,77,86,0,0,0
2024-07-24 13:30,162,74,88,0,0,0
2024-07-24 13:45,176,96,80,0,0,0
2024-07-24 14:00,167,81,86,0,0,0
2024-07-24 14:15,167,87,80,0,0,0
2024-07-24 14:30,168,95,73,0,0,0
2024-07-24 14:45,165,95,70,0,0,0
2024-07-24 15:00,160,83,77,0,0,0
2024-07-24 15:15,135,75,60,0,0,0
2024-07-24 15:30,175,81,94,0,0,0
2024-07-24 15:45,204,113,91,0,0,0
2024-07-24 16:00,215,119,96,0,0,0
2024-07-24 16:15,200,104,96,0,0,0
2024-07-24 16:30,193,105,88,0,0,0
2024-07-24 16:45,223,115,108,0,0,0
2024-07-24 17:00,227,125,102,0,0,0
2024-07-24 17:15,240,133,107,0,0,0
2024-07-24 17:30,228,115,113,0,0,0
2024-07-24 17:45,239,116,123,0,0,0
2024-07-24 18:00,218,116,102,0,0,0
2024-07-24 18:15,185,91,94,0,0,0
2024-07-24 18:30,170,103,67,0,0,0
2024-07-24 18:45,203,117,86,0,0,0
2024-07-24 19:00,179,101,78,0,0,0
2024-07-24 19:15,177,102,75,0,0,0
2024-07-24 19:30,160,80,80,0,0,0
2024-07-24 19:45,157,82,75,0,0,0
2024-07-24 20:00,165,101,64,0,0,0
2024-07-24 20:15,101,65,36,0,0,0
2024-07-24 20:30,111,64,47,0,0,0
2024-07-24 20:45,76,43,33,0,0,0
2024-07-24 21:00,89,56,33,0,0,0
2024-07-24 21:15,86,47,39,0,0,0
2024-07-24 21:30,92,44,48,0,0,0
2024-07-24 21:45,65,29,36,0,0,0
2024-07-24 22:00,77,35,42,0,0,0
2024-07-24 22:15,74,38,36,0,0,0
2024-07-24 22:30,68,36,32,0,0,0
2024-07-24 22:45,98,41,57,0,0,0
2024-07-24 23:00,55,25,30,0,0,0
2024-07-24 23:15,40,14,26,0,0,0
2024-07-24 23:30,39,22,17,0,0,0
2024-07-24 23:45,44,24,20,0,0,0
2024-07-25 00:00,33,17,16,0,0,0
2024-07-25 00:15,15,6,9,0,0,0
2024-07-25 00:30,29,17,12,0,0,0
2024-07-25 00:45,9,5,4,0,0,0
2024-07-25 01:00,13,8,5,0,0,0
2024-07-25 01:15,19,11,8,0,0,0
2024-07-25 01:30,8,5,3,0,0,0
2024-07-25 01:45,15,13,2,0,0,0
2024-07-25 02:00,16,5,11,0,0,0
2024-07-25 02:15,7,3,4,0,0,0
2024-07-25 02:30,8,3,5,0,0,0
2024-07-25 02:45,1,1,0,0,0,0
2024-07-25 03:00,5,2,3,0,0,0
2024-07-25 03:15,10,6,4,0,0,0
2024-07-25 03:30,3,3,0,0,0,0
2024-07-25 03:45,11,5,6,0,0,0
2024-07-25 04:00,0,0,0,0,0,0
2024-07-25 04:15,5,4,1,0,0,0
2024-07-25 04:30,4,3,1,0,0,0
2024-07-25 04:45,5,3,2,0,0,0
2024-07-25 05:00,8,5,3,0,0,0
2024-07-25 05:15,9,7,2,0,0,0
2024-07-25 05:30,20,7,13,0,0,0
2024-07-25 05:45,31,14,17,0,0,0
2024-07-25 06:00,31,10,21,0,0,0
2024-07-25 06:15,36,11,25,0,0,0
2024-07-25 06:30,52,22,30,0,0,0
2024-07-25 06:45,80,34,46,0,0,0
2024-07-25 07:00,69,18,51,0,0,0
2024-07-25 07:15,105,32,73,0,0,0
2024-07-25 07:30,155,46,109,0,0,0
2024-07-25 07:45,186,53,133,0,0,0
2024-07-25 08:00,140,50,90,0,0,0
2024-07-25 08:15,161,49,112,0,0,0
2024-07-25 08:30,176,59,117,0,0,0
2024-07-25 08:45,165,59,106,0,0,0
2024-07-25 09:00,111,39,72,0,0,0
2024-07-25 09:15,107,30,77,0,0,0
2024-07-25 09:30,124,40,84,0,0,0
2024-07-25 09:45,134,46,88,0,0,0
2024-07-25 10:00,109,34,75,0,0,0
2024-07-25 10:15,118,44,74,0,0,0
2024-07-25 10:30,121,41,80,0,0,0
2024-07-25 10:45,124,51,73,0,0,0
2024-07-25 11:00,113,40,73,0,0,0
2024-07-25 11:15,134,57,77,0,0,0
2024-07-25 11:30,124,49,75,0,0,0
2024-07-25 11:45,176,86,90,0,0,0
2024-07-25 12:00,125,58,67,0,0,0
2024-07-25 12:15,140,57,83,0,0,0
2024-07-25 12:30,116,48,68,0,0,0
2024-07-25 12:45,146,68,78,0,0,0
2024-07-25 13:00,156,71,85,0,0,0
2024-07-25 13:15,168,85,83,0,0,0
2024-07-25 13:30,128,58,70,0,0,0
2024-07-25 13:45,158,87,71,0,0,0
2024-07-25 14:00,146,77,69,0,0,0
2024-07-25 14:15,167,70,97,0,0,0
2024-07-25 14:30,156,81,75,0,0,0
2024-07-25 14:45,190,100,90,0,0,0
2024-07-25 15:00,151,79,72,0,0,0
2024-07-25 15:15,196,101,95,0,0,0
2024-07-25 15:30,213,104,109,0,0,0
2024-07-25 15:45,202,104,98,0,0,0
2024-07-25 16:00,201,112,89,0,0,0
2024-07-25 16:15,219,114,105,0,0,0
2024-07-25 16:30,222,113,109,0,0,0
2024-07-25 16:45,220,113,107,0,0,0
2024-07-25 17:00,208,117,91,0,0,0
2024-07-25 17:15,264,132,132,0,0,0
2024-07-25 17:30,232,119,113,0,0,0
2024-07-25 17:45,235,130,105,0,0,0
2024-07-25 18:00,219,124,95,0,0,0
2024-07-25 18:15,221,133,88,0,0,0
2024-07-25 18:30,213,105,108,0,0,0
2024-07-25 18:45,200,100,100,0,0,0
2024-07-25 19:00,201,106,95,0,0,0
2024-07-25 19:15,173,86,87,0,0,0
2024-07-25 19:30,122,60,62,0,0,0
2024-07-25 19:45,141,75,66,0,0,0
2024-07-25 20:00,132,72,60,0,0,0
2024-07-25 20:15,125,63,62,0,0,0
2024-07-25 20:30,85,42,43,0,0,0
2024-07-25 20:45,101,54,47,0,0,0
2024-07-25 21:00,92,49,43,0,0,0
2024-07-25 21:15,66,43,23,0,0,0
2024-07-25 21:30,97,51,46,0,0,0
2024-07-25 21:45,75,40,35,0,0,0
2024-07-25 22:00,68,25,43,0,0,0
2024-07-25 22:15,68,35,33,0,0,0
2024-07-25 22:30,57,21,36,0,0,0
2024-07-25 22:45,64,33,31,0,0,0
2024-07-25 23:00,50,25,25,0,0,0
2024-07-25 23:15,46,24,22,0,0,0
2024-07-25 23:30,23,17,6,0,0,0
2024-07-25 23:45,34,22,12,0,0,0
2024-07-26 00:00,92,86,6,0,0,0
2024-07-26 00:15,22,13,9,0,0,0
2024-07-26 00:30,14,10,4,0,0,0
2024-07-26 00:45,13,9,4,0,0,0
2024-07-26 01:00,12,9,3,0,0,0
2024-07-26 01:15,10,3,7,0,0,0
2024-07-26 01:30,10,4,6,0,0,0
2024-07-26 01:45,5,3,2,0,0,0
2024-07-26 02:00,8,3,5,0,0,0
2024-07-26 02:15,2,1,1,0,0,0
2024-07-26 02:30,5,3,2,0,0,0
2024-07-26 02:45,2,0,2,0,0,0
2024-07-26 03:00,3,0,3,0,0,0
2024-07-26 03:15,2,1,1,0,0,0
2024-07-26 03:30,1,1,0,0,0,0
2024-07-26 03:45,2,1,1,0,0,0
2024-07-26 04:00,4,1,3,0,0,0
2024-07-26 04:15,3,2,1,0,0,0
2024-07-26 04:30,6,3,3,0,0,0
2024-07-26 04:45,4,0,4,0,0,0
2024-07-26 05:00,4,4,0,0,0,0
2024-07-26 05:15,12,9,3,0,0,0
2024-07-26 05:30,15,9,6,0,0,0
2024-07-26 05:45,19,8,11,0,0,0
2024-07-26 06:00,21,8,13,0,0,0
2024-07-26 06:15,30,11,19,0,0,0
2024-07-26 06:30,39,18,21,0,0,0
2024-07-26 06:45,38,14,24,0,0,0
2024-07-26 07:00,52,25,27,0,0,0
2024-07-26 07:15,90,36,54,0,0,0
2024-07-26 07:30,119,34,85,0,0,0
2024-07-26 07:45,140,43,97,0,0,0
2024-07-26 08:00,96,28,68,0,0,0
2024-07-26 08:15,95,27,68,0,0,0
2024-07-26 08:30,102,39,63,0,0,0
2024-07-26 08:45,136,40,96,0,0,0
2024-07-26 09:00,79,24,55,0,0,0
2024-07-26 09:15,86,29,57,0,0,0
2024-07-26 09:30,94,29,65,0,0,0
2024-07-26 09:45,106,30,76,0,0,0
2024-07-26 10:00,83,25,58,0,0,0
2024-07-26 10:15,99,36,63,0,0,0
2024-07-26 10:30,92,39,53,0,0,0
2024-07-26 10:45,92,31,61,0,0,0
2024-07-26 11:00,102,48,54,0,0,0
2024-07-26 11:15,121,51,70,0,0,0
2024-07-26 11:30,101,43,58,0,0,0
2024-07-26 11:45,162,67,95,0,0,0
2024-07-26 12:00,121,53,68,0,0,0
2024-07-26 12:15,109,41,68,0,0,0
2024-07-26 12:30,158,71,87,0,0,0
2024-07-26 12:45,152,76,76,0,0,0
2024-07-26 13:00,119,64,55,0,0,0
2024-07-26 13:15,140,59,81,0,0,0
2024-07-26 13:30,162,88,74,0,0,0
2024-07-26 13:45,167,77,90,0,0,0
2024-07-26 14:00,138,66,72,0,0,0
2024-07-26 14:15,132,67,65,0,0,0
2024-07-26 14:30,154,96,58,0,0,0
2024-07-26 14:45,145,68,77,0,0,0
2024-07-26 15:00,139,69,70,0,0,0
2024-07-26 15:15,127,55,72,0,0,0
2024-07-26 15:30,150,76,74,0,0,0
2024-07-26 15:45,144,75,69,0,0,0
2024-07-26 16:00,142,68,74,0,0,0
2024-07-26 16:15,146,87,59,0,0,0
2024-07-26 16:30,157,84,73,0,0,0
2024-07-26 16:45,167,100,67,0,0,0
2024-07-26 17:00,156,89,67,0,0,0
2024-07-26 17:15,158,69,89,0,0,0
2024-07-26 17:30,164,94,70,0,0,0
2024-07-26 17:45,179,90,89,0,0,0
2024-07-26 18:00,160,89,71,0,0,0
2024-07-26 18:15,172,77,95,0,0,0
2024-07-26 18:30,161,83,78,0,0,0
2024-07-26 18:45,184,93,91,0,0,0
2024-07-26 19:00,144,87,57,0,0,0
2024-07-26 19:15,141,80,61,0,0,0
2024-07-26 19:30,112,66,46,0,0,0
2024-07-26 19:45,111,63,48,0,0,0
2024-07-26 20:00,148,89,59,0,0,0
2024-07-26 20:15,134,67,67,0,0,0
2024-07-26 20:30,105,48,57,0,0,0
2024-07-26 20:45,77,38,39,0,0,0
2024-07-26 21:00,82,38,44,0,0,0
2024-07-26 21:15,62,37,25,0,0,0
2024-07-26 21:30,67,40,27,0,0,0
2024-07-26 21:45,74,46,28,0,0,0
2024-07-26 22:00,72,33,39,0,0,0
2024-07-26 22:15,62,30,32,0,0,0
2024-07-26 22:30,68,29,39,0,0,0
2024-07-26 22:45,68,36,32,0,0,0
2024-07-26 23:00,50,28,22,0,0,0
2024-07-26 23:15,44,22,22,0,0,0
2024-07-26 23:30,41,18,23,0,0,0
2024-07-26 23:45,51,28,23,0,0,0
2024-07-27 00:00,54,33,21,0,0,0
2024-07-27 00:15,30,20,10,0,0,0
2024-07-27 00:30,35,15,20,0,0,0
2024-07-27 00:45,37,13,24,0,0,0
2024-07-27 01:00,47,21,26,0,0,0
2024-07-27 01:15,30,11,19,0,0,0
2024-07-27 01:30,20,11,9,0,0,0
2024-07-27 01:45,20,11,9,0,0,0
2024-07-27 02:00,25,14,11,0,0,0
2024-07-27 02:15,29,15,14,0,0,0
2024-07-27 02:30,18,8,10,0,0,0
2024-07-27 02:45,17,13,4,0,0,0
2024-07-27 03:00,15,10,5,0,0,0
2024-07-27 03:15,16,9,7,0,0,0
2024-07-27 03:30,25,9,16,0,0,0
2024-07-27 03:45,8,5,3,0,0,0
2024-07-27 04:00,9,3,6,0,0,0
2024-07-27 04:15,5,4,1,0,0,0
2024-07-27 04:30,20,14,6,0,0,0
2024-07-27 04:45,3,1,2,0,0,0
2024-07-27 05:00,8,5,3,0,0,0
2024-07-27 05:15,10,6,4,0,0,0
2024-07-27 05:30,19,6,13,0,0,0
2024-07-27 05:45,10,2,8,0,0,0
2024-07-27 06:00,4,2,2,0,0,0
2024-07-27 06:15,8,1,7,0,0,0
2024-07-27 06:30,9,1,8,0,0,0
2024-07-27 06:45,14,11,3,0,0,0
2024-07-27 07:00,17,4,13,0,0,0
2024-07-27 07:15,15,6,9,0,0,0
2024-07-27 07:30,21,7,14,0,0,0
2024-07-27 07:45,33,9,24,0,0,0
2024-07-27 08:00,33,14,19,0,0,0
2024-07-27 08:15,54,16,38,0,0,0
2024-07-27 08:30,60,23,37,0,0,0
2024-07-27 08:45,85,21,64,0,0,0
2024-07-27 09:00,59,19,40,0,0,0
2024-07-27 09:15,82,26,56,0,0,0
2024-07-27 09:30,123,38,85,0,0,0
2024-07-27 09:45,134,42,92,0,0,0
2024-07-27 10:00,135,47,88,0,0,0
2024-07-27 10:15,130,47,83,0,0,0
2024-07-27 10:30,128,28,100,0,0,0
2024-07-27 10:45,151,50,101,0,0,0
2024-07-27 11:00,149,58,91,0,0,0
2024-07-27 11:15,120,33,87,0,0,0
2024-07-27 11:30,160,45,115,0,0,0
2024-07-27 11:45,187,55,132,0,0,0
2024-07-27 12:00,190,83,107,0,0,0
2024-07-27 12:15,161,73,88,0,0,0
2024-07-27 12:30,158,84,74,0,0,0
2024-07-27 12:45,170,84,86,0,0,0
2024-07-27 13:00,188,88,100,0,0,0
2024-07-27 13:15,164,85,79,0,0,0
2024-07-27 13:30,180,107,73,0,0,0
2024-07-27 13:45,160,96,64,0,0,0
2024-07-27 14:00,161,84,77,0,0,0
2024-07-27 14:15,157,87,70,0,0,0
2024-07-27 14:30,135,77,58,0,0,0
2024-07-27 14:45,152,62,90,0,0,0
2024-07-27 15:00,109,64,45,0,0,0
2024-07-27 15:15,124,86,38,0,0,0
2024-07-27 15:30,111,68,43,0,0,0
2024-07-27 15:45,139,74,65,0,0,0
2024-07-27 16:00,160,88,72,0,0,0
2024-07-27 16:15,112,55,57,0,0,0
2024-07-27 16:30,91,56,35,0,0,0
2024-07-27 16:45,141,83,58,0,0,0
2024-07-27 17:00,121,72,49,0,0,0
2024-07-27 17:15,104,54,50,0,0,0
2024-07-27 17:30,138,100,38,0,0,0
2024-07-27 17:45,121,74,47,0,0,0
2024-07-27 18:00,87,54,33,0,0,0
2024-07-27 18:15,50,34,16,0,0,0
2024-07-27 18:30,47,29,18,0,0,0
2024-07-27 18:45,56,28,28,0,0,0
2024-07-27 19:00,48,30,18,0,0,0
2024-07-27 19:15,85,45,40,0,0,0
2024-07-27 19:30,97,51,46,0,0,0
2024-07-27 19:45,86,52,34,0,0,0
2024-07-27 20:00,84,52,32,0,0,0
2024-07-27 20:15,57,29,28,0,0,0
2024-07-27 20:30,59,26,33,0,0,0
2024-07-27 20:45,50,24,26,0,0,0
2024-07-27 21:00,50,28,22,0,0,0
2024-07-27 21:15,58,35,23,0,0,0
2024-07-27 21:30,52,22,30,0,0,0
2024-07-27 21:45,35,19,16,0,0,0
2024-07-27 22:00,33,19,14,0,0,0
2024-07-27 22:15,39,22,17,0,0,0
2024-07-27 22:30,42,21,21,0,0,0
2024-07-27 22:45,44,16,28,0,0,0
2024-07-27 23:00,48,22,26,0,0,0
2024-07-27 23:15,37,14,23,0,0,0
2024-07-27 23:30,36,17,19,0,0,0
2024-07-27 23:45,30,20,10,0,0,0
