Datetime,100020113 (Wolbecker Straße),101020113 (FR stdteinwärts),102020113 (FR stadtauswärts),100020113-status,101020113-status,102020113-status
2024-11-01 00:00,82,39,43,0,0,0
2024-11-01 00:15,92,50,42,0,0,0
2024-11-01 00:30,87,46,41,0,0,0
2024-11-01 00:45,63,27,36,0,0,0
2024-11-01 01:00,79,26,53,0,0,0
2024-11-01 01:15,90,32,58,0,0,0
2024-11-01 01:30,71,33,38,0,0,0
2024-11-01 01:45,87,50,37,0,0,0
2024-11-01 02:00,69,27,42,0,0,0
2024-11-01 02:15,75,39,36,0,0,0
2024-11-01 02:30,52,21,31,0,0,0
2024-11-01 02:45,63,25,38,0,0,0
2024-11-01 03:00,47,25,22,0,0,0
2024-11-01 03:15,64,21,43,0,0,0
2024-11-01 03:30,56,26,30,0,0,0
2024-11-01 03:45,30,14,16,0,0,0
2024-11-01 04:00,41,20,21,0,0,0
2024-11-01 04:15,29,9,20,0,0,0
2024-11-01 04:30,21,8,13,0,0,0
2024-11-01 04:45,15,4,11,0,0,0
2024-11-01 05:00,16,5,11,0,0,0
2024-11-01 05:15,18,8,10,0,0,0
2024-11-01 05:30,20,9,11,0,0,0
2024-11-01 05:45,21,12,9,0,0,0
2024-11-01 06:00,15,10,5,0,0,0
2024-11-01 06:15,7,2,5,0,0,0
2024-11-01 06:30,5,1,4,0,0,0
2024-11-01 06:45,20,10,10,0,0,0
2024-11-01 07:00,12,5,7,0,0,0
2024-11-01 07:15,8,4,4,0,0,0
2024-11-01 07:30,13,6,7,0,0,0
2024-11-01 07:45,20,9,11,0,0,0
2024-11-01 08:00,13,7,6,0,0,0
2024-11-01 08:15,16,9,7,0,0,0
2024-11-01 08:30,19,3,16,0,0,0
2024-11-01 08:45,26,9,17,0,0,0
2024-11-01 09:00,17,7,10,0,0,0
2024-11-01 09:15,30,17,13,0,0,0
2024-11-01 09:30,43,18,25,0,0,0
2024-11-01 09:45,60,21,39,0,0,0
2024-11-01 10:00,50,23,27,0,0,0
2024-11-01 10:15,55,21,34,0,0,0
2024-11-01 10:30,59,23,36,0,0,0
2024-11-01 10:45,78,41,37,0,0,0
2024-11-01 11:00,71,34,37,0,0,0
2024-11-01 11:15,81,45,36,0,0,0
2024-11-01 11:30,68,36,32,0,0,0
2024-11-01 11:45,79,37,42,0,0,0
2024-11-01 12:00,71,37,34,0,0,0
2024-11-01 12:15,78,42,36,0,0,0
2024-11-01 12:30,67,28,39,0,0,0
2024-11-01 12:45,101,49,52,0,0,0
2024-11-01 13:00,79,47,32,0,0,0
2024-11-01 13:15,77,39,38,0,0,0
2024-11-01 13:30,60,18,42,0,0,0
2024-11-01 13:45,92,37,55,0,0,0
2024-11-01 14:00,87,36,51,0,0,0
2024-11-01 14:15,88,53,35,0,0,0
2024-11-01 14:30,62,28,34,0,0,0
2024-11-01 14:45,81,40,41,0,0,0
2024-11-01 15:00,71,40,31,0,0,0
2024-11-01 15:15,68,34,34,0,0,0
2024-11-01 15:30,84,37,47,0,0,0
2024-11-01 15:45,101,47,54,0,0,0
2024-11-01 16:00,82,39,43,0,0,0
2024-11-01 16:15,86,44,42,0,0,0
2024-11-01 16:30,87,49,38,0,0,0
2024-11-01 16:45,76,36,40,0,0,0
2024-11-01 17:00,106,53,53,0,0,0
2024-11-01 17:15,94,48,46,0,0,0
2024-11-01 17:30,101,35,66,0,0,0
2024-11-01 17:45,83,42,41,0,0,0
2024-11-01 18:00,99,39,60,0,0,0
2024-11-01 18:15,89,39,50,0,0,0
2024-11-01 18:30,65,32,33,0,0,0
2024-11-01 18:45,85,42,43,0,0,0
2024-11-01 19:00,77,32,45,0,0,0
2024-11-01 19:15,77,43,34,0,0,0
2024-11-01 19:30,78,34,44,0,0,0
2024-11-01 19:45,72,25,47,0,0,0
2024-11-01 20:00,69,40,29,0,0,0
2024-11-01 20:15,84,40,44,0,0,0
2024-11-01 20:30,55,19,36,0,0,0
2024-11-01 20:45,61,24,37,0,0,0
2024-11-01 21:00,58,37,21,0,0,0
2024-11-01 21:15,63,39,24,0,0,0
2024-11-01 21:30,45,24,21,0,0,0
2024-11-01 21:45,45,31,14,0,0,0
2024-11-01 22:00,66,50,16,0,0,0
2024-11-01 22:15,49,32,17,0,0,0
2024-11-01 22:30,53,28,25,0,0,0
2024-11-01 22:45,73,35,38,0,0,0
2024-11-01 23:00,31,16,15,0,0,0
2024-11-01 23:15,37,23,14,0,0,0
2024-11-01 23:30,38,16,22,0,0,0
2024-11-01 23:45,50,27,23,0,0,0
2024-11-02 00:00,23,16,7,0,0,0
2024-11-02 00:15,17,10,7,0,0,0
2024-11-02 00:30,33,14,19,0,0,0
2024-11-02 00:45,24,8,16,0,0,0
2024-11-02 01:00,17,9,8,0,0,0
2024-11-02 01:15,9,3,6,0,0,0
2024-11-02 01:30,19,14,5,0,0,0
2024-11-02 01:45,13,7,6,0,0,0
2024-11-02 02:00,6,3,3,0,0,0
2024-11-02 02:15,4,2,2,0,0,0
2024-11-02 02:30,5,3,2,0,0,0
2024-11-02 02:45,4,0,4,0,0,0
2024-11-02 03:00,8,0,8,0,0,0
2024-11-02 03:15,7,2,5,0,0,0
2024-11-02 03:30,6,4,2,0,0,0
2024-11-02 03:45,5,4,1,0,0,0
2024-11-02 04:00,5,2,3,0,0,0
2024-11-02 04:15,3,3,0,0,0,0
2024-11-02 04:30,2,0,2,0,0,0
2024-11-02 04:45,6,2,4,0,0,0
2024-11-02 05:00,3,0,3,0,0,0
2024-11-02 05:15,2,1,1,0,0,0
2024-11-02 05:30,5,3,2,0,0,0
2024-11-02 05:45,10,4,6,0,0,0
2024-11-02 06:00,4,3,1,0,0,0
2024-11-02 06:15,11,2,9,0,0,0
2024-11-02 06:30,4,3,1,0,0,0
2024-11-02 06:45,14,5,9,0,0,0
2024-11-02 07:00,10,0,10,0,0,0
2024-11-02 07:15,18,7,11,0,0,0
2024-11-02 07:30,23,11,12,0,0,0
2024-11-02 07:45,27,8,19,0,0,0
2024-11-02 08:00,37,18,19,0,0,0
2024-11-02 08:15,30,17,13,0,0,0
2024-11-02 08:30,39,13,26,0,0,0
2024-11-02 08:45,70,19,51,0,0,0
2024-11-02 09:00,87,31,56,0,0,0
2024-11-02 09:15,80,25,55,0,0,0
2024-11-02 09:30,114,36,78,0,0,0
2024-11-02 09:45,150,37,113,0,0,0
2024-11-02 10:00,164,38,126,0,0,0
2024-11-02 10:15,155,41,114,0,0,0
2024-11-02 10:30,153,45,108,0,0,0
2024-11-02 10:45,189,67,122,0,0,0
2024-11-02 11:00,159,44,115,0,0,0
2024-11-02 11:15,200,55,145,0,0,0
2024-11-02 11:30,183,77,106,0,0,0
2024-11-02 11:45,216,81,135,0,0,0
2024-11-02 12:00,207,72,135,0,0,0
2024-11-02 12:15,180,70,110,0,0,0
2024-11-02 12:30,165,73,92,0,0,0
2024-11-02 12:45,185,91,94,0,0,0
2024-11-02 13:00,174,77,97,0,0,0
2024-11-02 13:15,191,82,109,0,0,0
2024-11-02 13:30,189,101,88,0,0,0
2024-11-02 13:45,198,88,110,0,0,0
2024-11-02 14:00,191,99,92,0,0,0
2024-11-02 14:15,201,106,95,0,0,0
2024-11-02 14:30,170,88,82,0,0,0
2024-11-02 14:45,172,95,77,0,0,0
2024-11-02 15:00,187,103,84,0,0,0
2024-11-02 15:15,148,78,70,0,0,0
2024-11-02 15:30,166,92,74,0,0,0
2024-11-02 15:45,184,94,90,0,0,0
2024-11-02 16:00,152,82,70,0,0,0
2024-11-02 16:15,186,107,79,0,0,0
2024-11-02 16:30,139,77,62,0,0,0
2024-11-02 16:45,156,83,73,0,0,0
2024-11-02 17:00,139,86,53,0,0,0
2024-11-02 17:15,154,97,57,0,0,0
2024-11-02 17:30,130,74,56,0,0,0
2024-11-02 17:45,149,77,72,0,0,0
2024-11-02 18:00,126,85,41,0,0,0
2024-11-02 18:15,123,74,49,0,0,0
2024-11-02 18:30,112,73,39,0,0,0
2024-11-02 18:45,104,64,40,0,0,0
2024-11-02 19:00,97,54,43,0,0,0
2024-11-02 19:15,127,63,64,0,0,0
2024-11-02 19:30,106,58,48,0,0,0
2024-11-02 19:45,97,47,50,0,0,0
2024-11-02 20:00,73,35,38,0,0,0
2024-11-02 20:15,72,36,36,0,0,0
2024-11-02 20:30,68,34,34,0,0,0
2024-11-02 20:45,61,43,18,0,0,0
2024-11-02 21:00,58,24,34,0,0,0
2024-11-02 21:15,53,31,22,0,0,0
2024-11-02 21:30,55,26,29,0,0,0
2024-11-02 21:45,46,30,16,0,0,0
2024-11-02 22:00,71,41,30,0,0,0
2024-11-02 22:15,62,23,39,0,0,0
2024-11-02 22:30,36,17,19,0,0,0
2024-11-02 22:45,36,18,18,0,0,0
2024-11-02 23:00,59,28,31,0,0,0
2024-11-02 23:15,38,25,13,0,0,0
2024-11-02 23:30,52,22,30,0,0,0
2024-11-02 23:45,49,29,20,0,0,0
2024-11-03 00:00,51,32,19,0,0,0
2024-11-03 00:15,38,20,18,0,0,0
2024-11-03 00:30,23,16,7,0,0,0
2024-11-03 00:45,25,10,15,0,0,0
2024-11-03 01:00,36,22,14,0,0,0
2024-11-03 01:15,39,17,22,0,0,0
2024-11-03 01:30,29,16,13,0,0,0
2024-11-03 01:45,30,12,18,0,0,0
2024-11-03 02:00,29,13,16,0,0,0
2024-11-03 02:15,20,7,13,0,0,0
2024-11-03 02:30,20,9,11,0,0,0
2024-11-03 02:45,12,5,7,0,0,0
2024-11-03 03:00,18,9,9,0,0,0
2024-11-03 03:15,16,2,14,0,0,0
2024-11-03 03:30,19,7,12,0,0,0
2024-11-03 03:45,14,7,7,0,0,0
2024-11-03 04:00,12,4,8,0,0,0
2024-11-03 04:15,13,5,8,0,0,0
2024-11-03 04:30,6,2,4,0,0,0
2024-11-03 04:45,14,4,10,0,0,0
2024-11-03 05:00,12,1,11,0,0,0
2024-11-03 05:15,6,2,4,0,0,0
2024-11-03 05:30,9,2,7,0,0,0
2024-11-03 05:45,8,3,5,0,0,0
2024-11-03 06:00,10,4,6,0,0,0
2024-11-03 06:15,6,0,6,0,0,0
2024-11-03 06:30,8,2,6,0,0,0
2024-11-03 06:45,3,1,2,0,0,0
2024-11-03 07:00,6,2,4,0,0,0
2024-11-03 07:15,5,2,3,0,0,0
2024-11-03 07:30,6,0,6,0,0,0
2024-11-03 07:45,7,5,2,0,0,0
2024-11-03 08:00,7,2,5,0,0,0
2024-11-03 08:15,12,4,8,0,0,0
2024-11-03 08:30,13,1,12,0,0,0
2024-11-03 08:45,22,9,13,0,0,0
2024-11-03 09:00,24,5,19,0,0,0
2024-11-03 09:15,39,18,21,0,0,0
2024-11-03 09:30,42,18,24,0,0,0
2024-11-03 09:45,72,29,43,0,0,0
2024-11-03 10:00,66,32,34,0,0,0
2024-11-03 10:15,47,24,23,0,0,0
2024-11-03 10:30,57,20,37,0,0,0
2024-11-03 10:45,90,34,56,0,0,0
2024-11-03 11:00,70,30,40,0,0,0
2024-11-03 11:15,88,41,47,0,0,0
2024-11-03 11:30,64,22,42,0,0,0
2024-11-03 11:45,87,30,57,0,0,0
2024-11-03 12:00,87,30,57,0,0,0
2024-11-03 12:15,86,39,47,0,0,0
2024-11-03 12:30,86,36,50,0,0,0
2024-11-03 12:45,102,41,61,0,0,0
2024-11-03 13:00,89,40,49,0,0,0
2024-11-03 13:15,111,42,69,0,0,0
2024-11-03 13:30,96,47,49,0,0,0
2024-11-03 13:45,161,76,85,0,0,0
2024-11-03 14:00,121,59,62,0,0,0
2024-11-03 14:15,128,62,66,0,0,0
2024-11-03 14:30,122,53,69,0,0,0
2024-11-03 14:45,138,65,73,0,0,0
2024-11-03 15:00,138,60,78,0,0,0
2024-11-03 15:15,114,38,76,0,0,0
2024-11-03 15:30,138,57,81,0,0,0
2024-11-03 15:45,141,70,71,0,0,0
2024-11-03 16:00,118,55,63,0,0,0
2024-11-03 16:15,109,61,48,0,0,0
2024-11-03 16:30,108,59,49,0,0,0
2024-11-03 16:45,121,72,49,0,0,0
2024-11-03 17:00,95,47,48,0,0,0
2024-11-03 17:15,119,75,44,0,0,0
2024-11-03 17:30,113,60,53,0,0,0
2024-11-03 17:45,134,65,69,0,0,0
2024-11-03 18:00,94,48,46,0,0,0
2024-11-03 18:15,103,52,51,0,0,0
2024-11-03 18:30,90,54,36,0,0,0
2024-11-03 18:45,90,50,40,0,0,0
2024-11-03 19:00,83,50,33,0,0,0
2024-11-03 19:15,80,34,46,0,0,0
2024-11-03 19:30,85,47,38,0,0,0
2024-11-03 19:45,85,50,35,0,0,0
2024-11-03 20:00,71,42,29,0,0,0
2024-11-03 20:15,76,30,46,0,0,0
2024-11-03 20:30,42,18,24,0,0,0
2024-11-03 20:45,39,20,19,0,0,0
2024-11-03 21:00,43,23,20,0,0,0
2024-11-03 21:15,48,25,23,0,0,0
2024-11-03 21:30,38,25,13,0,0,0
2024-11-03 21:45,24,9,15,0,0,0
2024-11-03 22:00,22,8,14,0,0,0
2024-11-03 22:15,26,13,13,0,0,0
2024-11-03 22:30,24,11,13,0,0,0
2024-11-03 22:45,14,4,10,0,0,0
2024-11-03 23:00,6,1,5,0,0,0
2024-11-03 23:15,17,10,7,0,0,0
2024-11-03 23:30,17,4,13,0,0,0
2024-11-03 23:45,14,3,11,0,0,0
2024-11-04 00:00,6,3,3,0,0,0
2024-11-04 00:15,5,3,2,0,0,0
2024-11-04 00:30,4,3,1,0,0,0
2024-11-04 00:45,5,3,2,0,0,0
2024-11-04 01:00,4,1,3,0,0,0
2024-11-04 01:15,2,1,1,0,0,0
2024-11-04 01:30,2,1,1,0,0,0
2024-11-04 01:45,0,0,0,0,0,0
2024-11-04 02:00,2,2,0,0,0,0
2024-11-04 02:15,1,1,0,0,0,0
2024-11-04 02:30,1,0,1,0,0,0
2024-11-04 02:45,1,0,1,0,0,0
2024-11-04 03:00,1,1,0,0,0,0
2024-11-04 03:15,0,0,0,0,0,0
2024-11-04 03:30,2,0,2,0,0,0
2024-11-04 03:45,2,1,1,0,0,0
2024-11-04 04:00,2,1,1,0,0,0
2024-11-04 04:15,4,3,1,0,0,0
2024-11-04 04:30,2,1,1,0,0,0
2024-11-04 04:45,4,3,1,0,0,0
2024-11-04 05:00,4,3,1,0,0,0
2024-11-04 05:15,10,3,7,0,0,0
2024-11-04 05:30,20,6,14,0,0,0
2024-11-04 05:45,29,9,20,0,0,0
2024-11-04 06:00,20,8,12,0,0,0
2024-11-04 06:15,39,15,24,0,0,0
2024-11-04 06:30,57,20,37,0,0,0
2024-11-04 06:45,99,43,56,0,0,0
2024-11-04 07:00,93,34,59,0,0,0
2024-11-04 07:15,183,63,120,0,0,0
2024-11-04 07:30,347,84,263,0,0,0
2024-11-04 07:45,325,87,238,0,0,0
2024-11-04 08:00,271,82,189,0,0,0
2024-11-04 08:15,236,71,165,0,0,0
2024-11-04 08:30,180,51,129,0,0,0
2024-11-04 08:45,163,33,130,0,0,0
2024-11-04 09:00,148,43,105,0,0,0
2024-11-04 09:15,138,43,95,0,0,0
2024-11-04 09:30,178,47,131,0,0,0
2024-11-04 09:45,189,41,148,0,0,0
2024-11-04 10:00,156,47,109,0,0,0
2024-11-04 10:15,131,55,76,0,0,0
2024-11-04 10:30,109,39,70,0,0,0
2024-11-04 10:45,142,49,93,0,0,0
2024-11-04 11:00,131,48,83,0,0,0
2024-11-04 11:15,138,57,81,0,0,0
2024-11-04 11:30,148,60,88,0,0,0
2024-11-04 11:45,214,71,143,0,0,0
2024-11-04 12:00,181,78,103,0,0,0
2024-11-04 12:15,179,85,94,0,0,0
2024-11-04 12:30,164,92,72,0,0,0
2024-11-04 12:45,150,63,87,0,0,0
2024-11-04 13:00,224,126,98,0,0,0
2024-11-04 13:15,187,92,95,0,0,0
2024-11-04 13:30,167,83,84,0,0,0
2024-11-04 13:45,208,89,119,0,0,0
2024-11-04 14:00,214,116,98,0,0,0
2024-11-04 14:15,174,98,76,0,0,0
2024-11-04 14:30,194,94,100,0,0,0
2024-11-04 14:45,209,97,112,0,0,0
2024-11-04 15:00,187,102,85,0,0,0
2024-11-04 15:15,189,100,89,0,0,0
2024-11-04 15:30,211,131,80,0,0,0
2024-11-04 15:45,243,130,113,0,0,0
2024-11-04 16:00,272,164,108,0,0,0
2024-11-04 16:15,260,148,112,0,0,0
2024-11-04 16:30,247,123,124,0,0,0
2024-11-04 16:45,289,148,141,0,0,0
2024-11-04 17:00,239,129,110,0,0,0
2024-11-04 17:15,235,133,102,0,0,0
2024-11-04 17:30,243,136,107,0,0,0
2024-11-04 17:45,282,154,128,0,0,0
2024-11-04 18:00,255,166,89,0,0,0
2024-11-04 18:15,210,135,75,0,0,0
2024-11-04 18:30,166,100,66,0,0,0
2024-11-04 18:45,161,91,70,0,0,0
2024-11-04 19:00,149,83,66,0,0,0
2024-11-04 19:15,168,89,79,0,0,0
2024-11-04 19:30,138,75,63,0,0,0
2024-11-04 19:45,158,87,71,0,0,0
2024-11-04 20:00,136,75,61,0,0,0
2024-11-04 20:15,93,53,40,0,0,0
2024-11-04 20:30,71,42,29,0,0,0
2024-11-04 20:45,73,34,39,0,0,0
2024-11-04 21:00,88,49,39,0,0,0
2024-11-04 21:15,68,34,34,0,0,0
2024-11-04 21:30,74,41,33,0,0,0
2024-11-04 21:45,54,32,22,0,0,0
2024-11-04 22:00,68,42,26,0,0,0
2024-11-04 22:15,45,22,23,0,0,0
2024-11-04 22:30,43,29,14,0,0,0
2024-11-04 22:45,36,20,16,0,0,0
2024-11-04 23:00,29,14,15,0,0,0
2024-11-04 23:15,29,16,13,0,0,0
2024-11-04 23:30,28,12,16,0,0,0
2024-11-04 23:45,8,2,6,0,0,0
2024-11-05 00:00,17,9,8,0,0,0
2024-11-05 00:15,8,4,4,0,0,0
2024-11-05 00:30,8,5,3,0,0,0
2024-11-05 00:45,6,2,4,0,0,0
2024-11-05 01:00,6,5,1,0,0,0
2024-11-05 01:15,3,1,2,0,0,0
2024-11-05 01:30,4,3,1,0,0,0
2024-11-05 01:45,3,0,3,0,0,0
2024-11-05 02:00,2,2,0,0,0,0
2024-11-05 02:15,2,1,1,0,0,0
2024-11-05 02:30,0,0,0,0,0,0
2024-11-05 02:45,0,0,0,0,0,0
2024-11-05 03:00,2,1,1,0,0,0
2024-11-05 03:15,1,1,0,0,0,0
2024-11-05 03:30,3,1,2,0,0,0
2024-11-05 03:45,1,0,1,0,0,0
2024-11-05 04:00,2,1,1,0,0,0
2024-11-05 04:15,3,2,1,0,0,0
2024-11-05 04:30,5,2,3,0,0,0
2024-11-05 04:45,2,1,1,0,0,0
2024-11-05 05:00,4,3,1,0,0,0
2024-11-05 05:15,11,5,6,0,0,0
2024-11-05 05:30,16,6,10,0,0,0
2024-11-05 05:45,32,14,18,0,0,0
2024-11-05 06:00,24,11,13,0,0,0
2024-11-05 06:15,51,24,27,0,0,0
2024-11-05 06:30,57,19,38,0,0,0
2024-11-05 06:45,105,41,64,0,0,0
2024-11-05 07:00,101,36,65,0,0,0
2024-11-05 07:15,177,54,123,0,0,0
2024-11-05 07:30,354,84,270,0,0,0
2024-11-05 07:45,334,97,237,0,0,0
2024-11-05 08:00,287,69,218,0,0,0
2024-11-05 08:15,262,80,182,0,0,0
2024-11-05 08:30,228,60,168,0,0,0
2024-11-05 08:45,211,60,151,0,0,0
2024-11-05 09:00,174,47,127,0,0,0
2024-11-05 09:15,136,40,96,0,0,0
2024-11-05 09:30,154,39,115,0,0,0
2024-11-05 09:45,218,40,178,0,0,0
2024-11-05 10:00,179,47,132,0,0,0
2024-11-05 10:15,128,40,88,0,0,0
2024-11-05 10:30,121,48,73,0,0,0
2024-11-05 10:45,116,41,75,0,0,0
2024-11-05 11:00,129,53,76,0,0,0
2024-11-05 11:15,149,81,68,0,0,0
2024-11-05 11:30,148,76,72,0,0,0
2024-11-05 11:45,194,73,121,0,0,0
2024-11-05 12:00,187,80,107,0,0,0
2024-11-05 12:15,149,78,71,0,0,0
2024-11-05 12:30,151,78,73,0,0,0
2024-11-05 12:45,177,82,95,0,0,0
2024-11-05 13:00,199,99,100,0,0,0
2024-11-05 13:15,151,73,78,0,0,0
2024-11-05 13:30,186,89,97,0,0,0
2024-11-05 13:45,212,95,117,0,0,0
2024-11-05 14:00,231,124,107,0,0,0
2024-11-05 14:15,200,105,95,0,0,0
2024-11-05 14:30,165,88,77,0,0,0
2024-11-05 14:45,199,103,96,0,0,0
2024-11-05 15:00,214,121,93,0,0,0
2024-11-05 15:15,189,97,92,0,0,0
2024-11-05 15:30,256,126,130,0,0,0
2024-11-05 15:45,262,130,132,0,0,0
2024-11-05 16:00,281,152,129,0,0,0
2024-11-05 16:15,261,148,113,0,0,0
2024-11-05 16:30,248,131,117,0,0,0
2024-11-05 16:45,276,151,125,0,0,0
2024-11-05 17:00,265,138,127,0,0,0
2024-11-05 17:15,263,149,114,0,0,0
2024-11-05 17:30,244,132,112,0,0,0
2024-11-05 17:45,283,163,120,0,0,0
2024-11-05 18:00,294,177,117,0,0,0
2024-11-05 18:15,254,132,122,0,0,0
2024-11-05 18:30,207,119,88,0,0,0
2024-11-05 18:45,205,116,89,0,0,0
2024-11-05 19:00,184,112,72,0,0,0
2024-11-05 19:15,166,83,83,0,0,0
2024-11-05 19:30,144,90,54,0,0,0
2024-11-05 19:45,157,87,70,0,0,0
2024-11-05 20:00,116,66,50,0,0,0
2024-11-05 20:15,112,66,46,0,0,0
2024-11-05 20:30,103,59,44,0,0,0
2024-11-05 20:45,80,43,37,0,0,0
2024-11-05 21:00,77,37,40,0,0,0
2024-11-05 21:15,74,48,26,0,0,0
2024-11-05 21:30,71,38,33,0,0,0
2024-11-05 21:45,60,26,34,0,0,0
2024-11-05 22:00,54,28,26,0,0,0
2024-11-05 22:15,76,43,33,0,0,0
2024-11-05 22:30,71,40,31,0,0,0
2024-11-05 22:45,45,28,17,0,0,0
2024-11-05 23:00,43,19,24,0,0,0
2024-11-05 23:15,48,21,27,0,0,0
2024-11-05 23:30,19,8,11,0,0,0
2024-11-05 23:45,16,6,10,0,0,0
2024-11-06 00:00,15,10,5,0,0,0
2024-11-06 00:15,10,5,5,0,0,0
2024-11-06 00:30,10,7,3,0,0,0
2024-11-06 00:45,9,8,1,0,0,0
2024-11-06 01:00,11,5,6,0,0,0
2024-11-06 01:15,10,8,2,0,0,0
2024-11-06 01:30,5,2,3,0,0,0
2024-11-06 01:45,1,1,0,0,0,0
2024-11-06 02:00,4,3,1,0,0,0
2024-11-06 02:15,5,4,1,0,0,0
2024-11-06 02:30,7,7,0,0,0,0
2024-11-06 02:45,1,1,0,0,0,0
2024-11-06 03:00,2,1,1,0,0,0
2024-11-06 03:15,7,6,1,0,0,0
2024-11-06 03:30,9,4,5,0,0,0
2024-11-06 03:45,4,4,0,0,0,0
2024-11-06 04:00,1,0,1,0,0,0
2024-11-06 04:15,7,6,1,0,0,0
2024-11-06 04:30,6,5,1,0,0,0
2024-11-06 04:45,5,4,1,0,0,0
2024-11-06 05:00,4,3,1,0,0,0
2024-11-06 05:15,9,3,6,0,0,0
2024-11-06 05:30,19,8,11,0,0,0
2024-11-06 05:45,27,12,15,0,0,0
2024-11-06 06:00,25,12,13,0,0,0
2024-11-06 06:15,47,20,27,0,0,0
2024-11-06 06:30,47,15,32,0,0,0
2024-11-06 06:45,81,37,44,0,0,0
2024-11-06 07:00,123,48,75,0,0,0
2024-11-06 07:15,201,52,149,0,0,0
2024-11-06 07:30,322,74,248,0,0,0
2024-11-06 07:45,340,83,257,0,0,0
2024-11-06 08:00,277,70,207,0,0,0
2024-11-06 08:15,222,67,155,0,0,0
2024-11-06 08:30,212,82,130,0,0,0
2024-11-06 08:45,224,48,176,0,0,0
2024-11-06 09:00,162,43,119,0,0,0
2024-11-06 09:15,147,40,107,0,0,0
2024-11-06 09:30,177,54,123,0,0,0
2024-11-06 09:45,231,46,185,0,0,0
2024-11-06 10:00,167,55,112,0,0,0
2024-11-06 10:15,118,44,74,0,0,0
2024-11-06 10:30,126,31,95,0,0,0
2024-11-06 10:45,147,54,93,0,0,0
2024-11-06 11:00,145,54,91,0,0,0
2024-11-06 11:15,125,54,71,0,0,0
2024-11-06 11:30,163,64,99,0,0,0
2024-11-06 11:45,207,75,132,0,0,0
2024-11-06 12:00,181,77,104,0,0,0
2024-11-06 12:15,173,92,81,0,0,0
2024-11-06 12:30,158,81,77,0,0,0
2024-11-06 12:45,201,99,102,0,0,0
2024-11-06 13:00,199,117,82,0,0,0
2024-11-06 13:15,171,100,71,0,0,0
2024-11-06 13:30,161,97,64,0,0,0
2024-11-06 13:45,197,99,98,0,0,0
2024-11-06 14:00,219,140,79,0,0,0
2024-11-06 14:15,191,112,79,0,0,0
2024-11-06 14:30,178,94,84,0,0,0
2024-11-06 14:45,205,115,90,0,0,0
2024-11-06 15:00,188,102,86,0,0,0
2024-11-06 15:15,186,123,63,0,0,0
2024-11-06 15:30,193,110,83,0,0,0
2024-11-06 15:45,255,122,133,0,0,0
2024-11-06 16:00,241,146,95,0,0,0
2024-11-06 16:15,209,121,88,0,0,0
2024-11-06 16:30,201,102,99,0,0,0
2024-11-06 16:45,210,111,99,0,0,0
2024-11-06 17:00,229,113,116,0,0,0
2024-11-06 17:15,258,133,125,0,0,0
2024-11-06 17:30,214,118,96,0,0,0
2024-11-06 17:45,261,145,116,0,0,0
2024-11-06 18:00,230,142,88,0,0,0
2024-11-06 18:15,216,121,95,0,0,0
2024-11-06 18:30,163,83,80,0,0,0
2024-11-06 18:45,187,97,90,0,0,0
2024-11-06 19:00,160,92,68,0,0,0
2024-11-06 19:15,149,85,64,0,0,0
2024-11-06 19:30,147,77,70,0,0,0
2024-11-06 19:45,163,88,75,0,0,0
2024-11-06 20:00,129,83,46,0,0,0
2024-11-06 20:15,131,63,68,0,0,0
2024-11-06 20:30,92,44,48,0,0,0
2024-11-06 20:45,102,56,46,0,0,0
2024-11-06 21:00,87,51,36,0,0,0
2024-11-06 21:15,86,42,44,0,0,0
2024-11-06 21:30,85,47,38,0,0,0
2024-11-06 21:45,89,40,49,0,0,0
2024-11-06 22:00,89,51,38,0,0,0
2024-11-06 22:15,93,54,39,0,0,0
2024-11-06 22:30,85,60,25,0,0,0
2024-11-06 22:45,64,38,26,0,0,0
2024-11-06 23:00,52,29,23,0,0,0
2024-11-06 23:15,69,47,22,0,0,0
2024-11-06 23:30,52,38,14,0,0,0
2024-11-06 23:45,33,20,13,0,0,0
2024-11-07 00:00,38,15,23,0,0,0
2024-11-07 00:15,19,12,7,0,0,0
2024-11-07 00:30,32,21,11,0,0,0
2024-11-07 00:45,25,8,17,0,0,0
2024-11-07 01:00,18,8,10,0,0,0
2024-11-07 01:15,29,6,23,0,0,0
2024-11-07 01:30,18,5,13,0,0,0
2024-11-07 01:45,23,3,20,0,0,0
2024-11-07 02:00,19,3,16,0,0,0
2024-11-07 02:15,13,1,12,0,0,0
2024-11-07 02:30,26,2,24,0,0,0
2024-11-07 02:45,12,2,10,0,0,0
2024-11-07 03:00,13,1,12,0,0,0
2024-11-07 03:15,22,5,17,0,0,0
2024-11-07 03:30,10,2,8,0,0,0
2024-11-07 03:45,29,5,24,0,0,0
2024-11-07 04:00,15,3,12,0,0,0
2024-11-07 04:15,5,2,3,0,0,0
2024-11-07 04:30,7,3,4,0,0,0
2024-11-07 04:45,8,3,5,0,0,0
2024-11-07 05:00,2,2,0,0,0,0
2024-11-07 05:15,12,7,5,0,0,0
2024-11-07 05:30,23,8,15,0,0,0
2024-11-07 05:45,33,10,23,0,0,0
2024-11-07 06:00,27,12,15,0,0,0
2024-11-07 06:15,42,21,21,0,0,0
2024-11-07 06:30,59,19,40,0,0,0
2024-11-07 06:45,75,37,38,0,0,0
2024-11-07 07:00,87,34,53,0,0,0
2024-11-07 07:15,192,58,134,0,0,0
2024-11-07 07:30,330,71,259,0,0,0
2024-11-07 07:45,323,104,219,0,0,0
2024-11-07 08:00,269,70,199,0,0,0
2024-11-07 08:15,225,65,160,0,0,0
2024-11-07 08:30,214,59,155,0,0,0
2024-11-07 08:45,195,59,136,0,0,0
2024-11-07 09:00,150,50,100,0,0,0
2024-11-07 09:15,132,42,90,0,0,0
2024-11-07 09:30,153,47,106,0,0,0
2024-11-07 09:45,208,53,155,0,0,0
2024-11-07 10:00,170,57,113,0,0,0
2024-11-07 10:15,118,40,78,0,0,0
2024-11-07 10:30,91,30,61,0,0,0
2024-11-07 10:45,124,36,88,0,0,0
2024-11-07 11:00,116,38,78,0,0,0
2024-11-07 11:15,108,45,63,0,0,0
2024-11-07 11:30,108,45,63,0,0,0
2024-11-07 11:45,183,74,109,0,0,0
2024-11-07 12:00,172,86,86,0,0,0
2024-11-07 12:15,134,54,80,0,0,0
2024-11-07 12:30,129,76,53,0,0,0
2024-11-07 12:45,191,90,101,0,0,0
2024-11-07 13:00,190,111,79,0,0,0
2024-11-07 13:15,160,87,73,0,0,0
2024-11-07 13:30,156,77,79,0,0,0
2024-11-07 13:45,213,112,101,0,0,0
2024-11-07 14:00,222,118,104,0,0,0
2024-11-07 14:15,170,86,84,0,0,0
2024-11-07 14:30,189,99,90,0,0,0
2024-11-07 14:45,187,100,87,0,0,0
2024-11-07 15:00,175,102,73,0,0,0
2024-11-07 15:15,190,104,86,0,0,0
2024-11-07 15:30,185,95,90,0,0,0
2024-11-07 15:45,278,159,119,0,0,0
2024-11-07 16:00,244,136,108,0,0,0
2024-11-07 16:15,228,115,113,0,0,0
2024-11-07 16:30,236,120,116,0,0,0
2024-11-07 16:45,220,110,110,0,0,0
2024-11-07 17:00,218,133,85,0,0,0
2024-11-07 17:15,223,118,105,0,0,0
2024-11-07 17:30,224,114,110,0,0,0
2024-11-07 17:45,250,144,106,0,0,0
2024-11-07 18:00,256,146,110,0,0,0
2024-11-07 18:15,202,116,86,0,0,0
2024-11-07 18:30,177,76,101,0,0,0
2024-11-07 18:45,175,85,90,0,0,0
2024-11-07 19:00,144,71,73,0,0,0
2024-11-07 19:15,148,66,82,0,0,0
2024-11-07 19:30,152,87,65,0,0,0
2024-11-07 19:45,182,105,77,0,0,0
2024-11-07 20:00,126,71,55,0,0,0
2024-11-07 20:15,111,68,43,0,0,0
2024-11-07 20:30,93,53,40,0,0,0
2024-11-07 20:45,58,31,27,0,0,0
2024-11-07 21:00,67,33,34,0,0,0
2024-11-07 21:15,72,54,18,0,0,0
2024-11-07 21:30,70,43,27,0,0,0
2024-11-07 21:45,74,44,30,0,0,0
2024-11-07 22:00,75,40,35,0,0,0
2024-11-07 22:15,68,40,28,0,0,0
2024-11-07 22:30,71,45,26,0,0,0
2024-11-07 22:45,74,32,42,0,0,0
2024-11-07 23:00,49,20,29,0,0,0
2024-11-07 23:15,48,28,20,0,0,0
2024-11-07 23:30,33,17,16,0,0,0
2024-11-07 23:45,23,14,9,0,0,0
2024-11-08 00:00,24,8,16,0,0,0
2024-11-08 00:15,28,10,18,0,0,0
2024-11-08 00:30,8,6,2,0,0,0
2024-11-08 00:45,9,2,7,0,0,0
2024-11-08 01:00,15,5,10,0,0,0
2024-11-08 01:15,10,4,6,0,0,0
2024-11-08 01:30,12,10,2,0,0,0
2024-11-08 01:45,5,2,3,0,0,0
2024-11-08 02:00,9,6,3,0,0,0
2024-11-08 02:15,1,1,0,0,0,0
2024-11-08 02:30,6,6,0,0,0,0
2024-11-08 02:45,2,0,2,0,0,0
2024-11-08 03:00,2,1,1,0,0,0
2024-11-08 03:15,4,4,0,0,0,0
2024-11-08 03:30,0,0,0,0,0,0
2024-11-08 03:45,4,0,4,0,0,0
2024-11-08 04:00,5,2,3,0,0,0
2024-11-08 04:15,3,2,1,0,0,0
2024-11-08 04:30,3,2,1,0,0,0
2024-11-08 04:45,4,1,3,0,0,0
2024-11-08 05:00,8,5,3,0,0,0
2024-11-08 05:15,12,1,11,0,0,0
2024-11-08 05:30,8,5,3,0,0,0
2024-11-08 05:45,23,7,16,0,0,0
2024-11-08 06:00,15,6,9,0,0,0
2024-11-08 06:15,32,15,17,0,0,0
2024-11-08 06:30,48,15,33,0,0,0
2024-11-08 06:45,65,31,34,0,0,0
2024-11-08 07:00,79,29,50,0,0,0
2024-11-08 07:15,157,39,118,0,0,0
2024-11-08 07:30,285,74,211,0,0,0
2024-11-08 07:45,291,69,222,0,0,0
2024-11-08 08:00,210,56,154,0,0,0
2024-11-08 08:15,200,60,140,0,0,0
2024-11-08 08:30,192,57,135,0,0,0
2024-11-08 08:45,178,51,127,0,0,0
2024-11-08 09:00,135,48,87,0,0,0
2024-11-08 09:15,125,37,88,0,0,0
2024-11-08 09:30,133,42,91,0,0,0
2024-11-08 09:45,183,58,125,0,0,0
2024-11-08 10:00,128,36,92,0,0,0
2024-11-08 10:15,142,59,83,0,0,0
2024-11-08 10:30,99,38,61,0,0,0
2024-11-08 10:45,153,51,102,0,0,0
2024-11-08 11:00,138,57,81,0,0,0
2024-11-08 11:15,146,72,74,0,0,0
2024-11-08 11:30,125,63,62,0,0,0
2024-11-08 11:45,180,80,100,0,0,0
2024-11-08 12:00,171,82,89,0,0,0
2024-11-08 12:15,167,58,109,0,0,0
2024-11-08 12:30,182,90,92,0,0,0
2024-11-08 12:45,225,126,99,0,0,0
2024-11-08 13:00,209,116,93,0,0,0
2024-11-08 13:15,206,112,94,0,0,0
2024-11-08 13:30,166,72,94,0,0,0
2024-11-08 13:45,209,100,109,0,0,0
2024-11-08 14:00,209,113,96,0,0,0
2024-11-08 14:15,199,113,86,0,0,0
2024-11-08 14:30,195,111,84,0,0,0
2024-11-08 14:45,232,106,126,0,0,0
2024-11-08 15:00,188,101,87,0,0,0
2024-11-08 15:15,179,74,105,0,0,0
2024-11-08 15:30,191,101,90,0,0,0
2024-11-08 15:45,199,99,100,0,0,0
2024-11-08 16:00,181,108,73,0,0,0
2024-11-08 16:15,206,109,97,0,0,0
2024-11-08 16:30,189,97,92,0,0,0
2024-11-08 16:45,199,109,90,0,0,0
2024-11-08 17:00,151,80,71,0,0,0
2024-11-08 17:15,189,101,88,0,0,0
2024-11-08 17:30,157,93,64,0,0,0
2024-11-08 17:45,166,91,75,0,0,0
2024-11-08 18:00,178,100,78,0,0,0
2024-11-08 18:15,161,87,74,0,0,0
2024-11-08 18:30,143,83,60,0,0,0
2024-11-08 18:45,181,97,84,0,0,0
2024-11-08 19:00,137,73,64,0,0,0
2024-11-08 19:15,134,77,57,0,0,0
2024-11-08 19:30,135,68,67,0,0,0
2024-11-08 19:45,116,62,54,0,0,0
2024-11-08 20:00,109,53,56,0,0,0
2024-11-08 20:15,100,49,51,0,0,0
2024-11-08 20:30,77,37,40,0,0,0
2024-11-08 20:45,79,40,39,0,0,0
2024-11-08 21:00,77,35,42,0,0,0
2024-11-08 21:15,93,44,49,0,0,0
2024-11-08 21:30,64,31,33,0,0,0
2024-11-08 21:45,67,37,30,0,0,0
2024-11-08 22:00,75,43,32,0,0,0
2024-11-08 22:15,72,35,37,0,0,0
2024-11-08 22:30,83,47,36,0,0,0
2024-11-08 22:45,61,23,38,0,0,0
2024-11-08 23:00,66,35,31,0,0,0
2024-11-08 23:15,62,28,34,0,0,0
2024-11-08 23:30,49,29,20,0,0,0
2024-11-08 23:45,47,29,18,0,0,0
2024-11-09 00:00,43,21,22,0,0,0
2024-11-09 00:15,40,21,19,0,0,0
2024-11-09 00:30,39,17,22,0,0,0
2024-11-09 00:45,49,26,23,0,0,0
2024-11-09 01:00,38,20,18,0,0,0
2024-11-09 01:15,35,20,15,0,0,0
2024-11-09 01:30,44,20,24,0,0,0
2024-11-09 01:45,29,16,13,0,0,0
2024-11-09 02:00,26,14,12,0,0,0
2024-11-09 02:15,19,10,9,0,0,0
2024-11-09 02:30,19,10,9,0,0,0
2024-11-09 02:45,16,9,7,0,0,0
2024-11-09 03:00,23,12,11,0,0,0
2024-11-09 03:15,12,3,9,0,0,0
2024-11-09 03:30,16,9,7,0,0,0
2024-11-09 03:45,7,4,3,0,0,0
2024-11-09 04:00,12,5,7,0,0,0
2024-11-09 04:15,6,0,6,0,0,0
2024-11-09 04:30,7,6,1,0,0,0
2024-11-09 04:45,6,1,5,0,0,0
2024-11-09 05:00,8,5,3,0,0,0
2024-11-09 05:15,9,3,6,0,0,0
2024-11-09 05:30,15,8,7,0,0,0
2024-11-09 05:45,6,4,2,0,0,0
2024-11-09 06:00,6,4,2,0,0,0
2024-11-09 06:15,8,1,7,0,0,0
2024-11-09 06:30,16,7,9,0,0,0
2024-11-09 06:45,13,8,5,0,0,0
2024-11-09 07:00,21,8,13,0,0,0
2024-11-09 07:15,15,6,9,0,0,0
2024-11-09 07:30,23,10,13,0,0,0
2024-11-09 07:45,26,14,12,0,0,0
2024-11-09 08:00,16,10,6,0,0,0
2024-11-09 08:15,35,10,25,0,0,0
2024-11-09 08:30,62,21,41,0,0,0
2024-11-09 08:45,77,21,56,0,0,0
2024-11-09 09:00,56,17,39,0,0,0
2024-11-09 09:15,86,36,50,0,0,0
2024-11-09 09:30,102,32,70,0,0,0
2024-11-09 09:45,125,39,86,0,0,0
2024-11-09 10:00,104,33,71,0,0,0
2024-11-09 10:15,115,29,86,0,0,0
2024-11-09 10:30,138,49,89,0,0,0
2024-11-09 10:45,174,62,112,0,0,0
2024-11-09 11:00,137,50,87,0,0,0
2024-11-09 11:15,162,49,113,0,0,0
2024-11-09 11:30,167,53,114,0,0,0
2024-11-09 11:45,168,64,104,0,0,0
2024-11-09 12:00,181,76,105,0,0,0
2024-11-09 12:15,153,60,93,0,0,0
2024-11-09 12:30,181,81,100,0,0,0
2024-11-09 12:45,190,80,110,0,0,0
2024-11-09 13:00,182,87,95,0,0,0
2024-11-09 13:15,189,94,95,0,0,0
2024-11-09 13:30,174,84,90,0,0,0
2024-11-09 13:45,181,83,98,0,0,0
2024-11-09 14:00,164,87,77,0,0,0
2024-11-09 14:15,145,83,62,0,0,0
2024-11-09 14:30,182,99,83,0,0,0
2024-11-09 14:45,162,89,73,0,0,0
2024-11-09 15:00,163,87,76,0,0,0
2024-11-09 15:15,165,100,65,0,0,0
2024-11-09 15:30,138,70,68,0,0,0
2024-11-09 15:45,148,70,78,0,0,0
2024-11-09 16:00,134,72,62,0,0,0
2024-11-09 16:15,130,68,62,0,0,0
2024-11-09 16:30,112,62,50,0,0,0
2024-11-09 16:45,140,84,56,0,0,0
2024-11-09 17:00,126,68,58,0,0,0
2024-11-09 17:15,130,71,59,0,0,0
2024-11-09 17:30,118,64,54,0,0,0
2024-11-09 17:45,107,58,49,0,0,0
2024-11-09 18:00,119,73,46,0,0,0
2024-11-09 18:15,111,77,34,0,0,0
2024-11-09 18:30,107,66,41,0,0,0
2024-11-09 18:45,132,86,46,0,0,0
2024-11-09 19:00,128,67,61,0,0,0
2024-11-09 19:15,90,52,38,0,0,0
2024-11-09 19:30,130,75,55,0,0,0
2024-11-09 19:45,99,57,42,0,0,0
2024-11-09 20:00,105,63,42,0,0,0
2024-11-09 20:15,89,50,39,0,0,0
2024-11-09 20:30,71,36,35,0,0,0
2024-11-09 20:45,81,50,31,0,0,0
2024-11-09 21:00,84,43,41,0,0,0
2024-11-09 21:15,47,23,24,0,0,0
2024-11-09 21:30,34,26,8,0,0,0
2024-11-09 21:45,63,25,38,0,0,0
2024-11-09 22:00,58,33,25,0,0,0
2024-11-09 22:15,47,18,29,0,0,0
2024-11-09 22:30,36,21,15,0,0,0
2024-11-09 22:45,63,28,35,0,0,0
2024-11-09 23:00,48,24,24,0,0,0
2024-11-09 23:15,48,23,25,0,0,0
2024-11-09 23:30,56,30,26,0,0,0
2024-11-09 23:45,62,33,29,0,0,0
2024-11-10 00:00,32,14,18,0,0,0
2024-11-10 00:15,44,19,25,0,0,0
2024-11-10 00:30,53,26,27,0,0,0
2024-11-10 00:45,57,27,30,0,0,0
2024-11-10 01:00,44,27,17,0,0,0
2024-11-10 01:15,37,23,14,0,0,0
2024-11-10 01:30,46,24,22,0,0,0
2024-11-10 01:45,41,20,21,0,0,0
2024-11-10 02:00,32,12,20,0,0,0
2024-11-10 02:15,28,9,19,0,0,0
2024-11-10 02:30,28,9,19,0,0,0
2024-11-10 02:45,16,6,10,0,0,0
2024-11-10 03:00,19,12,7,0,0,0
2024-11-10 03:15,27,13,14,0,0,0
2024-11-10 03:30,12,3,9,0,0,0
2024-11-10 03:45,20,7,13,0,0,0
2024-11-10 04:00,13,5,8,0,0,0
2024-11-10 04:15,18,5,13,0,0,0
2024-11-10 04:30,5,1,4,0,0,0
2024-11-10 04:45,10,1,9,0,0,0
2024-11-10 05:00,8,2,6,0,0,0
2024-11-10 05:15,12,3,9,0,0,0
2024-11-10 05:30,9,4,5,0,0,0
2024-11-10 05:45,10,2,8,0,0,0
2024-11-10 06:00,9,3,6,0,0,0
2024-11-10 06:15,10,0,10,0,0,0
2024-11-10 06:30,5,3,2,0,0,0
2024-11-10 06:45,9,5,4,0,0,0
2024-11-10 07:00,9,6,3,0,0,0
2024-11-10 07:15,8,4,4,0,0,0
2024-11-10 07:30,10,1,9,0,0,0
2024-11-10 07:45,7,3,4,0,0,0
2024-11-10 08:00,16,9,7,0,0,0
2024-11-10 08:15,10,5,5,0,0,0
2024-11-10 08:30,18,8,10,0,0,0
2024-11-10 08:45,28,16,12,0,0,0
2024-11-10 09:00,24,13,11,0,0,0
2024-11-10 09:15,22,8,14,0,0,0
2024-11-10 09:30,36,12,24,0,0,0
2024-11-10 09:45,62,28,34,0,0,0
2024-11-10 10:00,66,30,36,0,0,0
2024-11-10 10:15,59,26,33,0,0,0
2024-11-10 10:30,53,27,26,0,0,0
2024-11-10 10:45,68,29,39,0,0,0
2024-11-10 11:00,60,24,36,0,0,0
2024-11-10 11:15,64,22,42,0,0,0
2024-11-10 11:30,39,12,27,0,0,0
2024-11-10 11:45,69,32,37,0,0,0
2024-11-10 12:00,62,31,31,0,0,0
2024-11-10 12:15,79,29,50,0,0,0
2024-11-10 12:30,78,39,39,0,0,0
2024-11-10 12:45,82,38,44,0,0,0
2024-11-10 13:00,83,45,38,0,0,0
2024-11-10 13:15,74,28,46,0,0,0
2024-11-10 13:30,81,41,40,0,0,0
2024-11-10 13:45,88,42,46,0,0,0
2024-11-10 14:00,109,52,57,0,0,0
2024-11-10 14:15,104,49,55,0,0,0
2024-11-10 14:30,101,50,51,0,0,0
2024-11-10 14:45,96,39,57,0,0,0
2024-11-10 15:00,103,46,57,0,0,0
2024-11-10 15:15,100,36,64,0,0,0
2024-11-10 15:30,95,48,47,0,0,0
2024-11-10 15:45,94,40,54,0,0,0
2024-11-10 16:00,109,50,59,0,0,0
2024-11-10 16:15,87,42,45,0,0,0
2024-11-10 16:30,90,46,44,0,0,0
2024-11-10 16:45,110,45,65,0,0,0
2024-11-10 17:00,101,51,50,0,0,0
2024-11-10 17:15,84,48,36,0,0,0
2024-11-10 17:30,102,57,45,0,0,0
2024-11-10 17:45,106,60,46,0,0,0
2024-11-10 18:00,86,37,49,0,0,0
2024-11-10 18:15,75,39,36,0,0,0
2024-11-10 18:30,80,34,46,0,0,0
2024-11-10 18:45,62,27,35,0,0,0
2024-11-10 19:00,72,39,33,0,0,0
2024-11-10 19:15,55,26,29,0,0,0
2024-11-10 19:30,66,38,28,0,0,0
2024-11-10 19:45,56,25,31,0,0,0
2024-11-10 20:00,71,32,39,0,0,0
2024-11-10 20:15,51,26,25,0,0,0
2024-11-10 20:30,62,29,33,0,0,0
2024-11-10 20:45,44,22,22,0,0,0
2024-11-10 21:00,30,17,13,0,0,0
2024-11-10 21:15,36,15,21,0,0,0
2024-11-10 21:30,43,19,24,0,0,0
2024-11-10 21:45,34,14,20,0,0,0
2024-11-10 22:00,26,13,13,0,0,0
2024-11-10 22:15,24,12,12,0,0,0
2024-11-10 22:30,29,12,17,0,0,0
2024-11-10 22:45,13,8,5,0,0,0
2024-11-10 23:00,22,9,13,0,0,0
2024-11-10 23:15,11,6,5,0,0,0
2024-11-10 23:30,12,7,5,0,0,0
2024-11-10 23:45,3,1,2,0,0,0
2024-11-11 00:00,12,6,6,0,0,0
2024-11-11 00:15,8,5,3,0,0,0
2024-11-11 00:30,2,1,1,0,0,0
2024-11-11 00:45,11,6,5,0,0,0
2024-11-11 01:00,1,0,1,0,0,0
2024-11-11 01:15,0,0,0,0,0,0
2024-11-11 01:30,2,2,0,0,0,0
2024-11-11 01:45,1,1,0,0,0,0
2024-11-11 02:00,0,0,0,0,0,0
2024-11-11 02:15,0,0,0,0,0,0
2024-11-11 02:30,2,0,2,0,0,0
2024-11-11 02:45,2,2,0,0,0,0
2024-11-11 03:00,0,0,0,0,0,0
2024-11-11 03:15,2,0,2,0,0,0
2024-11-11 03:30,0,0,0,0,0,0
2024-11-11 03:45,3,1,2,0,0,0
2024-11-11 04:00,2,1,1,0,0,0
2024-11-11 04:15,1,0,1,0,0,0
2024-11-11 04:30,4,1,3,0,0,0
2024-11-11 04:45,5,4,1,0,0,0
2024-11-11 05:00,4,4,0,0,0,0
2024-11-11 05:15,8,3,5,0,0,0
2024-11-11 05:30,15,4,11,0,0,0
2024-11-11 05:45,24,9,15,0,0,0
2024-11-11 06:00,18,9,9,0,0,0
2024-11-11 06:15,57,29,28,0,0,0
2024-11-11 06:30,58,26,32,0,0,0
2024-11-11 06:45,91,40,51,0,0,0
2024-11-11 07:00,83,33,50,0,0,0
2024-11-11 07:15,161,50,111,0,0,0
2024-11-11 07:30,331,77,254,0,0,0
2024-11-11 07:45,253,72,181,0,0,0
2024-11-11 08:00,214,58,156,0,0,0
2024-11-11 08:15,171,43,128,0,0,0
2024-11-11 08:30,152,46,106,0,0,0
2024-11-11 08:45,182,68,114,0,0,0
2024-11-11 09:00,114,41,73,0,0,0
2024-11-11 09:15,100,32,68,0,0,0
2024-11-11 09:30,105,24,81,0,0,0
2024-11-11 09:45,160,29,131,0,0,0
2024-11-11 10:00,111,34,77,0,0,0
2024-11-11 10:15,80,27,53,0,0,0
2024-11-11 10:30,96,36,60,0,0,0
2024-11-11 10:45,90,29,61,0,0,0
2024-11-11 11:00,98,43,55,0,0,0
2024-11-11 11:15,114,52,62,0,0,0
2024-11-11 11:30,108,40,68,0,0,0
2024-11-11 11:45,142,56,86,0,0,0
2024-11-11 12:00,140,55,85,0,0,0
2024-11-11 12:15,124,58,66,0,0,0
2024-11-11 12:30,128,73,55,0,0,0
2024-11-11 12:45,134,57,77,0,0,0
2024-11-11 13:00,175,85,90,0,0,0
2024-11-11 13:15,136,71,65,0,0,0
2024-11-11 13:30,120,55,65,0,0,0
2024-11-11 13:45,169,76,93,0,0,0
2024-11-11 14:00,194,104,90,0,0,0
2024-11-11 14:15,152,80,72,0,0,0
2024-11-11 14:30,142,71,71,0,0,0
2024-11-11 14:45,150,66,84,0,0,0
2024-11-11 15:00,146,82,64,0,0,0
2024-11-11 15:15,126,80,46,0,0,0
2024-11-11 15:30,166,102,64,0,0,0
2024-11-11 15:45,223,127,96,0,0,0
2024-11-11 16:00,205,112,93,0,0,0
2024-11-11 16:15,186,107,79,0,0,0
2024-11-11 16:30,167,92,75,0,0,0
2024-11-11 16:45,160,84,76,0,0,0
2024-11-11 17:00,188,113,75,0,0,0
2024-11-11 17:15,170,84,86,0,0,0
2024-11-11 17:30,170,96,74,0,0,0
2024-11-11 17:45,192,114,78,0,0,0
2024-11-11 18:00,195,133,62,0,0,0
2024-11-11 18:15,138,73,65,0,0,0
2024-11-11 18:30,134,76,58,0,0,0
2024-11-11 18:45,132,63,69,0,0,0
2024-11-11 19:00,140,74,66,0,0,0
2024-11-11 19:15,119,70,49,0,0,0
2024-11-11 19:30,98,57,41,0,0,0
2024-11-11 19:45,95,50,45,0,0,0
2024-11-11 20:00,74,37,37,0,0,0
2024-11-11 20:15,56,29,27,0,0,0
2024-11-11 20:30,50,28,22,0,0,0
2024-11-11 20:45,53,24,29,0,0,0
2024-11-11 21:00,64,35,29,0,0,0
2024-11-11 21:15,55,28,27,0,0,0
2024-11-11 21:30,60,30,30,0,0,0
2024-11-11 21:45,53,30,23,0,0,0
2024-11-11 22:00,52,36,16,0,0,0
2024-11-11 22:15,58,31,27,0,0,0
2024-11-11 22:30,32,16,16,0,0,0
2024-11-11 22:45,31,23,8,0,0,0
2024-11-11 23:00,24,14,10,0,0,0
2024-11-11 23:15,20,9,11,0,0,0
2024-11-11 23:30,12,7,5,0,0,0
2024-11-11 23:45,7,3,4,0,0,0
2024-11-12 00:00,14,3,11,0,0,0
2024-11-12 00:15,3,1,2,0,0,0
2024-11-12 00:30,9,2,7,0,0,0
2024-11-12 00:45,7,1,6,0,0,0
2024-11-12 01:00,2,0,2,0,0,0
2024-11-12 01:15,3,2,1,0,0,0
2024-11-12 01:30,2,1,1,0,0,0
2024-11-12 01:45,0,0,0,0,0,0
2024-11-12 02:00,3,2,1,0,0,0
2024-11-12 02:15,2,1,1,0,0,0
2024-11-12 02:30,1,0,1,0,0,0
2024-11-12 02:45,1,1,0,0,0,0
2024-11-12 03:00,0,0,0,0,0,0
2024-11-12 03:15,2,0,2,0,0,0
2024-11-12 03:30,1,1,0,0,0,0
2024-11-12 03:45,1,0,1,0,0,0
2024-11-12 04:00,2,0,2,0,0,0
2024-11-12 04:15,4,3,1,0,0,0
2024-11-12 04:30,1,0,1,0,0,0
2024-11-12 04:45,6,4,2,0,0,0
2024-11-12 05:00,5,5,0,0,0,0
2024-11-12 05:15,9,2,7,0,0,0
2024-11-12 05:30,18,9,9,0,0,0
2024-11-12 05:45,24,8,16,0,0,0
2024-11-12 06:00,22,6,16,0,0,0
2024-11-12 06:15,59,22,37,0,0,0
2024-11-12 06:30,57,22,35,0,0,0
2024-11-12 06:45,92,40,52,0,0,0
2024-11-12 07:00,89,36,53,0,0,0
2024-11-12 07:15,188,56,132,0,0,0
2024-11-12 07:30,324,86,238,0,0,0
2024-11-12 07:45,314,86,228,0,0,0
2024-11-12 08:00,273,96,177,0,0,0
2024-11-12 08:15,231,79,152,0,0,0
2024-11-12 08:30,210,57,153,0,0,0
2024-11-12 08:45,225,59,166,0,0,0
2024-11-12 09:00,121,38,83,0,0,0
2024-11-12 09:15,127,38,89,0,0,0
2024-11-12 09:30,151,39,112,0,0,0
2024-11-12 09:45,218,47,171,0,0,0
2024-11-12 10:00,151,49,102,0,0,0
2024-11-12 10:15,99,35,64,0,0,0
2024-11-12 10:30,83,31,52,0,0,0
2024-11-12 10:45,115,33,82,0,0,0
2024-11-12 11:00,94,42,52,0,0,0
2024-11-12 11:15,133,63,70,0,0,0
2024-11-12 11:30,132,53,79,0,0,0
2024-11-12 11:45,171,72,99,0,0,0
2024-11-12 12:00,161,77,84,0,0,0
2024-11-12 12:15,122,58,64,0,0,0
2024-11-12 12:30,128,65,63,0,0,0
2024-11-12 12:45,157,61,96,0,0,0
2024-11-12 13:00,141,78,63,0,0,0
2024-11-12 13:15,162,86,76,0,0,0
2024-11-12 13:30,155,74,81,0,0,0
2024-11-12 13:45,223,112,111,0,0,0
2024-11-12 14:00,223,117,106,0,0,0
2024-11-12 14:15,184,85,99,0,0,0
2024-11-12 14:30,140,66,74,0,0,0
2024-11-12 14:45,177,81,96,0,0,0
2024-11-12 15:00,184,92,92,0,0,0
2024-11-12 15:15,177,97,80,0,0,0
2024-11-12 15:30,216,119,97,0,0,0
2024-11-12 15:45,271,142,129,0,0,0
2024-11-12 16:00,251,131,120,0,0,0
2024-11-12 16:15,255,148,107,0,0,0
2024-11-12 16:30,253,128,125,0,0,0
2024-11-12 16:45,265,140,125,0,0,0
2024-11-12 17:00,277,157,120,0,0,0
2024-11-12 17:15,260,134,126,0,0,0
2024-11-12 17:30,250,115,135,0,0,0
2024-11-12 17:45,263,140,123,0,0,0
2024-11-12 18:00,241,151,90,0,0,0
2024-11-12 18:15,239,124,115,0,0,0
2024-11-12 18:30,179,102,77,0,0,0
2024-11-12 18:45,225,127,98,0,0,0
2024-11-12 19:00,146,87,59,0,0,0
2024-11-12 19:15,144,75,69,0,0,0
2024-11-12 19:30,144,86,58,0,0,0
2024-11-12 19:45,138,86,52,0,0,0
2024-11-12 20:00,136,75,61,0,0,0
2024-11-12 20:15,108,68,40,0,0,0
2024-11-12 20:30,81,51,30,0,0,0
2024-11-12 20:45,69,38,31,0,0,0
2024-11-12 21:00,78,42,36,0,0,0
2024-11-12 21:15,88,45,43,0,0,0
2024-11-12 21:30,58,33,25,0,0,0
2024-11-12 21:45,56,31,25,0,0,0
2024-11-12 22:00,87,46,41,0,0,0
2024-11-12 22:15,62,41,21,0,0,0
2024-11-12 22:30,77,51,26,0,0,0
2024-11-12 22:45,74,29,45,0,0,0
2024-11-12 23:00,40,20,20,0,0,0
2024-11-12 23:15,31,16,15,0,0,0
2024-11-12 23:30,31,21,10,0,0,0
2024-11-12 23:45,13,6,7,0,0,0
2024-11-13 00:00,11,7,4,0,0,0
2024-11-13 00:15,8,6,2,0,0,0
2024-11-13 00:30,18,6,12,0,0,0
2024-11-13 00:45,7,4,3,0,0,0
2024-11-13 01:00,6,4,2,0,0,0
2024-11-13 01:15,8,3,5,0,0,0
2024-11-13 01:30,8,5,3,0,0,0
2024-11-13 01:45,5,2,3,0,0,0
2024-11-13 02:00,3,3,0,0,0,0
2024-11-13 02:15,3,2,1,0,0,0
2024-11-13 02:30,3,2,1,0,0,0
2024-11-13 02:45,2,1,1,0,0,0
2024-11-13 03:00,0,0,0,0,0,0
2024-11-13 03:15,0,0,0,0,0,0
2024-11-13 03:30,1,0,1,0,0,0
2024-11-13 03:45,1,0,1,0,0,0
2024-11-13 04:00,1,0,1,0,0,0
2024-11-13 04:15,4,3,1,0,0,0
2024-11-13 04:30,3,0,3,0,0,0
2024-11-13 04:45,4,2,2,0,0,0
2024-11-13 05:00,6,3,3,0,0,0
2024-11-13 05:15,11,2,9,0,0,0
2024-11-13 05:30,16,5,11,0,0,0
2024-11-13 05:45,27,10,17,0,0,0
2024-11-13 06:00,24,7,17,0,0,0
2024-11-13 06:15,53,17,36,0,0,0
2024-11-13 06:30,56,21,35,0,0,0
2024-11-13 06:45,83,30,53,0,0,0
2024-11-13 07:00,102,39,63,0,0,0
2024-11-13 07:15,194,53,141,0,0,0
2024-11-13 07:30,349,68,281,0,0,0
2024-11-13 07:45,333,81,252,0,0,0
2024-11-13 08:00,283,89,194,0,0,0
2024-11-13 08:15,223,60,163,0,0,0
2024-11-13 08:30,219,65,154,0,0,0
2024-11-13 08:45,199,50,149,0,0,0
2024-11-13 09:00,153,50,103,0,0,0
2024-11-13 09:15,141,45,96,0,0,0
2024-11-13 09:30,179,51,128,0,0,0
2024-11-13 09:45,221,45,176,0,0,0
2024-11-13 10:00,162,51,111,0,0,0
2024-11-13 10:15,129,41,88,0,0,0
2024-11-13 10:30,105,30,75,0,0,0
2024-11-13 10:45,145,54,91,0,0,0
2024-11-13 11:00,116,45,71,0,0,0
2024-11-13 11:15,128,53,75,0,0,0
2024-11-13 11:30,143,47,96,0,0,0
2024-11-13 11:45,216,113,103,0,0,0
2024-11-13 12:00,183,84,99,0,0,0
2024-11-13 12:15,155,81,74,0,0,0
2024-11-13 12:30,172,98,74,0,0,0
2024-11-13 12:45,193,89,104,0,0,0
2024-11-13 13:00,178,97,81,0,0,0
2024-11-13 13:15,190,104,86,0,0,0
2024-11-13 13:30,145,77,68,0,0,0
2024-11-13 13:45,203,93,110,0,0,0
2024-11-13 14:00,219,138,81,0,0,0
2024-11-13 14:15,176,97,79,0,0,0
2024-11-13 14:30,173,98,75,0,0,0
2024-11-13 14:45,189,102,87,0,0,0
2024-11-13 15:00,152,84,68,0,0,0
2024-11-13 15:15,162,105,57,0,0,0
2024-11-13 15:30,208,121,87,0,0,0
2024-11-13 15:45,230,131,99,0,0,0
2024-11-13 16:00,261,149,112,0,0,0
2024-11-13 16:15,209,116,93,0,0,0
2024-11-13 16:30,222,124,98,0,0,0
2024-11-13 16:45,205,120,85,0,0,0
2024-11-13 17:00,184,95,89,0,0,0
2024-11-13 17:15,216,118,98,0,0,0
2024-11-13 17:30,180,101,79,0,0,0
2024-11-13 17:45,263,152,111,0,0,0
2024-11-13 18:00,215,134,81,0,0,0
2024-11-13 18:15,219,108,111,0,0,0
2024-11-13 18:30,184,108,76,0,0,0
2024-11-13 18:45,188,102,86,0,0,0
2024-11-13 19:00,163,89,74,0,0,0
2024-11-13 19:15,175,104,71,0,0,0
2024-11-13 19:30,116,61,55,0,0,0
2024-11-13 19:45,166,96,70,0,0,0
2024-11-13 20:00,143,78,65,0,0,0
2024-11-13 20:15,87,52,35,0,0,0
2024-11-13 20:30,85,50,35,0,0,0
2024-11-13 20:45,80,52,28,0,0,0
2024-11-13 21:00,95,50,45,0,0,0
2024-11-13 21:15,101,59,42,0,0,0
2024-11-13 21:30,80,44,36,0,0,0
2024-11-13 21:45,86,43,43,0,0,0
2024-11-13 22:00,74,40,34,0,0,0
2024-11-13 22:15,77,34,43,0,0,0
2024-11-13 22:30,69,40,29,0,0,0
2024-11-13 22:45,61,31,30,0,0,0
2024-11-13 23:00,63,29,34,0,0,0
2024-11-13 23:15,45,21,24,0,0,0
2024-11-13 23:30,52,38,14,0,0,0
2024-11-13 23:45,22,14,8,0,0,0
2024-11-14 00:00,30,15,15,0,0,0
2024-11-14 00:15,36,23,13,0,0,0
2024-11-14 00:30,20,5,15,0,0,0
2024-11-14 00:45,13,6,7,0,0,0
2024-11-14 01:00,22,10,12,0,0,0
2024-11-14 01:15,10,5,5,0,0,0
2024-11-14 01:30,11,2,9,0,0,0
2024-11-14 01:45,7,3,4,0,0,0
2024-11-14 02:00,13,4,9,0,0,0
2024-11-14 02:15,12,7,5,0,0,0
2024-11-14 02:30,9,1,8,0,0,0
2024-11-14 02:45,9,6,3,0,0,0
2024-11-14 03:00,15,10,5,0,0,0
2024-11-14 03:15,9,1,8,0,0,0
2024-11-14 03:30,13,6,7,0,0,0
2024-11-14 03:45,11,2,9,0,0,0
2024-11-14 04:00,7,1,6,0,0,0
2024-11-14 04:15,7,1,6,0,0,0
2024-11-14 04:30,7,4,3,0,0,0
2024-11-14 04:45,9,9,0,0,0,0
2024-11-14 05:00,10,7,3,0,0,0
2024-11-14 05:15,7,0,7,0,0,0
2024-11-14 05:30,17,5,12,0,0,0
2024-11-14 05:45,24,13,11,0,0,0
2024-11-14 06:00,18,9,9,0,0,0
2024-11-14 06:15,50,20,30,0,0,0
2024-11-14 06:30,58,13,45,0,0,0
2024-11-14 06:45,83,41,42,0,0,0
2024-11-14 07:00,97,34,63,0,0,0
2024-11-14 07:15,171,55,116,0,0,0
2024-11-14 07:30,340,85,255,0,0,0
2024-11-14 07:45,333,100,233,0,0,0
2024-11-14 08:00,250,68,182,0,0,0
2024-11-14 08:15,193,70,123,0,0,0
2024-11-14 08:30,196,52,144,0,0,0
2024-11-14 08:45,190,59,131,0,0,0
2024-11-14 09:00,142,41,101,0,0,0
2024-11-14 09:15,147,47,100,0,0,0
2024-11-14 09:30,144,42,102,0,0,0
2024-11-14 09:45,192,42,150,0,0,0
2024-11-14 10:00,172,50,122,0,0,0
2024-11-14 10:15,117,43,74,0,0,0
2024-11-14 10:30,122,35,87,0,0,0
2024-11-14 10:45,143,51,92,0,0,0
2024-11-14 11:00,106,44,62,0,0,0
2024-11-14 11:15,105,39,66,0,0,0
2024-11-14 11:30,123,43,80,0,0,0
2024-11-14 11:45,158,64,94,0,0,0
2024-11-14 12:00,180,87,93,0,0,0
2024-11-14 12:15,160,76,84,0,0,0
2024-11-14 12:30,140,64,76,0,0,0
2024-11-14 12:45,179,79,100,0,0,0
2024-11-14 13:00,172,103,69,0,0,0
2024-11-14 13:15,163,76,87,0,0,0
2024-11-14 13:30,147,69,78,0,0,0
2024-11-14 13:45,185,91,94,0,0,0
2024-11-14 14:00,197,117,80,0,0,0
2024-11-14 14:15,172,96,76,0,0,0
2024-11-14 14:30,192,104,88,0,0,0
2024-11-14 14:45,191,86,105,0,0,0
2024-11-14 15:00,196,110,86,0,0,0
2024-11-14 15:15,176,94,82,0,0,0
2024-11-14 15:30,218,104,114,0,0,0
2024-11-14 15:45,239,131,108,0,0,0
2024-11-14 16:00,281,142,139,0,0,0
2024-11-14 16:15,262,137,125,0,0,0
2024-11-14 16:30,234,122,112,0,0,0
2024-11-14 16:45,215,117,98,0,0,0
2024-11-14 17:00,220,127,93,0,0,0
2024-11-14 17:15,228,132,96,0,0,0
2024-11-14 17:30,236,135,101,0,0,0
2024-11-14 17:45,236,122,114,0,0,0
2024-11-14 18:00,196,97,99,0,0,0
2024-11-14 18:15,233,124,109,0,0,0
2024-11-14 18:30,183,108,75,0,0,0
2024-11-14 18:45,173,83,90,0,0,0
2024-11-14 19:00,151,93,58,0,0,0
2024-11-14 19:15,150,86,64,0,0,0
2024-11-14 19:30,139,78,61,0,0,0
2024-11-14 19:45,147,81,66,0,0,0
2024-11-14 20:00,118,61,57,0,0,0
2024-11-14 20:15,86,45,41,0,0,0
2024-11-14 20:30,88,43,45,0,0,0
2024-11-14 20:45,80,46,34,0,0,0
2024-11-14 21:00,64,42,22,0,0,0
2024-11-14 21:15,70,46,24,0,0,0
2024-11-14 21:30,64,37,27,0,0,0
2024-11-14 21:45,82,43,39,0,0,0
2024-11-14 22:00,82,47,35,0,0,0
2024-11-14 22:15,81,49,32,0,0,0
2024-11-14 22:30,65,40,25,0,0,0
2024-11-14 22:45,40,19,21,0,0,0
2024-11-14 23:00,41,22,19,0,0,0
2024-11-14 23:15,31,18,13,0,0,0
2024-11-14 23:30,25,17,8,0,0,0
2024-11-14 23:45,22,7,15,0,0,0
2024-11-15 00:00,20,9,11,0,0,0
2024-11-15 00:15,19,8,11,0,0,0
2024-11-15 00:30,21,15,6,0,0,0
2024-11-15 00:45,15,7,8,0,0,0
2024-11-15 01:00,17,7,10,0,0,0
2024-11-15 01:15,11,5,6,0,0,0
2024-11-15 01:30,1,1,0,0,0,0
2024-11-15 01:45,4,2,2,0,0,0
2024-11-15 02:00,2,1,1,0,0,0
2024-11-15 02:15,2,1,1,0,0,0
2024-11-15 02:30,0,0,0,0,0,0
2024-11-15 02:45,2,2,0,0,0,0
2024-11-15 03:00,2,0,2,0,0,0
2024-11-15 03:15,1,0,1,0,0,0
2024-11-15 03:30,5,3,2,0,0,0
2024-11-15 03:45,4,3,1,0,0,0
2024-11-15 04:00,3,2,1,0,0,0
2024-11-15 04:15,2,1,1,0,0,0
2024-11-15 04:30,3,1,2,0,0,0
2024-11-15 04:45,4,3,1,0,0,0
2024-11-15 05:00,4,4,0,0,0,0
2024-11-15 05:15,7,4,3,0,0,0
2024-11-15 05:30,16,5,11,0,0,0
2024-11-15 05:45,22,5,17,0,0,0
2024-11-15 06:00,19,10,9,0,0,0
2024-11-15 06:15,42,16,26,0,0,0
2024-11-15 06:30,48,15,33,0,0,0
2024-11-15 06:45,79,31,48,0,0,0
2024-11-15 07:00,81,28,53,0,0,0
2024-11-15 07:15,150,39,111,0,0,0
2024-11-15 07:30,303,77,226,0,0,0
2024-11-15 07:45,301,76,225,0,0,0
2024-11-15 08:00,199,61,138,0,0,0
2024-11-15 08:15,164,54,110,0,0,0
2024-11-15 08:30,173,43,130,0,0,0
2024-11-15 08:45,189,56,133,0,0,0
2024-11-15 09:00,119,30,89,0,0,0
2024-11-15 09:15,127,40,87,0,0,0
2024-11-15 09:30,154,31,123,0,0,0
2024-11-15 09:45,207,58,149,0,0,0
2024-11-15 10:00,143,51,92,0,0,0
2024-11-15 10:15,118,56,62,0,0,0
2024-11-15 10:30,99,33,66,0,0,0
2024-11-15 10:45,126,40,86,0,0,0
2024-11-15 11:00,122,55,67,0,0,0
2024-11-15 11:15,139,67,72,0,0,0
2024-11-15 11:30,130,49,81,0,0,0
2024-11-15 11:45,156,73,83,0,0,0
2024-11-15 12:00,179,78,101,0,0,0
2024-11-15 12:15,166,74,92,0,0,0
2024-11-15 12:30,194,102,92,0,0,0
2024-11-15 12:45,230,114,116,0,0,0
2024-11-15 13:00,227,129,98,0,0,0
2024-11-15 13:15,210,109,101,0,0,0
2024-11-15 13:30,179,88,91,0,0,0
2024-11-15 13:45,191,106,85,0,0,0
2024-11-15 14:00,203,96,107,0,0,0
2024-11-15 14:15,216,124,92,0,0,0
2024-11-15 14:30,186,85,101,0,0,0
2024-11-15 14:45,221,109,112,0,0,0
2024-11-15 15:00,191,111,80,0,0,0
2024-11-15 15:15,191,99,92,0,0,0
2024-11-15 15:30,200,103,97,0,0,0
2024-11-15 15:45,209,105,104,0,0,0
2024-11-15 16:00,173,103,70,0,0,0
2024-11-15 16:15,195,96,99,0,0,0
2024-11-15 16:30,212,115,97,0,0,0
2024-11-15 16:45,217,120,97,0,0,0
2024-11-15 17:00,225,126,99,0,0,0
2024-11-15 17:15,189,106,83,0,0,0
2024-11-15 17:30,152,83,69,0,0,0
2024-11-15 17:45,182,108,74,0,0,0
2024-11-15 18:00,163,81,82,0,0,0
2024-11-15 18:15,167,83,84,0,0,0
2024-11-15 18:30,149,89,60,0,0,0
2024-11-15 18:45,184,89,95,0,0,0
2024-11-15 19:00,173,97,76,0,0,0
2024-11-15 19:15,164,90,74,0,0,0
2024-11-15 19:30,137,76,61,0,0,0
2024-11-15 19:45,128,67,61,0,0,0
2024-11-15 20:00,119,61,58,0,0,0
2024-11-15 20:15,135,79,56,0,0,0
2024-11-15 20:30,75,46,29,0,0,0
2024-11-15 20:45,86,41,45,0,0,0
2024-11-15 21:00,63,30,33,0,0,0
2024-11-15 21:15,58,26,32,0,0,0
2024-11-15 21:30,61,43,18,0,0,0
2024-11-15 21:45,60,37,23,0,0,0
2024-11-15 22:00,67,26,41,0,0,0
2024-11-15 22:15,58,32,26,0,0,0
2024-11-15 22:30,57,25,32,0,0,0
2024-11-15 22:45,66,30,36,0,0,0
2024-11-15 23:00,58,29,29,0,0,0
2024-11-15 23:15,117,52,65,0,0,0
2024-11-15 23:30,68,31,37,0,0,0
2024-11-15 23:45,64,31,33,0,0,0
2024-11-16 00:00,77,36,41,0,0,0
2024-11-16 00:15,64,33,31,0,0,0
2024-11-16 00:30,57,29,28,0,0,0
2024-11-16 00:45,57,22,35,0,0,0
2024-11-16 01:00,54,28,26,0,0,0
2024-11-16 01:15,49,29,20,0,0,0
2024-11-16 01:30,32,16,16,0,0,0
2024-11-16 01:45,31,16,15,0,0,0
2024-11-16 02:00,30,12,18,0,0,0
2024-11-16 02:15,23,15,8,0,0,0
2024-11-16 02:30,22,13,9,0,0,0
2024-11-16 02:45,32,9,23,0,0,0
2024-11-16 03:00,25,3,22,0,0,0
2024-11-16 03:15,8,5,3,0,0,0
2024-11-16 03:30,31,13,18,0,0,0
2024-11-16 03:45,23,12,11,0,0,0
2024-11-16 04:00,18,10,8,0,0,0
2024-11-16 04:15,11,4,7,0,0,0
2024-11-16 04:30,9,5,4,0,0,0
2024-11-16 04:45,6,5,1,0,0,0
2024-11-16 05:00,6,4,2,0,0,0
2024-11-16 05:15,4,2,2,0,0,0
2024-11-16 05:30,14,6,8,0,0,0
2024-11-16 05:45,11,2,9,0,0,0
2024-11-16 06:00,7,1,6,0,0,0
2024-11-16 06:15,17,4,13,0,0,0
2024-11-16 06:30,12,4,8,0,0,0
2024-11-16 06:45,17,10,7,0,0,0
2024-11-16 07:00,25,9,16,0,0,0
2024-11-16 07:15,16,6,10,0,0,0
2024-11-16 07:30,25,9,16,0,0,0
2024-11-16 07:45,20,10,10,0,0,0
2024-11-16 08:00,28,12,16,0,0,0
2024-11-16 08:15,45,15,30,0,0,0
2024-11-16 08:30,58,16,42,0,0,0
2024-11-16 08:45,90,25,65,0,0,0
2024-11-16 09:00,51,20,31,0,0,0
2024-11-16 09:15,91,32,59,0,0,0
2024-11-16 09:30,99,28,71,0,0,0
2024-11-16 09:45,138,32,106,0,0,0
2024-11-16 10:00,105,33,72,0,0,0
2024-11-16 10:15,118,31,87,0,0,0
2024-11-16 10:30,150,39,111,0,0,0
2024-11-16 10:45,185,60,125,0,0,0
2024-11-16 11:00,137,47,90,0,0,0
2024-11-16 11:15,159,49,110,0,0,0
2024-11-16 11:30,161,51,110,0,0,0
2024-11-16 11:45,180,74,106,0,0,0
2024-11-16 12:00,165,63,102,0,0,0
2024-11-16 12:15,169,70,99,0,0,0
2024-11-16 12:30,186,71,115,0,0,0
2024-11-16 12:45,201,71,130,0,0,0
2024-11-16 13:00,170,62,108,0,0,0
2024-11-16 13:15,180,92,88,0,0,0
2024-11-16 13:30,159,82,77,0,0,0
2024-11-16 13:45,179,89,90,0,0,0
2024-11-16 14:00,163,82,81,0,0,0
2024-11-16 14:15,148,78,70,0,0,0
2024-11-16 14:30,174,113,61,0,0,0
2024-11-16 14:45,179,100,79,0,0,0
2024-11-16 15:00,130,72,58,0,0,0
2024-11-16 15:15,127,75,52,0,0,0
2024-11-16 15:30,141,71,70,0,0,0
2024-11-16 15:45,151,86,65,0,0,0
2024-11-16 16:00,134,78,56,0,0,0
2024-11-16 16:15,122,68,54,0,0,0
2024-11-16 16:30,121,68,53,0,0,0
2024-11-16 16:45,141,87,54,0,0,0
2024-11-16 17:00,106,66,40,0,0,0
2024-11-16 17:15,120,65,55,0,0,0
2024-11-16 17:30,107,72,35,0,0,0
2024-11-16 17:45,129,73,56,0,0,0
2024-11-16 18:00,129,72,57,0,0,0
2024-11-16 18:15,153,84,69,0,0,0
2024-11-16 18:30,94,53,41,0,0,0
2024-11-16 18:45,114,62,52,0,0,0
2024-11-16 19:00,107,55,52,0,0,0
2024-11-16 19:15,115,59,56,0,0,0
2024-11-16 19:30,81,42,39,0,0,0
2024-11-16 19:45,121,67,54,0,0,0
2024-11-16 20:00,95,43,52,0,0,0
2024-11-16 20:15,65,34,31,0,0,0
2024-11-16 20:30,76,33,43,0,0,0
2024-11-16 20:45,62,32,30,0,0,0
2024-11-16 21:00,72,39,33,0,0,0
2024-11-16 21:15,62,41,21,0,0,0
2024-11-16 21:30,52,32,20,0,0,0
2024-11-16 21:45,44,16,28,0,0,0
2024-11-16 22:00,61,31,30,0,0,0
2024-11-16 22:15,42,25,17,0,0,0
2024-11-16 22:30,50,20,30,0,0,0
2024-11-16 22:45,72,40,32,0,0,0
2024-11-16 23:00,59,37,22,0,0,0
2024-11-16 23:15,50,21,29,0,0,0
2024-11-16 23:30,46,29,17,0,0,0
2024-11-16 23:45,56,27,29,0,0,0
2024-11-17 00:00,59,24,35,0,0,0
2024-11-17 00:15,53,24,29,0,0,0
2024-11-17 00:30,45,20,25,0,0,0
2024-11-17 00:45,48,26,22,0,0,0
2024-11-17 01:00,57,28,29,0,0,0
2024-11-17 01:15,32,15,17,0,0,0
2024-11-17 01:30,39,18,21,0,0,0
2024-11-17 01:45,23,13,10,0,0,0
2024-11-17 02:00,24,10,14,0,0,0
2024-11-17 02:15,31,15,16,0,0,0
2024-11-17 02:30,21,6,15,0,0,0
2024-11-17 02:45,17,8,9,0,0,0
2024-11-17 03:00,28,11,17,0,0,0
2024-11-17 03:15,11,4,7,0,0,0
2024-11-17 03:30,12,6,6,0,0,0
2024-11-17 03:45,10,6,4,0,0,0
2024-11-17 04:00,16,5,11,0,0,0
2024-11-17 04:15,5,1,4,0,0,0
2024-11-17 04:30,7,3,4,0,0,0
2024-11-17 04:45,7,2,5,0,0,0
2024-11-17 05:00,6,2,4,0,0,0
2024-11-17 05:15,8,2,6,0,0,0
2024-11-17 05:30,8,3,5,0,0,0
2024-11-17 05:45,6,2,4,0,0,0
2024-11-17 06:00,3,0,3,0,0,0
2024-11-17 06:15,7,2,5,0,0,0
2024-11-17 06:30,5,1,4,0,0,0
2024-11-17 06:45,4,2,2,0,0,0
2024-11-17 07:00,5,0,5,0,0,0
2024-11-17 07:15,6,2,4,0,0,0
2024-11-17 07:30,7,2,5,0,0,0
2024-11-17 07:45,9,7,2,0,0,0
2024-11-17 08:00,8,3,5,0,0,0
2024-11-17 08:15,15,5,10,0,0,0
2024-11-17 08:30,16,4,12,0,0,0
2024-11-17 08:45,22,10,12,0,0,0
2024-11-17 09:00,16,13,3,0,0,0
2024-11-17 09:15,28,16,12,0,0,0
2024-11-17 09:30,34,9,25,0,0,0
2024-11-17 09:45,64,33,31,0,0,0
2024-11-17 10:00,44,28,16,0,0,0
2024-11-17 10:15,52,16,36,0,0,0
2024-11-17 10:30,44,23,21,0,0,0
2024-11-17 10:45,52,29,23,0,0,0
2024-11-17 11:00,49,23,26,0,0,0
2024-11-17 11:15,42,21,21,0,0,0
2024-11-17 11:30,41,14,27,0,0,0
2024-11-17 11:45,41,16,25,0,0,0
2024-11-17 12:00,60,29,31,0,0,0
2024-11-17 12:15,60,33,27,0,0,0
2024-11-17 12:30,57,30,27,0,0,0
2024-11-17 12:45,72,39,33,0,0,0
2024-11-17 13:00,67,35,32,0,0,0
2024-11-17 13:15,67,31,36,0,0,0
2024-11-17 13:30,74,32,42,0,0,0
2024-11-17 13:45,80,30,50,0,0,0
2024-11-17 14:00,53,26,27,0,0,0
2024-11-17 14:15,83,29,54,0,0,0
2024-11-17 14:30,77,30,47,0,0,0
2024-11-17 14:45,70,30,40,0,0,0
2024-11-17 15:00,82,33,49,0,0,0
2024-11-17 15:15,85,42,43,0,0,0
2024-11-17 15:30,67,34,33,0,0,0
2024-11-17 15:45,91,38,53,0,0,0
2024-11-17 16:00,105,63,42,0,0,0
2024-11-17 16:15,74,34,40,0,0,0
2024-11-17 16:30,78,41,37,0,0,0
2024-11-17 16:45,107,60,47,0,0,0
2024-11-17 17:00,95,42,53,0,0,0
2024-11-17 17:15,72,37,35,0,0,0
2024-11-17 17:30,97,61,36,0,0,0
2024-11-17 17:45,102,51,51,0,0,0
2024-11-17 18:00,75,35,40,0,0,0
2024-11-17 18:15,88,43,45,0,0,0
2024-11-17 18:30,77,29,48,0,0,0
2024-11-17 18:45,72,28,44,0,0,0
2024-11-17 19:00,74,41,33,0,0,0
2024-11-17 19:15,64,25,39,0,0,0
2024-11-17 19:30,78,35,43,0,0,0
2024-11-17 19:45,56,29,27,0,0,0
2024-11-17 20:00,63,31,32,0,0,0
2024-11-17 20:15,44,20,24,0,0,0
2024-11-17 20:30,37,7,30,0,0,0
2024-11-17 20:45,27,12,15,0,0,0
2024-11-17 21:00,34,22,12,0,0,0
2024-11-17 21:15,34,14,20,0,0,0
2024-11-17 21:30,36,18,18,0,0,0
2024-11-17 21:45,48,31,17,0,0,0
2024-11-17 22:00,25,9,16,0,0,0
2024-11-17 22:15,32,15,17,0,0,0
2024-11-17 22:30,30,13,17,0,0,0
2024-11-17 22:45,23,8,15,0,0,0
2024-11-17 23:00,43,27,16,0,0,0
2024-11-17 23:15,8,4,4,0,0,0
2024-11-17 23:30,17,10,7,0,0,0
2024-11-17 23:45,10,2,8,0,0,0
2024-11-18 00:00,9,0,9,0,0,0
2024-11-18 00:15,6,2,4,0,0,0
2024-11-18 00:30,3,2,1,0,0,0
2024-11-18 00:45,3,1,2,0,0,0
2024-11-18 01:00,6,3,3,0,0,0
2024-11-18 01:15,1,0,1,0,0,0
2024-11-18 01:30,4,2,2,0,0,0
2024-11-18 01:45,1,0,1,0,0,0
2024-11-18 02:00,2,1,1,0,0,0
2024-11-18 02:15,1,1,0,0,0,0
2024-11-18 02:30,2,1,1,0,0,0
2024-11-18 02:45,0,0,0,0,0,0
2024-11-18 03:00,1,0,1,0,0,0
2024-11-18 03:15,0,0,0,0,0,0
2024-11-18 03:30,0,0,0,0,0,0
2024-11-18 03:45,1,0,1,0,0,0
2024-11-18 04:00,1,1,0,0,0,0
2024-11-18 04:15,1,0,1,0,0,0
2024-11-18 04:30,1,1,0,0,0,0
2024-11-18 04:45,7,5,2,0,0,0
2024-11-18 05:00,5,4,1,0,0,0
2024-11-18 05:15,3,1,2,0,0,0
2024-11-18 05:30,18,3,15,0,0,0
2024-11-18 05:45,23,6,17,0,0,0
2024-11-18 06:00,18,6,12,0,0,0
2024-11-18 06:15,40,27,13,0,0,0
2024-11-18 06:30,40,9,31,0,0,0
2024-11-18 06:45,74,29,45,0,0,0
2024-11-18 07:00,99,38,61,0,0,0
2024-11-18 07:15,165,49,116,0,0,0
2024-11-18 07:30,324,79,245,0,0,0
2024-11-18 07:45,326,94,232,0,0,0
2024-11-18 08:00,230,69,161,0,0,0
2024-11-18 08:15,205,50,155,0,0,0
2024-11-18 08:30,197,59,138,0,0,0
2024-11-18 08:45,191,54,137,0,0,0
2024-11-18 09:00,130,36,94,0,0,0
2024-11-18 09:15,133,42,91,0,0,0
2024-11-18 09:30,164,35,129,0,0,0
2024-11-18 09:45,222,45,177,0,0,0
2024-11-18 10:00,134,47,87,0,0,0
2024-11-18 10:15,124,54,70,0,0,0
2024-11-18 10:30,103,29,74,0,0,0
2024-11-18 10:45,127,47,80,0,0,0
2024-11-18 11:00,97,36,61,0,0,0
2024-11-18 11:15,126,43,83,0,0,0
2024-11-18 11:30,124,42,82,0,0,0
2024-11-18 11:45,140,60,80,0,0,0
2024-11-18 12:00,153,66,87,0,0,0
2024-11-18 12:15,151,74,77,0,0,0
2024-11-18 12:30,150,86,64,0,0,0
2024-11-18 12:45,167,86,81,0,0,0
2024-11-18 13:00,173,96,77,0,0,0
2024-11-18 13:15,141,74,67,0,0,0
2024-11-18 13:30,149,63,86,0,0,0
2024-11-18 13:45,212,105,107,0,0,0
2024-11-18 14:00,197,94,103,0,0,0
2024-11-18 14:15,164,81,83,0,0,0
2024-11-18 14:30,144,80,64,0,0,0
2024-11-18 14:45,199,106,93,0,0,0
2024-11-18 15:00,166,82,84,0,0,0
2024-11-18 15:15,178,88,90,0,0,0
2024-11-18 15:30,203,116,87,0,0,0
2024-11-18 15:45,252,137,115,0,0,0
2024-11-18 16:00,249,138,111,0,0,0
2024-11-18 16:15,197,105,92,0,0,0
2024-11-18 16:30,200,109,91,0,0,0
2024-11-18 16:45,226,107,119,0,0,0
2024-11-18 17:00,194,106,88,0,0,0
2024-11-18 17:15,246,122,124,0,0,0
2024-11-18 17:30,245,124,121,0,0,0
2024-11-18 17:45,247,147,100,0,0,0
2024-11-18 18:00,241,140,101,0,0,0
2024-11-18 18:15,182,116,66,0,0,0
2024-11-18 18:30,172,87,85,0,0,0
2024-11-18 18:45,176,100,76,0,0,0
2024-11-18 19:00,174,105,69,0,0,0
2024-11-18 19:15,151,80,71,0,0,0
2024-11-18 19:30,125,62,63,0,0,0
2024-11-18 19:45,143,78,65,0,0,0
2024-11-18 20:00,89,44,45,0,0,0
2024-11-18 20:15,85,45,40,0,0,0
2024-11-18 20:30,77,46,31,0,0,0
2024-11-18 20:45,49,18,31,0,0,0
2024-11-18 21:00,44,10,34,0,0,0
2024-11-18 21:15,51,21,30,0,0,0
2024-11-18 21:30,58,27,31,0,0,0
2024-11-18 21:45,36,10,26,0,0,0
2024-11-18 22:00,25,1,24,0,0,0
2024-11-18 22:15,32,4,28,0,0,0
2024-11-18 22:30,38,13,25,0,0,0
2024-11-18 22:45,31,14,17,0,0,0
2024-11-18 23:00,28,16,12,0,0,0
2024-11-18 23:15,22,9,13,0,0,0
2024-11-18 23:30,11,4,7,0,0,0
2024-11-18 23:45,20,12,8,0,0,0
2024-11-19 00:00,8,8,0,0,0,0
2024-11-19 00:15,6,3,3,0,0,0
2024-11-19 00:30,6,5,1,0,0,0
2024-11-19 00:45,3,2,1,0,0,0
2024-11-19 01:00,3,3,0,0,0,0
2024-11-19 01:15,1,1,0,0,0,0
2024-11-19 01:30,0,0,0,0,0,0
2024-11-19 01:45,0,0,0,0,0,0
2024-11-19 02:00,3,0,3,0,0,0
2024-11-19 02:15,2,1,1,0,0,0
2024-11-19 02:30,3,3,0,0,0,0
2024-11-19 02:45,0,0,0,0,0,0
2024-11-19 03:00,1,1,0,0,0,0
2024-11-19 03:15,2,0,2,0,0,0
2024-11-19 03:30,0,0,0,0,0,0
2024-11-19 03:45,1,0,1,0,0,0
2024-11-19 04:00,1,1,0,0,0,0
2024-11-19 04:15,3,2,1,0,0,0
2024-11-19 04:30,1,0,1,0,0,0
2024-11-19 04:45,7,4,3,0,0,0
2024-11-19 05:00,5,5,0,0,0,0
2024-11-19 05:15,4,1,3,0,0,0
2024-11-19 05:30,20,7,13,0,0,0
2024-11-19 05:45,25,11,14,0,0,0
2024-11-19 06:00,15,2,13,0,0,0
2024-11-19 06:15,28,15,13,0,0,0
2024-11-19 06:30,33,8,25,0,0,0
2024-11-19 06:45,69,37,32,0,0,0
2024-11-19 07:00,74,26,48,0,0,0
2024-11-19 07:15,141,44,97,0,0,0
2024-11-19 07:30,213,43,170,0,0,0
2024-11-19 07:45,233,57,176,0,0,0
2024-11-19 08:00,171,47,124,0,0,0
2024-11-19 08:15,134,32,102,0,0,0
2024-11-19 08:30,144,43,101,0,0,0
2024-11-19 08:45,138,37,101,0,0,0
2024-11-19 09:00,101,33,68,0,0,0
2024-11-19 09:15,75,25,50,0,0,0
2024-11-19 09:30,106,31,75,0,0,0
2024-11-19 09:45,162,37,125,0,0,0
2024-11-19 10:00,113,29,84,0,0,0
2024-11-19 10:15,63,17,46,0,0,0
2024-11-19 10:30,49,16,33,0,0,0
2024-11-19 10:45,60,17,43,0,0,0
2024-11-19 11:00,60,29,31,0,0,0
2024-11-19 11:15,74,34,40,0,0,0
2024-11-19 11:30,77,24,53,0,0,0
2024-11-19 11:45,129,63,66,0,0,0
2024-11-19 12:00,124,52,72,0,0,0
2024-11-19 12:15,111,42,69,0,0,0
2024-11-19 12:30,76,51,25,0,0,0
2024-11-19 12:45,106,49,57,0,0,0
2024-11-19 13:00,88,44,44,0,0,0
2024-11-19 13:15,105,63,42,0,0,0
2024-11-19 13:30,97,49,48,0,0,0
2024-11-19 13:45,132,56,76,0,0,0
2024-11-19 14:00,116,63,53,0,0,0
2024-11-19 14:15,79,41,38,0,0,0
2024-11-19 14:30,95,54,41,0,0,0
2024-11-19 14:45,115,55,60,0,0,0
2024-11-19 15:00,94,54,40,0,0,0
2024-11-19 15:15,109,74,35,0,0,0
2024-11-19 15:30,130,73,57,0,0,0
2024-11-19 15:45,165,83,82,0,0,0
2024-11-19 16:00,151,86,65,0,0,0
2024-11-19 16:15,128,73,55,0,0,0
2024-11-19 16:30,143,77,66,0,0,0
2024-11-19 16:45,155,75,80,0,0,0
2024-11-19 17:00,144,76,68,0,0,0
2024-11-19 17:15,166,89,77,0,0,0
2024-11-19 17:30,165,86,79,0,0,0
2024-11-19 17:45,205,115,90,0,0,0
2024-11-19 18:00,171,102,69,0,0,0
2024-11-19 18:15,154,91,63,0,0,0
2024-11-19 18:30,129,71,58,0,0,0
2024-11-19 18:45,142,79,63,0,0,0
2024-11-19 19:00,130,73,57,0,0,0
2024-11-19 19:15,118,55,63,0,0,0
2024-11-19 19:30,107,55,52,0,0,0
2024-11-19 19:45,136,70,66,0,0,0
2024-11-19 20:00,107,60,47,0,0,0
2024-11-19 20:15,90,51,39,0,0,0
2024-11-19 20:30,75,36,39,0,0,0
2024-11-19 20:45,61,39,22,0,0,0
2024-11-19 21:00,64,31,33,0,0,0
2024-11-19 21:15,67,36,31,0,0,0
2024-11-19 21:30,60,27,33,0,0,0
2024-11-19 21:45,57,27,30,0,0,0
2024-11-19 22:00,61,31,30,0,0,0
2024-11-19 22:15,51,33,18,0,0,0
2024-11-19 22:30,55,30,25,0,0,0
2024-11-19 22:45,58,28,30,0,0,0
2024-11-19 23:00,27,11,16,0,0,0
2024-11-19 23:15,32,16,16,0,0,0
2024-11-19 23:30,19,11,8,0,0,0
2024-11-19 23:45,12,9,3,0,0,0
