Datetime,100020113 (Wolbecker Straße),101020113 (FR stdteinwärts),102020113 (FR stadtauswärts),100020113-status,101020113-status,102020113-status
2024-04-01 00:00,11,4,7,0,0,0
2024-04-01 00:15,13,6,7,0,0,0
2024-04-01 00:30,8,4,4,0,0,0
2024-04-01 00:45,11,8,3,0,0,0
2024-04-01 01:00,1,0,1,0,0,0
2024-04-01 01:15,5,2,3,0,0,0
2024-04-01 01:30,3,1,2,0,0,0
2024-04-01 01:45,6,3,3,0,0,0
2024-04-01 02:00,6,6,0,0,0,0
2024-04-01 02:15,4,2,2,0,0,0
2024-04-01 02:30,4,2,2,0,0,0
2024-04-01 02:45,4,3,1,0,0,0
2024-04-01 03:00,4,1,3,0,0,0
2024-04-01 03:15,4,0,4,0,0,0
2024-04-01 03:30,2,2,0,0,0,0
2024-04-01 03:45,4,2,2,0,0,0
2024-04-01 04:00,3,1,2,0,0,0
2024-04-01 04:15,4,1,3,0,0,0
2024-04-01 04:30,2,1,1,0,0,0
2024-04-01 04:45,1,0,1,0,0,0
2024-04-01 05:00,1,0,1,0,0,0
2024-04-01 05:15,2,1,1,0,0,0
2024-04-01 05:30,5,1,4,0,0,0
2024-04-01 05:45,9,3,6,0,0,0
2024-04-01 06:00,2,0,2,0,0,0
2024-04-01 06:15,5,0,5,0,0,0
2024-04-01 06:30,7,2,5,0,0,0
2024-04-01 06:45,4,2,2,0,0,0
2024-04-01 07:00,3,1,2,0,0,0
2024-04-01 07:15,5,3,2,0,0,0
2024-04-01 07:30,2,0,2,0,0,0
2024-04-01 07:45,5,3,2,0,0,0
2024-04-01 08:00,2,0,2,0,0,0
2024-04-01 08:15,5,1,4,0,0,0
2024-04-01 08:30,7,1,6,0,0,0
2024-04-01 08:45,8,3,5,0,0,0
2024-04-01 09:00,5,2,3,0,0,0
2024-04-01 09:15,9,4,5,0,0,0
2024-04-01 09:30,13,6,7,0,0,0
2024-04-01 09:45,16,3,13,0,0,0
2024-04-01 10:00,12,7,5,0,0,0
2024-04-01 10:15,13,7,6,0,0,0
2024-04-01 10:30,10,4,6,0,0,0
2024-04-01 10:45,14,6,8,0,0,0
2024-04-01 11:00,7,2,5,0,0,0
2024-04-01 11:15,22,8,14,0,0,0
2024-04-01 11:30,21,9,12,0,0,0
2024-04-01 11:45,19,8,11,0,0,0
2024-04-01 12:00,12,7,5,0,0,0
2024-04-01 12:15,25,14,11,0,0,0
2024-04-01 12:30,32,16,16,0,0,0
2024-04-01 12:45,17,7,10,0,0,0
2024-04-01 13:00,32,22,10,0,0,0
2024-04-01 13:15,21,13,8,0,0,0
2024-04-01 13:30,33,14,19,0,0,0
2024-04-01 13:45,28,11,17,0,0,0
2024-04-01 14:00,29,16,13,0,0,0
2024-04-01 14:15,23,8,15,0,0,0
2024-04-01 14:30,32,16,16,0,0,0
2024-04-01 14:45,33,14,19,0,0,0
2024-04-01 15:00,26,16,10,0,0,0
2024-04-01 15:15,27,10,17,0,0,0
2024-04-01 15:30,26,10,16,0,0,0
2024-04-01 15:45,29,12,17,0,0,0
2024-04-01 16:00,35,25,10,0,0,0
2024-04-01 16:15,43,19,24,0,0,0
2024-04-01 16:30,24,9,15,0,0,0
2024-04-01 16:45,48,23,25,0,0,0
2024-04-01 17:00,47,16,31,0,0,0
2024-04-01 17:15,34,17,17,0,0,0
2024-04-01 17:30,44,20,24,0,0,0
2024-04-01 17:45,56,29,27,0,0,0
2024-04-01 18:00,41,19,22,0,0,0
2024-04-01 18:15,45,24,21,0,0,0
2024-04-01 18:30,42,22,20,0,0,0
2024-04-01 18:45,53,19,34,0,0,0
2024-04-01 19:00,41,18,23,0,0,0
2024-04-01 19:15,39,18,21,0,0,0
2024-04-01 19:30,65,33,32,0,0,0
2024-04-01 19:45,41,24,17,0,0,0
2024-04-01 20:00,42,18,24,0,0,0
2024-04-01 20:15,35,17,18,0,0,0
2024-04-01 20:30,29,13,16,0,0,0
2024-04-01 20:45,29,16,13,0,0,0
2024-04-01 21:00,34,12,22,0,0,0
2024-04-01 21:15,30,12,18,0,0,0
2024-04-01 21:30,24,13,11,0,0,0
2024-04-01 21:45,30,11,19,0,0,0
2024-04-01 22:00,34,8,26,0,0,0
2024-04-01 22:15,24,9,15,0,0,0
2024-04-01 22:30,21,12,9,0,0,0
2024-04-01 22:45,13,5,8,0,0,0
2024-04-01 23:00,21,10,11,0,0,0
2024-04-01 23:15,16,9,7,0,0,0
2024-04-01 23:30,9,7,2,0,0,0
2024-04-01 23:45,7,3,4,0,0,0
2024-04-02 00:00,7,4,3,0,0,0
2024-04-02 00:15,3,0,3,0,0,0
2024-04-02 00:30,0,0,0,0,0,0
2024-04-02 00:45,5,1,4,0,0,0
2024-04-02 01:00,5,3,2,0,0,0
2024-04-02 01:15,1,1,0,0,0,0
2024-04-02 01:30,5,4,1,0,0,0
2024-04-02 01:45,1,0,1,0,0,0
2024-04-02 02:00,1,1,0,0,0,0
2024-04-02 02:15,0,0,0,0,0,0
2024-04-02 02:30,1,0,1,0,0,0
2024-04-02 02:45,3,2,1,0,0,0
2024-04-02 03:00,1,0,1,0,0,0
2024-04-02 03:15,1,1,0,0,0,0
2024-04-02 03:30,3,2,1,0,0,0
2024-04-02 03:45,2,1,1,0,0,0
2024-04-02 04:00,1,1,0,0,0,0
2024-04-02 04:15,2,0,2,0,0,0
2024-04-02 04:30,1,1,0,0,0,0
2024-04-02 04:45,8,4,4,0,0,0
2024-04-02 05:00,4,3,1,0,0,0
2024-04-02 05:15,8,4,4,0,0,0
2024-04-02 05:30,20,7,13,0,0,0
2024-04-02 05:45,18,5,13,0,0,0
2024-04-02 06:00,16,4,12,0,0,0
2024-04-02 06:15,38,15,23,0,0,0
2024-04-02 06:30,55,18,37,0,0,0
2024-04-02 06:45,65,28,37,0,0,0
2024-04-02 07:00,74,25,49,0,0,0
2024-04-02 07:15,79,29,50,0,0,0
2024-04-02 07:30,132,40,92,0,0,0
2024-04-02 07:45,170,48,122,0,0,0
2024-04-02 08:00,130,32,98,0,0,0
2024-04-02 08:15,155,56,99,0,0,0
2024-04-02 08:30,127,30,97,0,0,0
2024-04-02 08:45,144,53,91,0,0,0
2024-04-02 09:00,95,43,52,0,0,0
2024-04-02 09:15,113,22,91,0,0,0
2024-04-02 09:30,89,32,57,0,0,0
2024-04-02 09:45,107,35,72,0,0,0
2024-04-02 10:00,102,44,58,0,0,0
2024-04-02 10:15,85,35,50,0,0,0
2024-04-02 10:30,86,33,53,0,0,0
2024-04-02 10:45,87,31,56,0,0,0
2024-04-02 11:00,96,34,62,0,0,0
2024-04-02 11:15,104,44,60,0,0,0
2024-04-02 11:30,117,45,72,0,0,0
2024-04-02 11:45,114,39,75,0,0,0
2024-04-02 12:00,103,48,55,0,0,0
2024-04-02 12:15,125,63,62,0,0,0
2024-04-02 12:30,97,39,58,0,0,0
2024-04-02 12:45,124,55,69,0,0,0
2024-04-02 13:00,118,60,58,0,0,0
2024-04-02 13:15,135,62,73,0,0,0
2024-04-02 13:30,107,59,48,0,0,0
2024-04-02 13:45,110,44,66,0,0,0
2024-04-02 14:00,125,66,59,0,0,0
2024-04-02 14:15,108,56,52,0,0,0
2024-04-02 14:30,123,52,71,0,0,0
2024-04-02 14:45,99,50,49,0,0,0
2024-04-02 15:00,106,63,43,0,0,0
2024-04-02 15:15,94,49,45,0,0,0
2024-04-02 15:30,119,63,56,0,0,0
2024-04-02 15:45,138,86,52,0,0,0
2024-04-02 16:00,164,93,71,0,0,0
2024-04-02 16:15,140,81,59,0,0,0
2024-04-02 16:30,162,83,79,0,0,0
2024-04-02 16:45,189,116,73,0,0,0
2024-04-02 17:00,147,79,68,0,0,0
2024-04-02 17:15,130,75,55,0,0,0
2024-04-02 17:30,153,75,78,0,0,0
2024-04-02 17:45,187,91,96,0,0,0
2024-04-02 18:00,173,105,68,0,0,0
2024-04-02 18:15,143,81,62,0,0,0
2024-04-02 18:30,110,57,53,0,0,0
2024-04-02 18:45,111,61,50,0,0,0
2024-04-02 19:00,106,65,41,0,0,0
2024-04-02 19:15,102,59,43,0,0,0
2024-04-02 19:30,102,53,49,0,0,0
2024-04-02 19:45,91,52,39,0,0,0
2024-04-02 20:00,91,46,45,0,0,0
2024-04-02 20:15,75,36,39,0,0,0
2024-04-02 20:30,72,37,35,0,0,0
2024-04-02 20:45,58,27,31,0,0,0
2024-04-02 21:00,47,20,27,0,0,0
2024-04-02 21:15,47,29,18,0,0,0
2024-04-02 21:30,43,24,19,0,0,0
2024-04-02 21:45,40,20,20,0,0,0
2024-04-02 22:00,31,18,13,0,0,0
2024-04-02 22:15,46,28,18,0,0,0
2024-04-02 22:30,44,27,17,0,0,0
2024-04-02 22:45,46,26,20,0,0,0
2024-04-02 23:00,41,19,22,0,0,0
2024-04-02 23:15,24,12,12,0,0,0
2024-04-02 23:30,24,19,5,0,0,0
2024-04-02 23:45,31,21,10,0,0,0
2024-04-03 00:00,13,3,10,0,0,0
2024-04-03 00:15,16,3,13,0,0,0
2024-04-03 00:30,16,10,6,0,0,0
2024-04-03 00:45,14,8,6,0,0,0
2024-04-03 01:00,3,2,1,0,0,0
2024-04-03 01:15,8,3,5,0,0,0
2024-04-03 01:30,10,1,9,0,0,0
2024-04-03 01:45,3,1,2,0,0,0
2024-04-03 02:00,5,1,4,0,0,0
2024-04-03 02:15,5,1,4,0,0,0
2024-04-03 02:30,7,1,6,0,0,0
2024-04-03 02:45,5,1,4,0,0,0
2024-04-03 03:00,4,2,2,0,0,0
2024-04-03 03:15,4,0,4,0,0,0
2024-04-03 03:30,7,0,7,0,0,0
2024-04-03 03:45,4,0,4,0,0,0
2024-04-03 04:00,7,3,4,0,0,0
2024-04-03 04:15,10,0,10,0,0,0
2024-04-03 04:30,6,2,4,0,0,0
2024-04-03 04:45,6,4,2,0,0,0
2024-04-03 05:00,3,3,0,0,0,0
2024-04-03 05:15,11,6,5,0,0,0
2024-04-03 05:30,16,5,11,0,0,0
2024-04-03 05:45,19,3,16,0,0,0
2024-04-03 06:00,11,1,10,0,0,0
2024-04-03 06:15,32,14,18,0,0,0
2024-04-03 06:30,46,13,33,0,0,0
2024-04-03 06:45,67,26,41,0,0,0
2024-04-03 07:00,60,19,41,0,0,0
2024-04-03 07:15,79,29,50,0,0,0
2024-04-03 07:30,111,34,77,0,0,0
2024-04-03 07:45,163,60,103,0,0,0
2024-04-03 08:00,145,53,92,0,0,0
2024-04-03 08:15,116,33,83,0,0,0
2024-04-03 08:30,148,45,103,0,0,0
2024-04-03 08:45,157,47,110,0,0,0
2024-04-03 09:00,92,35,57,0,0,0
2024-04-03 09:15,118,23,95,0,0,0
2024-04-03 09:30,91,23,68,0,0,0
2024-04-03 09:45,126,51,75,0,0,0
2024-04-03 10:00,84,34,50,0,0,0
2024-04-03 10:15,116,32,84,0,0,0
2024-04-03 10:30,87,37,50,0,0,0
2024-04-03 10:45,116,44,72,0,0,0
2024-04-03 11:00,101,39,62,0,0,0
2024-04-03 11:15,89,29,60,0,0,0
2024-04-03 11:30,110,37,73,0,0,0
2024-04-03 11:45,98,43,55,0,0,0
2024-04-03 12:00,96,45,51,0,0,0
2024-04-03 12:15,106,38,68,0,0,0
2024-04-03 12:30,108,62,46,0,0,0
2024-04-03 12:45,115,50,65,0,0,0
2024-04-03 13:00,115,62,53,0,0,0
2024-04-03 13:15,132,66,66,0,0,0
2024-04-03 13:30,94,51,43,0,0,0
2024-04-03 13:45,94,41,53,0,0,0
2024-04-03 14:00,101,52,49,0,0,0
2024-04-03 14:15,137,66,71,0,0,0
2024-04-03 14:30,111,66,45,0,0,0
2024-04-03 14:45,129,74,55,0,0,0
2024-04-03 15:00,114,64,50,0,0,0
2024-04-03 15:15,109,58,51,0,0,0
2024-04-03 15:30,120,65,55,0,0,0
2024-04-03 15:45,168,79,89,0,0,0
2024-04-03 16:00,159,99,60,0,0,0
2024-04-03 16:15,160,87,73,0,0,0
2024-04-03 16:30,145,81,64,0,0,0
2024-04-03 16:45,183,101,82,0,0,0
2024-04-03 17:00,175,102,73,0,0,0
2024-04-03 17:15,183,104,79,0,0,0
2024-04-03 17:30,204,118,86,0,0,0
2024-04-03 17:45,175,103,72,0,0,0
2024-04-03 18:00,166,106,60,0,0,0
2024-04-03 18:15,152,85,67,0,0,0
2024-04-03 18:30,149,83,66,0,0,0
2024-04-03 18:45,159,95,64,0,0,0
2024-04-03 19:00,123,68,55,0,0,0
2024-04-03 19:15,142,80,62,0,0,0
2024-04-03 19:30,115,59,56,0,0,0
2024-04-03 19:45,84,47,37,0,0,0
2024-04-03 20:00,93,44,49,0,0,0
2024-04-03 20:15,93,52,41,0,0,0
2024-04-03 20:30,60,30,30,0,0,0
2024-04-03 20:45,63,33,30,0,0,0
2024-04-03 21:00,57,21,36,0,0,0
2024-04-03 21:15,65,36,29,0,0,0
2024-04-03 21:30,49,19,30,0,0,0
2024-04-03 21:45,60,30,30,0,0,0
2024-04-03 22:00,55,34,21,0,0,0
2024-04-03 22:15,46,22,24,0,0,0
2024-04-03 22:30,47,20,27,0,0,0
2024-04-03 22:45,70,25,45,0,0,0
2024-04-03 23:00,91,16,75,0,0,0
2024-04-03 23:15,68,15,53,0,0,0
2024-04-03 23:30,42,8,34,0,0,0
2024-04-03 23:45,37,15,22,0,0,0
2024-04-04 00:00,32,20,12,0,0,0
2024-04-04 00:15,27,10,17,0,0,0
2024-04-04 00:30,15,8,7,0,0,0
2024-04-04 00:45,18,10,8,0,0,0
2024-04-04 01:00,20,11,9,0,0,0
2024-04-04 01:15,10,7,3,0,0,0
2024-04-04 01:30,5,2,3,0,0,0
2024-04-04 01:45,16,10,6,0,0,0
2024-04-04 02:00,3,2,1,0,0,0
2024-04-04 02:15,13,7,6,0,0,0
2024-04-04 02:30,10,6,4,0,0,0
2024-04-04 02:45,10,5,5,0,0,0
2024-04-04 03:00,8,3,5,0,0,0
2024-04-04 03:15,8,3,5,0,0,0
2024-04-04 03:30,4,2,2,0,0,0
2024-04-04 03:45,13,3,10,0,0,0
2024-04-04 04:00,4,4,0,0,0,0
2024-04-04 04:15,5,1,4,0,0,0
2024-04-04 04:30,3,1,2,0,0,0
2024-04-04 04:45,6,4,2,0,0,0
2024-04-04 05:00,5,4,1,0,0,0
2024-04-04 05:15,16,10,6,0,0,0
2024-04-04 05:30,21,7,14,0,0,0
2024-04-04 05:45,15,5,10,0,0,0
2024-04-04 06:00,7,1,6,0,0,0
2024-04-04 06:15,33,13,20,0,0,0
2024-04-04 06:30,37,11,26,0,0,0
2024-04-04 06:45,55,20,35,0,0,0
2024-04-04 07:00,58,23,35,0,0,0
2024-04-04 07:15,66,23,43,0,0,0
2024-04-04 07:30,109,33,76,0,0,0
2024-04-04 07:45,149,42,107,0,0,0
2024-04-04 08:00,118,43,75,0,0,0
2024-04-04 08:15,119,43,76,0,0,0
2024-04-04 08:30,116,30,86,0,0,0
2024-04-04 08:45,115,30,85,0,0,0
2024-04-04 09:00,75,28,47,0,0,0
2024-04-04 09:15,69,22,47,0,0,0
2024-04-04 09:30,74,22,52,0,0,0
2024-04-04 09:45,88,16,72,0,0,0
2024-04-04 10:00,54,24,30,0,0,0
2024-04-04 10:15,74,33,41,0,0,0
2024-04-04 10:30,60,32,28,0,0,0
2024-04-04 10:45,62,20,42,0,0,0
2024-04-04 11:00,52,27,25,0,0,0
2024-04-04 11:15,47,16,31,0,0,0
2024-04-04 11:30,75,29,46,0,0,0
2024-04-04 11:45,76,35,41,0,0,0
2024-04-04 12:00,76,38,38,0,0,0
2024-04-04 12:15,91,36,55,0,0,0
2024-04-04 12:30,95,44,51,0,0,0
2024-04-04 12:45,118,47,71,0,0,0
2024-04-04 13:00,99,56,43,0,0,0
2024-04-04 13:15,94,41,53,0,0,0
2024-04-04 13:30,105,57,48,0,0,0
2024-04-04 13:45,125,49,76,0,0,0
2024-04-04 14:00,121,59,62,0,0,0
2024-04-04 14:15,99,50,49,0,0,0
2024-04-04 14:30,106,52,54,0,0,0
2024-04-04 14:45,125,51,74,0,0,0
2024-04-04 15:00,109,45,64,0,0,0
2024-04-04 15:15,119,57,62,0,0,0
2024-04-04 15:30,144,69,75,0,0,0
2024-04-04 15:45,155,68,87,0,0,0
2024-04-04 16:00,179,97,82,0,0,0
2024-04-04 16:15,85,57,28,0,0,0
2024-04-04 16:30,125,64,61,0,0,0
2024-04-04 16:45,152,84,68,0,0,0
2024-04-04 17:00,129,66,63,0,0,0
2024-04-04 17:15,154,74,80,0,0,0
2024-04-04 17:30,151,88,63,0,0,0
2024-04-04 17:45,174,90,84,0,0,0
2024-04-04 18:00,155,89,66,0,0,0
2024-04-04 18:15,143,85,58,0,0,0
2024-04-04 18:30,111,51,60,0,0,0
2024-04-04 18:45,150,79,71,0,0,0
2024-04-04 19:00,144,81,63,0,0,0
2024-04-04 19:15,117,67,50,0,0,0
2024-04-04 19:30,89,50,39,0,0,0
2024-04-04 19:45,112,67,45,0,0,0
2024-04-04 20:00,102,57,45,0,0,0
2024-04-04 20:15,65,37,28,0,0,0
2024-04-04 20:30,60,37,23,0,0,0
2024-04-04 20:45,73,41,32,0,0,0
2024-04-04 21:00,55,24,31,0,0,0
2024-04-04 21:15,59,23,36,0,0,0
2024-04-04 21:30,59,31,28,0,0,0
2024-04-04 21:45,45,24,21,0,0,0
2024-04-04 22:00,51,28,23,0,0,0
2024-04-04 22:15,56,30,26,0,0,0
2024-04-04 22:30,49,22,27,0,0,0
2024-04-04 22:45,53,27,26,0,0,0
2024-04-04 23:00,51,24,27,0,0,0
2024-04-04 23:15,29,15,14,0,0,0
2024-04-04 23:30,36,15,21,0,0,0
2024-04-04 23:45,24,11,13,0,0,0
2024-04-05 00:00,22,10,12,0,0,0
2024-04-05 00:15,24,14,10,0,0,0
2024-04-05 00:30,14,5,9,0,0,0
2024-04-05 00:45,14,7,7,0,0,0
2024-04-05 01:00,16,11,5,0,0,0
2024-04-05 01:15,8,6,2,0,0,0
2024-04-05 01:30,5,4,1,0,0,0
2024-04-05 01:45,3,0,3,0,0,0
2024-04-05 02:00,4,2,2,0,0,0
2024-04-05 02:15,1,1,0,0,0,0
2024-04-05 02:30,1,0,1,0,0,0
2024-04-05 02:45,1,0,1,0,0,0
2024-04-05 03:00,3,3,0,0,0,0
2024-04-05 03:15,4,2,2,0,0,0
2024-04-05 03:30,3,2,1,0,0,0
2024-04-05 03:45,2,0,2,0,0,0
2024-04-05 04:00,0,0,0,0,0,0
2024-04-05 04:15,3,1,2,0,0,0
2024-04-05 04:30,4,1,3,0,0,0
2024-04-05 04:45,5,4,1,0,0,0
2024-04-05 05:00,3,3,0,0,0,0
2024-04-05 05:15,14,6,8,0,0,0
2024-04-05 05:30,16,6,10,0,0,0
2024-04-05 05:45,19,7,12,0,0,0
2024-04-05 06:00,9,1,8,0,0,0
2024-04-05 06:15,32,14,18,0,0,0
2024-04-05 06:30,47,21,26,0,0,0
2024-04-05 06:45,58,23,35,0,0,0
2024-04-05 07:00,58,17,41,0,0,0
2024-04-05 07:15,81,30,51,0,0,0
2024-04-05 07:30,110,28,82,0,0,0
2024-04-05 07:45,150,49,101,0,0,0
2024-04-05 08:00,99,25,74,0,0,0
2024-04-05 08:15,141,61,80,0,0,0
2024-04-05 08:30,109,35,74,0,0,0
2024-04-05 08:45,123,42,81,0,0,0
2024-04-05 09:00,95,34,61,0,0,0
2024-04-05 09:15,99,27,72,0,0,0
2024-04-05 09:30,114,30,84,0,0,0
2024-04-05 09:45,129,43,86,0,0,0
2024-04-05 10:00,101,33,68,0,0,0
2024-04-05 10:15,114,34,80,0,0,0
2024-04-05 10:30,124,41,83,0,0,0
2024-04-05 10:45,130,40,90,0,0,0
2024-04-05 11:00,122,48,74,0,0,0
2024-04-05 11:15,90,41,49,0,0,0
2024-04-05 11:30,139,55,84,0,0,0
2024-04-05 11:45,117,58,59,0,0,0
2024-04-05 12:00,146,73,73,0,0,0
2024-04-05 12:15,131,61,70,0,0,0
2024-04-05 12:30,121,63,58,0,0,0
2024-04-05 12:45,117,64,53,0,0,0
2024-04-05 13:00,129,64,65,0,0,0
2024-04-05 13:15,146,88,58,0,0,0
2024-04-05 13:30,110,52,58,0,0,0
2024-04-05 13:45,160,80,80,0,0,0
2024-04-05 14:00,130,68,62,0,0,0
2024-04-05 14:15,130,69,61,0,0,0
2024-04-05 14:30,161,84,77,0,0,0
2024-04-05 14:45,171,78,93,0,0,0
2024-04-05 15:00,141,79,62,0,0,0
2024-04-05 15:15,143,68,75,0,0,0
2024-04-05 15:30,120,61,59,0,0,0
2024-04-05 15:45,156,75,81,0,0,0
2024-04-05 16:00,112,66,46,0,0,0
2024-04-05 16:15,129,67,62,0,0,0
2024-04-05 16:30,140,70,70,0,0,0
2024-04-05 16:45,196,102,94,0,0,0
2024-04-05 17:00,149,67,82,0,0,0
2024-04-05 17:15,154,71,83,0,0,0
2024-04-05 17:30,171,92,79,0,0,0
2024-04-05 17:45,174,95,79,0,0,0
2024-04-05 18:00,144,88,56,0,0,0
2024-04-05 18:15,170,89,81,0,0,0
2024-04-05 18:30,171,99,72,0,0,0
2024-04-05 18:45,208,109,99,0,0,0
2024-04-05 19:00,159,87,72,0,0,0
2024-04-05 19:15,172,96,76,0,0,0
2024-04-05 19:30,138,71,67,0,0,0
2024-04-05 19:45,146,77,69,0,0,0
2024-04-05 20:00,117,68,49,0,0,0
2024-04-05 20:15,137,70,67,0,0,0
2024-04-05 20:30,80,33,47,0,0,0
2024-04-05 20:45,77,43,34,0,0,0
2024-04-05 21:00,83,49,34,0,0,0
2024-04-05 21:15,63,36,27,0,0,0
2024-04-05 21:30,83,50,33,0,0,0
2024-04-05 21:45,57,41,16,0,0,0
2024-04-05 22:00,77,39,38,0,0,0
2024-04-05 22:15,90,40,50,0,0,0
2024-04-05 22:30,88,52,36,0,0,0
2024-04-05 22:45,70,37,33,0,0,0
2024-04-05 23:00,64,38,26,0,0,0
2024-04-05 23:15,55,32,23,0,0,0
2024-04-05 23:30,49,19,30,0,0,0
2024-04-05 23:45,37,10,27,0,0,0
2024-04-06 00:00,54,39,15,0,0,0
2024-04-06 00:15,44,21,23,0,0,0
2024-04-06 00:30,43,19,24,0,0,0
2024-04-06 00:45,57,34,23,0,0,0
2024-04-06 01:00,44,28,16,0,0,0
2024-04-06 01:15,39,20,19,0,0,0
2024-04-06 01:30,31,19,12,0,0,0
2024-04-06 01:45,25,15,10,0,0,0
2024-04-06 02:00,12,6,6,0,0,0
2024-04-06 02:15,18,7,11,0,0,0
2024-04-06 02:30,21,7,14,0,0,0
2024-04-06 02:45,24,12,12,0,0,0
2024-04-06 03:00,16,9,7,0,0,0
2024-04-06 03:15,12,4,8,0,0,0
2024-04-06 03:30,13,5,8,0,0,0
2024-04-06 03:45,7,3,4,0,0,0
2024-04-06 04:00,14,6,8,0,0,0
2024-04-06 04:15,8,5,3,0,0,0
2024-04-06 04:30,9,1,8,0,0,0
2024-04-06 04:45,5,2,3,0,0,0
2024-04-06 05:00,2,1,1,0,0,0
2024-04-06 05:15,12,7,5,0,0,0
2024-04-06 05:30,8,2,6,0,0,0
2024-04-06 05:45,20,5,15,0,0,0
2024-04-06 06:00,12,3,9,0,0,0
2024-04-06 06:15,11,4,7,0,0,0
2024-04-06 06:30,13,2,11,0,0,0
2024-04-06 06:45,15,4,11,0,0,0
2024-04-06 07:00,13,6,7,0,0,0
2024-04-06 07:15,19,8,11,0,0,0
2024-04-06 07:30,22,5,17,0,0,0
2024-04-06 07:45,35,16,19,0,0,0
2024-04-06 08:00,33,10,23,0,0,0
2024-04-06 08:15,49,14,35,0,0,0
2024-04-06 08:30,52,19,33,0,0,0
2024-04-06 08:45,80,27,53,0,0,0
2024-04-06 09:00,86,32,54,0,0,0
2024-04-06 09:15,82,18,64,0,0,0
2024-04-06 09:30,131,47,84,0,0,0
2024-04-06 09:45,146,40,106,0,0,0
2024-04-06 10:00,161,34,127,0,0,0
2024-04-06 10:15,181,49,132,0,0,0
2024-04-06 10:30,186,65,121,0,0,0
2024-04-06 10:45,196,50,146,0,0,0
2024-04-06 11:00,198,76,122,0,0,0
2024-04-06 11:15,165,64,101,0,0,0
2024-04-06 11:30,196,58,138,0,0,0
2024-04-06 11:45,225,97,128,0,0,0
2024-04-06 12:00,222,92,130,0,0,0
2024-04-06 12:15,223,86,137,0,0,0
2024-04-06 12:30,207,95,112,0,0,0
2024-04-06 12:45,228,100,128,0,0,0
2024-04-06 13:00,210,99,111,0,0,0
2024-04-06 13:15,207,94,113,0,0,0
2024-04-06 13:30,213,125,88,0,0,0
2024-04-06 13:45,207,90,117,0,0,0
2024-04-06 14:00,194,108,86,0,0,0
2024-04-06 14:15,181,98,83,0,0,0
2024-04-06 14:30,209,133,76,0,0,0
2024-04-06 14:45,208,113,95,0,0,0
2024-04-06 15:00,178,102,76,0,0,0
2024-04-06 15:15,191,123,68,0,0,0
2024-04-06 15:30,202,91,111,0,0,0
2024-04-06 15:45,198,85,113,0,0,0
2024-04-06 16:00,190,101,89,0,0,0
2024-04-06 16:15,156,83,73,0,0,0
2024-04-06 16:30,170,87,83,0,0,0
2024-04-06 16:45,177,78,99,0,0,0
2024-04-06 17:00,210,102,108,0,0,0
2024-04-06 17:15,152,78,74,0,0,0
2024-04-06 17:30,202,100,102,0,0,0
2024-04-06 17:45,184,94,90,0,0,0
2024-04-06 18:00,193,108,85,0,0,0
2024-04-06 18:15,151,73,78,0,0,0
2024-04-06 18:30,140,71,69,0,0,0
2024-04-06 18:45,169,81,88,0,0,0
2024-04-06 19:00,158,92,66,0,0,0
2024-04-06 19:15,141,65,76,0,0,0
2024-04-06 19:30,149,68,81,0,0,0
2024-04-06 19:45,122,79,43,0,0,0
2024-04-06 20:00,127,69,58,0,0,0
2024-04-06 20:15,120,66,54,0,0,0
2024-04-06 20:30,101,49,52,0,0,0
2024-04-06 20:45,106,59,47,0,0,0
2024-04-06 21:00,103,52,51,0,0,0
2024-04-06 21:15,95,58,37,0,0,0
2024-04-06 21:30,91,46,45,0,0,0
2024-04-06 21:45,67,36,31,0,0,0
2024-04-06 22:00,75,42,33,0,0,0
2024-04-06 22:15,80,49,31,0,0,0
2024-04-06 22:30,69,34,35,0,0,0
2024-04-06 22:45,69,33,36,0,0,0
2024-04-06 23:00,46,22,24,0,0,0
2024-04-06 23:15,67,37,30,0,0,0
2024-04-06 23:30,70,38,32,0,0,0
2024-04-06 23:45,89,49,40,0,0,0
2024-04-07 00:00,79,36,43,0,0,0
2024-04-07 00:15,60,25,35,0,0,0
2024-04-07 00:30,57,24,33,0,0,0
2024-04-07 00:45,33,15,18,0,0,0
2024-04-07 01:00,40,18,22,0,0,0
2024-04-07 01:15,36,21,15,0,0,0
2024-04-07 01:30,53,25,28,0,0,0
2024-04-07 01:45,36,14,22,0,0,0
2024-04-07 02:00,34,19,15,0,0,0
2024-04-07 02:15,38,21,17,0,0,0
2024-04-07 02:30,27,17,10,0,0,0
2024-04-07 02:45,21,12,9,0,0,0
2024-04-07 03:00,20,11,9,0,0,0
2024-04-07 03:15,20,12,8,0,0,0
2024-04-07 03:30,17,8,9,0,0,0
2024-04-07 03:45,13,5,8,0,0,0
2024-04-07 04:00,14,6,8,0,0,0
2024-04-07 04:15,10,1,9,0,0,0
2024-04-07 04:30,6,3,3,0,0,0
2024-04-07 04:45,8,2,6,0,0,0
2024-04-07 05:00,5,2,3,0,0,0
2024-04-07 05:15,6,3,3,0,0,0
2024-04-07 05:30,9,6,3,0,0,0
2024-04-07 05:45,8,1,7,0,0,0
2024-04-07 06:00,14,5,9,0,0,0
2024-04-07 06:15,5,2,3,0,0,0
2024-04-07 06:30,19,3,16,0,0,0
2024-04-07 06:45,11,6,5,0,0,0
2024-04-07 07:00,6,1,5,0,0,0
2024-04-07 07:15,11,4,7,0,0,0
2024-04-07 07:30,11,2,9,0,0,0
2024-04-07 07:45,11,7,4,0,0,0
2024-04-07 08:00,10,3,7,0,0,0
2024-04-07 08:15,15,6,9,0,0,0
2024-04-07 08:30,11,4,7,0,0,0
2024-04-07 08:45,23,11,12,0,0,0
2024-04-07 09:00,23,15,8,0,0,0
2024-04-07 09:15,28,11,17,0,0,0
2024-04-07 09:30,43,21,22,0,0,0
2024-04-07 09:45,55,24,31,0,0,0
2024-04-07 10:00,57,26,31,0,0,0
2024-04-07 10:15,63,32,31,0,0,0
2024-04-07 10:30,59,25,34,0,0,0
2024-04-07 10:45,87,39,48,0,0,0
2024-04-07 11:00,57,26,31,0,0,0
2024-04-07 11:15,66,30,36,0,0,0
2024-04-07 11:30,75,21,54,0,0,0
2024-04-07 11:45,89,36,53,0,0,0
2024-04-07 12:00,79,30,49,0,0,0
2024-04-07 12:15,94,36,58,0,0,0
2024-04-07 12:30,76,35,41,0,0,0
2024-04-07 12:45,127,57,70,0,0,0
2024-04-07 13:00,131,58,73,0,0,0
2024-04-07 13:15,90,38,52,0,0,0
2024-04-07 13:30,100,39,61,0,0,0
2024-04-07 13:45,125,45,80,0,0,0
2024-04-07 14:00,131,59,72,0,0,0
2024-04-07 14:15,130,45,85,0,0,0
2024-04-07 14:30,107,52,55,0,0,0
2024-04-07 14:45,147,64,83,0,0,0
2024-04-07 15:00,142,53,89,0,0,0
2024-04-07 15:15,121,56,65,0,0,0
2024-04-07 15:30,136,64,72,0,0,0
2024-04-07 15:45,171,67,104,0,0,0
2024-04-07 16:00,123,54,69,0,0,0
2024-04-07 16:15,124,59,65,0,0,0
2024-04-07 16:30,109,58,51,0,0,0
2024-04-07 16:45,145,90,55,0,0,0
2024-04-07 17:00,143,63,80,0,0,0
2024-04-07 17:15,137,74,63,0,0,0
2024-04-07 17:30,134,63,71,0,0,0
2024-04-07 17:45,108,50,58,0,0,0
2024-04-07 18:00,137,66,71,0,0,0
2024-04-07 18:15,119,57,62,0,0,0
2024-04-07 18:30,107,47,60,0,0,0
2024-04-07 18:45,108,59,49,0,0,0
2024-04-07 19:00,103,58,45,0,0,0
2024-04-07 19:15,100,46,54,0,0,0
2024-04-07 19:30,85,44,41,0,0,0
2024-04-07 19:45,91,46,45,0,0,0
2024-04-07 20:00,87,43,44,0,0,0
2024-04-07 20:15,95,49,46,0,0,0
2024-04-07 20:30,70,29,41,0,0,0
2024-04-07 20:45,46,25,21,0,0,0
2024-04-07 21:00,57,29,28,0,0,0
2024-04-07 21:15,36,17,19,0,0,0
2024-04-07 21:30,45,24,21,0,0,0
2024-04-07 21:45,51,26,25,0,0,0
2024-04-07 22:00,28,7,21,0,0,0
2024-04-07 22:15,20,9,11,0,0,0
2024-04-07 22:30,29,13,16,0,0,0
2024-04-07 22:45,17,8,9,0,0,0
2024-04-07 23:00,21,9,12,0,0,0
2024-04-07 23:15,17,8,9,0,0,0
2024-04-07 23:30,18,7,11,0,0,0
2024-04-07 23:45,7,4,3,0,0,0
2024-04-08 00:00,13,4,9,0,0,0
2024-04-08 00:15,6,4,2,0,0,0
2024-04-08 00:30,3,3,0,0,0,0
2024-04-08 00:45,2,2,0,0,0,0
2024-04-08 01:00,4,1,3,0,0,0
2024-04-08 01:15,0,0,0,0,0,0
2024-04-08 01:30,2,1,1,0,0,0
2024-04-08 01:45,1,1,0,0,0,0
2024-04-08 02:00,1,1,0,0,0,0
2024-04-08 02:15,4,3,1,0,0,0
2024-04-08 02:30,2,2,0,0,0,0
2024-04-08 02:45,1,0,1,0,0,0
2024-04-08 03:00,4,1,3,0,0,0
2024-04-08 03:15,1,1,0,0,0,0
2024-04-08 03:30,1,1,0,0,0,0
2024-04-08 03:45,4,1,3,0,0,0
2024-04-08 04:00,0,0,0,0,0,0
2024-04-08 04:15,2,1,1,0,0,0
2024-04-08 04:30,5,2,3,0,0,0
2024-04-08 04:45,6,3,3,0,0,0
2024-04-08 05:00,4,4,0,0,0,0
2024-04-08 05:15,12,6,6,0,0,0
2024-04-08 05:30,25,7,18,0,0,0
2024-04-08 05:45,18,6,12,0,0,0
2024-04-08 06:00,22,9,13,0,0,0
2024-04-08 06:15,40,17,23,0,0,0
2024-04-08 06:30,82,32,50,0,0,0
2024-04-08 06:45,98,34,64,0,0,0
2024-04-08 07:00,96,33,63,0,0,0
2024-04-08 07:15,180,62,118,0,0,0
2024-04-08 07:30,352,84,268,0,0,0
2024-04-08 07:45,318,92,226,0,0,0
2024-04-08 08:00,260,66,194,0,0,0
2024-04-08 08:15,222,70,152,0,0,0
2024-04-08 08:30,202,52,150,0,0,0
2024-04-08 08:45,202,64,138,0,0,0
2024-04-08 09:00,124,38,86,0,0,0
2024-04-08 09:15,125,45,80,0,0,0
2024-04-08 09:30,157,40,117,0,0,0
2024-04-08 09:45,219,59,160,0,0,0
2024-04-08 10:00,149,61,88,0,0,0
2024-04-08 10:15,118,42,76,0,0,0
2024-04-08 10:30,124,40,84,0,0,0
2024-04-08 10:45,152,61,91,0,0,0
2024-04-08 11:00,128,47,81,0,0,0
2024-04-08 11:15,144,56,88,0,0,0
2024-04-08 11:30,166,63,103,0,0,0
2024-04-08 11:45,175,66,109,0,0,0
2024-04-08 12:00,159,72,87,0,0,0
2024-04-08 12:15,151,69,82,0,0,0
2024-04-08 12:30,175,89,86,0,0,0
2024-04-08 12:45,146,60,86,0,0,0
2024-04-08 13:00,165,96,69,0,0,0
2024-04-08 13:15,184,106,78,0,0,0
2024-04-08 13:30,156,72,84,0,0,0
2024-04-08 13:45,220,98,122,0,0,0
2024-04-08 14:00,188,109,79,0,0,0
2024-04-08 14:15,192,90,102,0,0,0
2024-04-08 14:30,163,82,81,0,0,0
2024-04-08 14:45,200,109,91,0,0,0
2024-04-08 15:00,179,106,73,0,0,0
2024-04-08 15:15,207,103,104,0,0,0
2024-04-08 15:30,207,110,97,0,0,0
2024-04-08 15:45,262,137,125,0,0,0
2024-04-08 16:00,243,119,124,0,0,0
2024-04-08 16:15,246,137,109,0,0,0
2024-04-08 16:30,257,146,111,0,0,0
2024-04-08 16:45,301,166,135,0,0,0
2024-04-08 17:00,262,137,125,0,0,0
2024-04-08 17:15,249,153,96,0,0,0
2024-04-08 17:30,235,114,121,0,0,0
2024-04-08 17:45,282,144,138,0,0,0
2024-04-08 18:00,255,138,117,0,0,0
2024-04-08 18:15,229,137,92,0,0,0
2024-04-08 18:30,209,123,86,0,0,0
2024-04-08 18:45,178,107,71,0,0,0
2024-04-08 19:00,198,103,95,0,0,0
2024-04-08 19:15,191,102,89,0,0,0
2024-04-08 19:30,165,95,70,0,0,0
2024-04-08 19:45,139,71,68,0,0,0
2024-04-08 20:00,139,84,55,0,0,0
2024-04-08 20:15,117,56,61,0,0,0
2024-04-08 20:30,119,55,64,0,0,0
2024-04-08 20:45,100,57,43,0,0,0
2024-04-08 21:00,86,48,38,0,0,0
2024-04-08 21:15,82,44,38,0,0,0
2024-04-08 21:30,70,42,28,0,0,0
2024-04-08 21:45,68,33,35,0,0,0
2024-04-08 22:00,59,39,20,0,0,0
2024-04-08 22:15,68,42,26,0,0,0
2024-04-08 22:30,54,33,21,0,0,0
2024-04-08 22:45,54,23,31,0,0,0
2024-04-08 23:00,46,21,25,0,0,0
2024-04-08 23:15,33,22,11,0,0,0
2024-04-08 23:30,13,6,7,0,0,0
2024-04-08 23:45,25,11,14,0,0,0
2024-04-09 00:00,13,6,7,0,0,0
2024-04-09 00:15,14,6,8,0,0,0
2024-04-09 00:30,14,6,8,0,0,0
2024-04-09 00:45,10,3,7,0,0,0
2024-04-09 01:00,2,0,2,0,0,0
2024-04-09 01:15,10,5,5,0,0,0
2024-04-09 01:30,8,3,5,0,0,0
2024-04-09 01:45,4,2,2,0,0,0
2024-04-09 02:00,4,2,2,0,0,0
2024-04-09 02:15,0,0,0,0,0,0
2024-04-09 02:30,2,1,1,0,0,0
2024-04-09 02:45,2,2,0,0,0,0
2024-04-09 03:00,3,2,1,0,0,0
2024-04-09 03:15,1,1,0,0,0,0
2024-04-09 03:30,0,0,0,0,0,0
2024-04-09 03:45,5,1,4,0,0,0
2024-04-09 04:00,2,2,0,0,0,0
2024-04-09 04:15,3,2,1,0,0,0
2024-04-09 04:30,4,2,2,0,0,0
2024-04-09 04:45,4,2,2,0,0,0
2024-04-09 05:00,8,6,2,0,0,0
2024-04-09 05:15,14,9,5,0,0,0
2024-04-09 05:30,24,7,17,0,0,0
2024-04-09 05:45,29,9,20,0,0,0
2024-04-09 06:00,23,14,9,0,0,0
2024-04-09 06:15,52,24,28,0,0,0
2024-04-09 06:30,79,22,57,0,0,0
2024-04-09 06:45,73,28,45,0,0,0
2024-04-09 07:00,100,43,57,0,0,0
2024-04-09 07:15,166,42,124,0,0,0
2024-04-09 07:30,360,69,291,0,0,0
2024-04-09 07:45,346,95,251,0,0,0
2024-04-09 08:00,283,77,206,0,0,0
2024-04-09 08:15,176,59,117,0,0,0
2024-04-09 08:30,196,47,149,0,0,0
2024-04-09 08:45,205,53,152,0,0,0
2024-04-09 09:00,95,38,57,0,0,0
2024-04-09 09:15,99,37,62,0,0,0
2024-04-09 09:30,157,43,114,0,0,0
2024-04-09 09:45,205,64,141,0,0,0
2024-04-09 10:00,96,38,58,0,0,0
2024-04-09 10:15,72,34,38,0,0,0
2024-04-09 10:30,76,36,40,0,0,0
2024-04-09 10:45,78,35,43,0,0,0
2024-04-09 11:00,84,30,54,0,0,0
2024-04-09 11:15,87,37,50,0,0,0
2024-04-09 11:30,94,47,47,0,0,0
2024-04-09 11:45,145,66,79,0,0,0
2024-04-09 12:00,142,62,80,0,0,0
2024-04-09 12:15,114,55,59,0,0,0
2024-04-09 12:30,96,52,44,0,0,0
2024-04-09 12:45,112,52,60,0,0,0
2024-04-09 13:00,160,75,85,0,0,0
2024-04-09 13:15,162,84,78,0,0,0
2024-04-09 13:30,117,46,71,0,0,0
2024-04-09 13:45,176,91,85,0,0,0
2024-04-09 14:00,169,95,74,0,0,0
2024-04-09 14:15,178,100,78,0,0,0
2024-04-09 14:30,159,79,80,0,0,0
2024-04-09 14:45,187,92,95,0,0,0
2024-04-09 15:00,167,77,90,0,0,0
2024-04-09 15:15,170,84,86,0,0,0
2024-04-09 15:30,194,90,104,0,0,0
2024-04-09 15:45,236,131,105,0,0,0
2024-04-09 16:00,242,137,105,0,0,0
2024-04-09 16:15,213,129,84,0,0,0
2024-04-09 16:30,218,120,98,0,0,0
2024-04-09 16:45,235,120,115,0,0,0
2024-04-09 17:00,197,106,91,0,0,0
2024-04-09 17:15,241,132,109,0,0,0
2024-04-09 17:30,217,121,96,0,0,0
2024-04-09 17:45,293,176,117,0,0,0
2024-04-09 18:00,276,159,117,0,0,0
2024-04-09 18:15,237,137,100,0,0,0
2024-04-09 18:30,185,83,102,0,0,0
2024-04-09 18:45,222,99,123,0,0,0
2024-04-09 19:00,162,89,73,0,0,0
2024-04-09 19:15,147,66,81,0,0,0
2024-04-09 19:30,136,75,61,0,0,0
2024-04-09 19:45,162,95,67,0,0,0
2024-04-09 20:00,138,77,61,0,0,0
2024-04-09 20:15,121,78,43,0,0,0
2024-04-09 20:30,93,40,53,0,0,0
2024-04-09 20:45,84,47,37,0,0,0
2024-04-09 21:00,68,41,27,0,0,0
2024-04-09 21:15,78,36,42,0,0,0
2024-04-09 21:30,73,40,33,0,0,0
2024-04-09 21:45,54,30,24,0,0,0
2024-04-09 22:00,69,41,28,0,0,0
2024-04-09 22:15,79,47,32,0,0,0
2024-04-09 22:30,52,27,25,0,0,0
2024-04-09 22:45,36,20,16,0,0,0
2024-04-09 23:00,73,37,36,0,0,0
2024-04-09 23:15,52,31,21,0,0,0
2024-04-09 23:30,40,29,11,0,0,0
2024-04-09 23:45,23,14,9,0,0,0
2024-04-10 00:00,17,10,7,0,0,0
2024-04-10 00:15,18,8,10,0,0,0
2024-04-10 00:30,14,2,12,0,0,0
2024-04-10 00:45,8,5,3,0,0,0
2024-04-10 01:00,4,2,2,0,0,0
2024-04-10 01:15,5,2,3,0,0,0
2024-04-10 01:30,5,3,2,0,0,0
2024-04-10 01:45,6,1,5,0,0,0
2024-04-10 02:00,1,1,0,0,0,0
2024-04-10 02:15,0,0,0,0,0,0
2024-04-10 02:30,2,1,1,0,0,0
2024-04-10 02:45,1,1,0,0,0,0
2024-04-10 03:00,1,0,1,0,0,0
2024-04-10 03:15,3,2,1,0,0,0
2024-04-10 03:30,5,2,3,0,0,0
2024-04-10 03:45,2,0,2,0,0,0
2024-04-10 04:00,3,0,3,0,0,0
2024-04-10 04:15,4,2,2,0,0,0
2024-04-10 04:30,2,1,1,0,0,0
2024-04-10 04:45,5,3,2,0,0,0
2024-04-10 05:00,5,5,0,0,0,0
2024-04-10 05:15,16,10,6,0,0,0
2024-04-10 05:30,21,8,13,0,0,0
2024-04-10 05:45,27,6,21,0,0,0
2024-04-10 06:00,29,18,11,0,0,0
2024-04-10 06:15,55,18,37,0,0,0
2024-04-10 06:30,75,23,52,0,0,0
2024-04-10 06:45,77,34,43,0,0,0
2024-04-10 07:00,112,40,72,0,0,0
2024-04-10 07:15,198,63,135,0,0,0
2024-04-10 07:30,316,68,248,0,0,0
2024-04-10 07:45,335,92,243,0,0,0
2024-04-10 08:00,292,90,202,0,0,0
2024-04-10 08:15,239,70,169,0,0,0
2024-04-10 08:30,212,57,155,0,0,0
2024-04-10 08:45,229,62,167,0,0,0
2024-04-10 09:00,129,41,88,0,0,0
2024-04-10 09:15,139,48,91,0,0,0
2024-04-10 09:30,153,42,111,0,0,0
2024-04-10 09:45,256,57,199,0,0,0
2024-04-10 10:00,152,44,108,0,0,0
2024-04-10 10:15,152,53,99,0,0,0
2024-04-10 10:30,133,57,76,0,0,0
2024-04-10 10:45,188,60,128,0,0,0
2024-04-10 11:00,158,62,96,0,0,0
2024-04-10 11:15,143,60,83,0,0,0
2024-04-10 11:30,178,55,123,0,0,0
2024-04-10 11:45,215,88,127,0,0,0
2024-04-10 12:00,212,116,96,0,0,0
2024-04-10 12:15,195,98,97,0,0,0
2024-04-10 12:30,192,107,85,0,0,0
2024-04-10 12:45,184,88,96,0,0,0
2024-04-10 13:00,212,124,88,0,0,0
2024-04-10 13:15,188,102,86,0,0,0
2024-04-10 13:30,169,95,74,0,0,0
2024-04-10 13:45,230,122,108,0,0,0
2024-04-10 14:00,240,118,122,0,0,0
2024-04-10 14:15,158,89,69,0,0,0
2024-04-10 14:30,186,104,82,0,0,0
2024-04-10 14:45,200,110,90,0,0,0
2024-04-10 15:00,173,95,78,0,0,0
2024-04-10 15:15,188,96,92,0,0,0
2024-04-10 15:30,183,88,95,0,0,0
2024-04-10 15:45,262,117,145,0,0,0
2024-04-10 16:00,236,148,88,0,0,0
2024-04-10 16:15,246,148,98,0,0,0
2024-04-10 16:30,257,128,129,0,0,0
2024-04-10 16:45,223,124,99,0,0,0
2024-04-10 17:00,265,145,120,0,0,0
2024-04-10 17:15,259,135,124,0,0,0
2024-04-10 17:30,228,119,109,0,0,0
2024-04-10 17:45,271,145,126,0,0,0
2024-04-10 18:00,254,157,97,0,0,0
2024-04-10 18:15,268,158,110,0,0,0
2024-04-10 18:30,195,103,92,0,0,0
2024-04-10 18:45,244,134,110,0,0,0
2024-04-10 19:00,209,100,109,0,0,0
2024-04-10 19:15,208,110,98,0,0,0
2024-04-10 19:30,174,93,81,0,0,0
2024-04-10 19:45,187,104,83,0,0,0
2024-04-10 20:00,159,79,80,0,0,0
2024-04-10 20:15,158,85,73,0,0,0
2024-04-10 20:30,103,51,52,0,0,0
2024-04-10 20:45,134,84,50,0,0,0
2024-04-10 21:00,111,56,55,0,0,0
2024-04-10 21:15,110,67,43,0,0,0
2024-04-10 21:30,87,59,28,0,0,0
2024-04-10 21:45,97,53,44,0,0,0
2024-04-10 22:00,95,40,55,0,0,0
2024-04-10 22:15,100,60,40,0,0,0
2024-04-10 22:30,87,56,31,0,0,0
2024-04-10 22:45,42,26,16,0,0,0
2024-04-10 23:00,82,48,34,0,0,0
2024-04-10 23:15,43,26,17,0,0,0
2024-04-10 23:30,38,15,23,0,0,0
2024-04-10 23:45,27,19,8,0,0,0
2024-04-11 00:00,27,14,13,0,0,0
2024-04-11 00:15,54,22,32,0,0,0
2024-04-11 00:30,29,9,20,0,0,0
2024-04-11 00:45,27,13,14,0,0,0
2024-04-11 01:00,16,10,6,0,0,0
2024-04-11 01:15,21,11,10,0,0,0
2024-04-11 01:30,23,10,13,0,0,0
2024-04-11 01:45,9,6,3,0,0,0
2024-04-11 02:00,15,12,3,0,0,0
2024-04-11 02:15,9,7,2,0,0,0
2024-04-11 02:30,12,11,1,0,0,0
2024-04-11 02:45,4,4,0,0,0,0
2024-04-11 03:00,5,3,2,0,0,0
2024-04-11 03:15,18,9,9,0,0,0
2024-04-11 03:30,8,4,4,0,0,0
2024-04-11 03:45,12,5,7,0,0,0
2024-04-11 04:00,3,2,1,0,0,0
2024-04-11 04:15,7,6,1,0,0,0
2024-04-11 04:30,5,2,3,0,0,0
2024-04-11 04:45,12,4,8,0,0,0
2024-04-11 05:00,8,5,3,0,0,0
2024-04-11 05:15,12,8,4,0,0,0
2024-04-11 05:30,15,5,10,0,0,0
2024-04-11 05:45,27,12,15,0,0,0
2024-04-11 06:00,24,11,13,0,0,0
2024-04-11 06:15,48,16,32,0,0,0
2024-04-11 06:30,73,29,44,0,0,0
2024-04-11 06:45,89,36,53,0,0,0
2024-04-11 07:00,94,33,61,0,0,0
2024-04-11 07:15,180,48,132,0,0,0
2024-04-11 07:30,303,70,233,0,0,0
2024-04-11 07:45,331,92,239,0,0,0
2024-04-11 08:00,262,76,186,0,0,0
2024-04-11 08:15,229,67,162,0,0,0
2024-04-11 08:30,235,61,174,0,0,0
2024-04-11 08:45,190,62,128,0,0,0
2024-04-11 09:00,145,47,98,0,0,0
2024-04-11 09:15,150,58,92,0,0,0
2024-04-11 09:30,141,37,104,0,0,0
2024-04-11 09:45,209,40,169,0,0,0
2024-04-11 10:00,140,50,90,0,0,0
2024-04-11 10:15,94,39,55,0,0,0
2024-04-11 10:30,133,44,89,0,0,0
2024-04-11 10:45,139,49,90,0,0,0
2024-04-11 11:00,98,29,69,0,0,0
2024-04-11 11:15,130,54,76,0,0,0
2024-04-11 11:30,129,56,73,0,0,0
2024-04-11 11:45,190,82,108,0,0,0
2024-04-11 12:00,167,70,97,0,0,0
2024-04-11 12:15,138,59,79,0,0,0
2024-04-11 12:30,142,63,79,0,0,0
2024-04-11 12:45,159,90,69,0,0,0
2024-04-11 13:00,174,92,82,0,0,0
2024-04-11 13:15,137,84,53,0,0,0
2024-04-11 13:30,130,58,72,0,0,0
2024-04-11 13:45,205,102,103,0,0,0
2024-04-11 14:00,173,92,81,0,0,0
2024-04-11 14:15,157,98,59,0,0,0
2024-04-11 14:30,165,91,74,0,0,0
2024-04-11 14:45,202,101,101,0,0,0
2024-04-11 15:00,196,99,97,0,0,0
2024-04-11 15:15,193,112,81,0,0,0
2024-04-11 15:30,222,111,111,0,0,0
2024-04-11 15:45,260,132,128,0,0,0
2024-04-11 16:00,257,117,140,0,0,0
2024-04-11 16:15,227,134,93,0,0,0
2024-04-11 16:30,209,102,107,0,0,0
2024-04-11 16:45,282,158,124,0,0,0
2024-04-11 17:00,252,157,95,0,0,0
2024-04-11 17:15,263,141,122,0,0,0
2024-04-11 17:30,238,132,106,0,0,0
2024-04-11 17:45,260,146,114,0,0,0
2024-04-11 18:00,243,144,99,0,0,0
2024-04-11 18:15,230,136,94,0,0,0
2024-04-11 18:30,185,98,87,0,0,0
2024-04-11 18:45,222,129,93,0,0,0
2024-04-11 19:00,178,96,82,0,0,0
2024-04-11 19:15,169,86,83,0,0,0
2024-04-11 19:30,168,101,67,0,0,0
2024-04-11 19:45,175,83,92,0,0,0
2024-04-11 20:00,122,65,57,0,0,0
2024-04-11 20:15,123,81,42,0,0,0
2024-04-11 20:30,108,67,41,0,0,0
2024-04-11 20:45,87,54,33,0,0,0
2024-04-11 21:00,92,46,46,0,0,0
2024-04-11 21:15,96,67,29,0,0,0
2024-04-11 21:30,87,50,37,0,0,0
2024-04-11 21:45,68,38,30,0,0,0
2024-04-11 22:00,95,48,47,0,0,0
2024-04-11 22:15,82,44,38,0,0,0
2024-04-11 22:30,75,41,34,0,0,0
2024-04-11 22:45,63,40,23,0,0,0
2024-04-11 23:00,61,23,38,0,0,0
2024-04-11 23:15,53,29,24,0,0,0
2024-04-11 23:30,33,18,15,0,0,0
2024-04-11 23:45,33,16,17,0,0,0
2024-04-12 00:00,40,17,23,0,0,0
2024-04-12 00:15,12,4,8,0,0,0
2024-04-12 00:30,19,10,9,0,0,0
2024-04-12 00:45,12,6,6,0,0,0
2024-04-12 01:00,9,1,8,0,0,0
2024-04-12 01:15,7,5,2,0,0,0
2024-04-12 01:30,7,1,6,0,0,0
2024-04-12 01:45,3,3,0,0,0,0
2024-04-12 02:00,7,6,1,0,0,0
2024-04-12 02:15,4,0,4,0,0,0
2024-04-12 02:30,2,1,1,0,0,0
2024-04-12 02:45,1,1,0,0,0,0
2024-04-12 03:00,3,3,0,0,0,0
2024-04-12 03:15,3,2,1,0,0,0
2024-04-12 03:30,1,0,1,0,0,0
2024-04-12 03:45,3,2,1,0,0,0
2024-04-12 04:00,2,0,2,0,0,0
2024-04-12 04:15,3,2,1,0,0,0
2024-04-12 04:30,3,1,2,0,0,0
2024-04-12 04:45,7,4,3,0,0,0
2024-04-12 05:00,8,4,4,0,0,0
2024-04-12 05:15,12,6,6,0,0,0
2024-04-12 05:30,17,7,10,0,0,0
2024-04-12 05:45,17,4,13,0,0,0
2024-04-12 06:00,22,10,12,0,0,0
2024-04-12 06:15,41,15,26,0,0,0
2024-04-12 06:30,64,22,42,0,0,0
2024-04-12 06:45,85,38,47,0,0,0
2024-04-12 07:00,76,28,48,0,0,0
2024-04-12 07:15,163,56,107,0,0,0
2024-04-12 07:30,275,58,217,0,0,0
2024-04-12 07:45,284,87,197,0,0,0
2024-04-12 08:00,208,53,155,0,0,0
2024-04-12 08:15,195,61,134,0,0,0
2024-04-12 08:30,180,52,128,0,0,0
2024-04-12 08:45,200,57,143,0,0,0
2024-04-12 09:00,143,49,94,0,0,0
2024-04-12 09:15,145,49,96,0,0,0
2024-04-12 09:30,167,43,124,0,0,0
2024-04-12 09:45,181,42,139,0,0,0
2024-04-12 10:00,142,48,94,0,0,0
2024-04-12 10:15,136,64,72,0,0,0
2024-04-12 10:30,132,54,78,0,0,0
2024-04-12 10:45,156,76,80,0,0,0
2024-04-12 11:00,119,41,78,0,0,0
2024-04-12 11:15,138,67,71,0,0,0
2024-04-12 11:30,149,63,86,0,0,0
2024-04-12 11:45,171,76,95,0,0,0
2024-04-12 12:00,183,92,91,0,0,0
2024-04-12 12:15,170,80,90,0,0,0
2024-04-12 12:30,183,96,87,0,0,0
2024-04-12 12:45,191,102,89,0,0,0
2024-04-12 13:00,197,103,94,0,0,0
2024-04-12 13:15,194,104,90,0,0,0
2024-04-12 13:30,151,82,69,0,0,0
2024-04-12 13:45,211,115,96,0,0,0
2024-04-12 14:00,241,129,112,0,0,0
2024-04-12 14:15,200,116,84,0,0,0
2024-04-12 14:30,207,101,106,0,0,0
2024-04-12 14:45,221,114,107,0,0,0
2024-04-12 15:00,181,89,92,0,0,0
2024-04-12 15:15,196,92,104,0,0,0
2024-04-12 15:30,208,106,102,0,0,0
2024-04-12 15:45,208,106,102,0,0,0
2024-04-12 16:00,208,102,106,0,0,0
2024-04-12 16:15,208,113,95,0,0,0
2024-04-12 16:30,202,97,105,0,0,0
2024-04-12 16:45,230,113,117,0,0,0
2024-04-12 17:00,211,97,114,0,0,0
2024-04-12 17:15,210,95,115,0,0,0
2024-04-12 17:30,216,112,104,0,0,0
2024-04-12 17:45,236,134,102,0,0,0
2024-04-12 18:00,175,92,83,0,0,0
2024-04-12 18:15,183,99,84,0,0,0
2024-04-12 18:30,189,109,80,0,0,0
2024-04-12 18:45,228,128,100,0,0,0
2024-04-12 19:00,193,111,82,0,0,0
2024-04-12 19:15,171,96,75,0,0,0
2024-04-12 19:30,163,90,73,0,0,0
2024-04-12 19:45,162,82,80,0,0,0
2024-04-12 20:00,179,97,82,0,0,0
2024-04-12 20:15,141,63,78,0,0,0
2024-04-12 20:30,133,58,75,0,0,0
2024-04-12 20:45,116,61,55,0,0,0
2024-04-12 21:00,111,62,49,0,0,0
2024-04-12 21:15,109,67,42,0,0,0
2024-04-12 21:30,105,49,56,0,0,0
2024-04-12 21:45,75,31,44,0,0,0
2024-04-12 22:00,110,53,57,0,0,0
2024-04-12 22:15,105,56,49,0,0,0
2024-04-12 22:30,79,54,25,0,0,0
2024-04-12 22:45,80,47,33,0,0,0
2024-04-12 23:00,81,49,32,0,0,0
2024-04-12 23:15,75,36,39,0,0,0
2024-04-12 23:30,79,40,39,0,0,0
2024-04-12 23:45,83,47,36,0,0,0
2024-04-13 00:00,54,32,22,0,0,0
2024-04-13 00:15,48,27,21,0,0,0
2024-04-13 00:30,81,42,39,0,0,0
2024-04-13 00:45,40,30,10,0,0,0
2024-04-13 01:00,65,28,37,0,0,0
2024-04-13 01:15,40,29,11,0,0,0
2024-04-13 01:30,39,27,12,0,0,0
2024-04-13 01:45,37,20,17,0,0,0
2024-04-13 02:00,26,8,18,0,0,0
2024-04-13 02:15,40,19,21,0,0,0
2024-04-13 02:30,22,7,15,0,0,0
2024-04-13 02:45,26,14,12,0,0,0
2024-04-13 03:00,23,5,18,0,0,0
2024-04-13 03:15,20,14,6,0,0,0
2024-04-13 03:30,39,9,30,0,0,0
2024-04-13 03:45,18,5,13,0,0,0
2024-04-13 04:00,14,4,10,0,0,0
2024-04-13 04:15,11,2,9,0,0,0
2024-04-13 04:30,13,4,9,0,0,0
2024-04-13 04:45,11,7,4,0,0,0
2024-04-13 05:00,6,1,5,0,0,0
2024-04-13 05:15,12,2,10,0,0,0
2024-04-13 05:30,12,2,10,0,0,0
2024-04-13 05:45,22,6,16,0,0,0
2024-04-13 06:00,12,4,8,0,0,0
2024-04-13 06:15,18,5,13,0,0,0
2024-04-13 06:30,21,3,18,0,0,0
2024-04-13 06:45,18,7,11,0,0,0
2024-04-13 07:00,18,6,12,0,0,0
2024-04-13 07:15,30,10,20,0,0,0
2024-04-13 07:30,38,14,24,0,0,0
2024-04-13 07:45,36,8,28,0,0,0
2024-04-13 08:00,37,14,23,0,0,0
2024-04-13 08:15,53,21,32,0,0,0
2024-04-13 08:30,67,20,47,0,0,0
2024-04-13 08:45,80,22,58,0,0,0
2024-04-13 09:00,83,40,43,0,0,0
2024-04-13 09:15,117,31,86,0,0,0
2024-04-13 09:30,124,37,87,0,0,0
2024-04-13 09:45,165,41,124,0,0,0
2024-04-13 10:00,128,30,98,0,0,0
2024-04-13 10:15,164,47,117,0,0,0
2024-04-13 10:30,172,49,123,0,0,0
2024-04-13 10:45,200,46,154,0,0,0
2024-04-13 11:00,168,60,108,0,0,0
2024-04-13 11:15,201,79,122,0,0,0
2024-04-13 11:30,192,55,137,0,0,0
2024-04-13 11:45,225,79,146,0,0,0
2024-04-13 12:00,205,66,139,0,0,0
2024-04-13 12:15,188,71,117,0,0,0
2024-04-13 12:30,212,98,114,0,0,0
2024-04-13 12:45,267,106,161,0,0,0
2024-04-13 13:00,234,119,115,0,0,0
2024-04-13 13:15,233,98,135,0,0,0
2024-04-13 13:30,197,90,107,0,0,0
2024-04-13 13:45,221,111,110,0,0,0
2024-04-13 14:00,205,119,86,0,0,0
2024-04-13 14:15,194,113,81,0,0,0
2024-04-13 14:30,218,123,95,0,0,0
2024-04-13 14:45,188,110,78,0,0,0
2024-04-13 15:00,179,89,90,0,0,0
2024-04-13 15:15,195,105,90,0,0,0
2024-04-13 15:30,158,87,71,0,0,0
2024-04-13 15:45,199,111,88,0,0,0
2024-04-13 16:00,184,87,97,0,0,0
2024-04-13 16:15,143,74,69,0,0,0
2024-04-13 16:30,170,102,68,0,0,0
2024-04-13 16:45,185,100,85,0,0,0
2024-04-13 17:00,165,85,80,0,0,0
2024-04-13 17:15,153,79,74,0,0,0
2024-04-13 17:30,175,104,71,0,0,0
2024-04-13 17:45,207,96,111,0,0,0
2024-04-13 18:00,178,106,72,0,0,0
2024-04-13 18:15,179,86,93,0,0,0
2024-04-13 18:30,172,80,92,0,0,0
2024-04-13 18:45,222,121,101,0,0,0
2024-04-13 19:00,188,96,92,0,0,0
2024-04-13 19:15,179,90,89,0,0,0
2024-04-13 19:30,128,61,67,0,0,0
2024-04-13 19:45,165,92,73,0,0,0
2024-04-13 20:00,126,60,66,0,0,0
2024-04-13 20:15,108,59,49,0,0,0
2024-04-13 20:30,126,66,60,0,0,0
2024-04-13 20:45,95,40,55,0,0,0
2024-04-13 21:00,109,62,47,0,0,0
2024-04-13 21:15,89,46,43,0,0,0
2024-04-13 21:30,83,47,36,0,0,0
2024-04-13 21:45,90,55,35,0,0,0
2024-04-13 22:00,108,64,44,0,0,0
2024-04-13 22:15,99,51,48,0,0,0
2024-04-13 22:30,68,34,34,0,0,0
2024-04-13 22:45,68,29,39,0,0,0
2024-04-13 23:00,71,31,40,0,0,0
2024-04-13 23:15,87,41,46,0,0,0
2024-04-13 23:30,63,31,32,0,0,0
2024-04-13 23:45,59,33,26,0,0,0
2024-04-14 00:00,79,40,39,0,0,0
2024-04-14 00:15,64,42,22,0,0,0
2024-04-14 00:30,62,26,36,0,0,0
2024-04-14 00:45,55,28,27,0,0,0
2024-04-14 01:00,70,42,28,0,0,0
2024-04-14 01:15,75,27,48,0,0,0
2024-04-14 01:30,42,24,18,0,0,0
2024-04-14 01:45,63,37,26,0,0,0
2024-04-14 02:00,42,26,16,0,0,0
2024-04-14 02:15,39,22,17,0,0,0
2024-04-14 02:30,26,12,14,0,0,0
2024-04-14 02:45,26,14,12,0,0,0
2024-04-14 03:00,22,11,11,0,0,0
2024-04-14 03:15,22,10,12,0,0,0
2024-04-14 03:30,33,13,20,0,0,0
2024-04-14 03:45,14,6,8,0,0,0
2024-04-14 04:00,28,8,20,0,0,0
2024-04-14 04:15,10,6,4,0,0,0
2024-04-14 04:30,11,4,7,0,0,0
2024-04-14 04:45,7,1,6,0,0,0
2024-04-14 05:00,10,4,6,0,0,0
2024-04-14 05:15,7,1,6,0,0,0
2024-04-14 05:30,9,1,8,0,0,0
2024-04-14 05:45,10,2,8,0,0,0
2024-04-14 06:00,9,1,8,0,0,0
2024-04-14 06:15,11,4,7,0,0,0
2024-04-14 06:30,15,5,10,0,0,0
2024-04-14 06:45,8,3,5,0,0,0
2024-04-14 07:00,10,3,7,0,0,0
2024-04-14 07:15,9,6,3,0,0,0
2024-04-14 07:30,14,6,8,0,0,0
2024-04-14 07:45,12,8,4,0,0,0
2024-04-14 08:00,15,2,13,0,0,0
2024-04-14 08:15,12,3,9,0,0,0
2024-04-14 08:30,25,6,19,0,0,0
2024-04-14 08:45,30,14,16,0,0,0
2024-04-14 09:00,24,13,11,0,0,0
2024-04-14 09:15,36,12,24,0,0,0
2024-04-14 09:30,62,23,39,0,0,0
2024-04-14 09:45,72,28,44,0,0,0
2024-04-14 10:00,52,27,25,0,0,0
2024-04-14 10:15,64,26,38,0,0,0
2024-04-14 10:30,62,26,36,0,0,0
2024-04-14 10:45,85,30,55,0,0,0
2024-04-14 11:00,64,27,37,0,0,0
2024-04-14 11:15,84,40,44,0,0,0
2024-04-14 11:30,79,34,45,0,0,0
2024-04-14 11:45,98,35,63,0,0,0
2024-04-14 12:00,95,48,47,0,0,0
2024-04-14 12:15,111,48,63,0,0,0
2024-04-14 12:30,99,42,57,0,0,0
2024-04-14 12:45,103,40,63,0,0,0
2024-04-14 13:00,105,42,63,0,0,0
2024-04-14 13:15,99,49,50,0,0,0
2024-04-14 13:30,95,41,54,0,0,0
2024-04-14 13:45,121,57,64,0,0,0
2024-04-14 14:00,119,53,66,0,0,0
2024-04-14 14:15,130,60,70,0,0,0
2024-04-14 14:30,145,71,74,0,0,0
2024-04-14 14:45,141,76,65,0,0,0
2024-04-14 15:00,142,64,78,0,0,0
2024-04-14 15:15,140,61,79,0,0,0
2024-04-14 15:30,99,46,53,0,0,0
2024-04-14 15:45,140,47,93,0,0,0
2024-04-14 16:00,111,65,46,0,0,0
2024-04-14 16:15,115,61,54,0,0,0
2024-04-14 16:30,116,53,63,0,0,0
2024-04-14 16:45,119,43,76,0,0,0
2024-04-14 17:00,106,51,55,0,0,0
2024-04-14 17:15,141,78,63,0,0,0
2024-04-14 17:30,144,71,73,0,0,0
2024-04-14 17:45,146,79,67,0,0,0
2024-04-14 18:00,104,55,49,0,0,0
2024-04-14 18:15,89,45,44,0,0,0
2024-04-14 18:30,115,60,55,0,0,0
2024-04-14 18:45,100,39,61,0,0,0
2024-04-14 19:00,83,48,35,0,0,0
2024-04-14 19:15,102,44,58,0,0,0
2024-04-14 19:30,92,52,40,0,0,0
2024-04-14 19:45,98,69,29,0,0,0
2024-04-14 20:00,85,42,43,0,0,0
2024-04-14 20:15,75,37,38,0,0,0
2024-04-14 20:30,62,26,36,0,0,0
2024-04-14 20:45,73,43,30,0,0,0
2024-04-14 21:00,61,29,32,0,0,0
2024-04-14 21:15,54,28,26,0,0,0
2024-04-14 21:30,53,28,25,0,0,0
2024-04-14 21:45,74,24,50,0,0,0
2024-04-14 22:00,38,21,17,0,0,0
2024-04-14 22:15,37,13,24,0,0,0
2024-04-14 22:30,29,13,16,0,0,0
2024-04-14 22:45,22,8,14,0,0,0
2024-04-14 23:00,30,12,18,0,0,0
2024-04-14 23:15,25,13,12,0,0,0
2024-04-14 23:30,7,4,3,0,0,0
2024-04-14 23:45,9,4,5,0,0,0
2024-04-15 00:00,7,5,2,0,0,0
2024-04-15 00:15,8,1,7,0,0,0
2024-04-15 00:30,8,6,2,0,0,0
2024-04-15 00:45,8,3,5,0,0,0
2024-04-15 01:00,3,1,2,0,0,0
2024-04-15 01:15,0,0,0,0,0,0
2024-04-15 01:30,1,1,0,0,0,0
2024-04-15 01:45,0,0,0,0,0,0
2024-04-15 02:00,3,1,2,0,0,0
2024-04-15 02:15,3,2,1,0,0,0
2024-04-15 02:30,3,0,3,0,0,0
2024-04-15 02:45,2,2,0,0,0,0
2024-04-15 03:00,0,0,0,0,0,0
2024-04-15 03:15,5,3,2,0,0,0
2024-04-15 03:30,2,0,2,0,0,0
2024-04-15 03:45,4,3,1,0,0,0
2024-04-15 04:00,0,0,0,0,0,0
2024-04-15 04:15,2,1,1,0,0,0
2024-04-15 04:30,5,2,3,0,0,0
2024-04-15 04:45,8,5,3,0,0,0
2024-04-15 05:00,1,1,0,0,0,0
2024-04-15 05:15,9,6,3,0,0,0
2024-04-15 05:30,23,9,14,0,0,0
2024-04-15 05:45,27,10,17,0,0,0
2024-04-15 06:00,24,8,16,0,0,0
2024-04-15 06:15,41,20,21,0,0,0
2024-04-15 06:30,65,23,42,0,0,0
2024-04-15 06:45,83,40,43,0,0,0
2024-04-15 07:00,103,41,62,0,0,0
2024-04-15 07:15,173,52,121,0,0,0
2024-04-15 07:30,292,70,222,0,0,0
2024-04-15 07:45,308,84,224,0,0,0
2024-04-15 08:00,257,71,186,0,0,0
2024-04-15 08:15,237,66,171,0,0,0
2024-04-15 08:30,215,61,154,0,0,0
2024-04-15 08:45,174,53,121,0,0,0
2024-04-15 09:00,145,41,104,0,0,0
2024-04-15 09:15,145,40,105,0,0,0
2024-04-15 09:30,163,44,119,0,0,0
2024-04-15 09:45,204,40,164,0,0,0
2024-04-15 10:00,141,40,101,0,0,0
2024-04-15 10:15,97,33,64,0,0,0
2024-04-15 10:30,110,48,62,0,0,0
2024-04-15 10:45,121,42,79,0,0,0
2024-04-15 11:00,128,56,72,0,0,0
2024-04-15 11:15,142,64,78,0,0,0
2024-04-15 11:30,118,41,77,0,0,0
2024-04-15 11:45,199,72,127,0,0,0
2024-04-15 12:00,171,80,91,0,0,0
2024-04-15 12:15,147,69,78,0,0,0
2024-04-15 12:30,156,78,78,0,0,0
2024-04-15 12:45,161,91,70,0,0,0
2024-04-15 13:00,168,82,86,0,0,0
2024-04-15 13:15,145,78,67,0,0,0
2024-04-15 13:30,142,64,78,0,0,0
2024-04-15 13:45,199,91,108,0,0,0
2024-04-15 14:00,196,97,99,0,0,0
2024-04-15 14:15,175,100,75,0,0,0
2024-04-15 14:30,164,87,77,0,0,0
2024-04-15 14:45,194,99,95,0,0,0
2024-04-15 15:00,163,90,73,0,0,0
2024-04-15 15:15,175,97,78,0,0,0
2024-04-15 15:30,206,104,102,0,0,0
2024-04-15 15:45,212,114,98,0,0,0
2024-04-15 16:00,205,129,76,0,0,0
2024-04-15 16:15,202,113,89,0,0,0
2024-04-15 16:30,214,117,97,0,0,0
2024-04-15 16:45,206,111,95,0,0,0
2024-04-15 17:00,169,106,63,0,0,0
2024-04-15 17:15,128,81,47,0,0,0
2024-04-15 17:30,136,71,65,0,0,0
2024-04-15 17:45,160,93,67,0,0,0
2024-04-15 18:00,210,119,91,0,0,0
2024-04-15 18:15,183,110,73,0,0,0
2024-04-15 18:30,176,101,75,0,0,0
2024-04-15 18:45,152,89,63,0,0,0
2024-04-15 19:00,133,67,66,0,0,0
2024-04-15 19:15,115,65,50,0,0,0
2024-04-15 19:30,100,53,47,0,0,0
2024-04-15 19:45,137,75,62,0,0,0
2024-04-15 20:00,108,64,44,0,0,0
2024-04-15 20:15,86,49,37,0,0,0
2024-04-15 20:30,71,35,36,0,0,0
2024-04-15 20:45,70,38,32,0,0,0
2024-04-15 21:00,63,36,27,0,0,0
2024-04-15 21:15,67,34,33,0,0,0
2024-04-15 21:30,47,29,18,0,0,0
2024-04-15 21:45,58,39,19,0,0,0
2024-04-15 22:00,58,26,32,0,0,0
2024-04-15 22:15,54,33,21,0,0,0
2024-04-15 22:30,41,19,22,0,0,0
2024-04-15 22:45,37,22,15,0,0,0
2024-04-15 23:00,25,17,8,0,0,0
2024-04-15 23:15,24,13,11,0,0,0
2024-04-15 23:30,26,11,15,0,0,0
2024-04-15 23:45,18,13,5,0,0,0
2024-04-16 00:00,11,4,7,0,0,0
2024-04-16 00:15,10,7,3,0,0,0
2024-04-16 00:30,5,2,3,0,0,0
2024-04-16 00:45,7,3,4,0,0,0
2024-04-16 01:00,4,2,2,0,0,0
2024-04-16 01:15,1,0,1,0,0,0
2024-04-16 01:30,3,3,0,0,0,0
2024-04-16 01:45,0,0,0,0,0,0
2024-04-16 02:00,0,0,0,0,0,0
2024-04-16 02:15,3,1,2,0,0,0
2024-04-16 02:30,3,2,1,0,0,0
2024-04-16 02:45,0,0,0,0,0,0
2024-04-16 03:00,1,0,1,0,0,0
2024-04-16 03:15,2,1,1,0,0,0
2024-04-16 03:30,3,2,1,0,0,0
2024-04-16 03:45,1,0,1,0,0,0
2024-04-16 04:00,4,2,2,0,0,0
2024-04-16 04:15,1,1,0,0,0,0
2024-04-16 04:30,2,1,1,0,0,0
2024-04-16 04:45,5,2,3,0,0,0
2024-04-16 05:00,5,5,0,0,0,0
2024-04-16 05:15,8,3,5,0,0,0
2024-04-16 05:30,16,8,8,0,0,0
2024-04-16 05:45,13,3,10,0,0,0
2024-04-16 06:00,23,8,15,0,0,0
2024-04-16 06:15,47,22,25,0,0,0
2024-04-16 06:30,54,15,39,0,0,0
2024-04-16 06:45,68,25,43,0,0,0
2024-04-16 07:00,81,30,51,0,0,0
2024-04-16 07:15,147,43,104,0,0,0
2024-04-16 07:30,300,68,232,0,0,0
2024-04-16 07:45,326,84,242,0,0,0
2024-04-16 08:00,254,68,186,0,0,0
2024-04-16 08:15,244,78,166,0,0,0
2024-04-16 08:30,192,52,140,0,0,0
2024-04-16 08:45,165,49,116,0,0,0
2024-04-16 09:00,98,28,70,0,0,0
2024-04-16 09:15,86,29,57,0,0,0
2024-04-16 09:30,103,31,72,0,0,0
2024-04-16 09:45,145,43,102,0,0,0
2024-04-16 10:00,93,25,68,0,0,0
2024-04-16 10:15,61,28,33,0,0,0
2024-04-16 10:30,55,21,34,0,0,0
2024-04-16 10:45,85,38,47,0,0,0
2024-04-16 11:00,71,28,43,0,0,0
2024-04-16 11:15,59,25,34,0,0,0
2024-04-16 11:30,83,38,45,0,0,0
2024-04-16 11:45,112,40,72,0,0,0
2024-04-16 12:00,119,63,56,0,0,0
2024-04-16 12:15,87,47,40,0,0,0
2024-04-16 12:30,99,58,41,0,0,0
2024-04-16 12:45,116,56,60,0,0,0
2024-04-16 13:00,138,60,78,0,0,0
2024-04-16 13:15,123,60,63,0,0,0
2024-04-16 13:30,110,51,59,0,0,0
2024-04-16 13:45,175,86,89,0,0,0
2024-04-16 14:00,180,93,87,0,0,0
2024-04-16 14:15,135,62,73,0,0,0
2024-04-16 14:30,141,70,71,0,0,0
2024-04-16 14:45,149,74,75,0,0,0
2024-04-16 15:00,130,78,52,0,0,0
2024-04-16 15:15,161,88,73,0,0,0
2024-04-16 15:30,169,71,98,0,0,0
2024-04-16 15:45,238,134,104,0,0,0
2024-04-16 16:00,232,122,110,0,0,0
2024-04-16 16:15,176,109,67,0,0,0
2024-04-16 16:30,197,110,87,0,0,0
2024-04-16 16:45,212,122,90,0,0,0
2024-04-16 17:00,220,112,108,0,0,0
2024-04-16 17:15,197,107,90,0,0,0
2024-04-16 17:30,220,107,113,0,0,0
2024-04-16 17:45,283,167,116,0,0,0
2024-04-16 18:00,252,139,113,0,0,0
2024-04-16 18:15,214,128,86,0,0,0
2024-04-16 18:30,182,94,88,0,0,0
2024-04-16 18:45,199,120,79,0,0,0
2024-04-16 19:00,166,91,75,0,0,0
2024-04-16 19:15,144,73,71,0,0,0
2024-04-16 19:30,159,85,74,0,0,0
2024-04-16 19:45,158,95,63,0,0,0
2024-04-16 20:00,138,76,62,0,0,0
2024-04-16 20:15,100,48,52,0,0,0
2024-04-16 20:30,96,51,45,0,0,0
2024-04-16 20:45,77,39,38,0,0,0
2024-04-16 21:00,74,37,37,0,0,0
2024-04-16 21:15,85,45,40,0,0,0
2024-04-16 21:30,60,24,36,0,0,0
2024-04-16 21:45,61,32,29,0,0,0
2024-04-16 22:00,69,36,33,0,0,0
2024-04-16 22:15,84,45,39,0,0,0
2024-04-16 22:30,54,29,25,0,0,0
2024-04-16 22:45,32,15,17,0,0,0
2024-04-16 23:00,65,32,33,0,0,0
2024-04-16 23:15,45,22,23,0,0,0
2024-04-16 23:30,30,20,10,0,0,0
2024-04-16 23:45,23,9,14,0,0,0
2024-04-17 00:00,7,4,3,0,0,0
2024-04-17 00:15,16,9,7,0,0,0
2024-04-17 00:30,11,6,5,0,0,0
2024-04-17 00:45,11,5,6,0,0,0
2024-04-17 01:00,6,3,3,0,0,0
2024-04-17 01:15,6,3,3,0,0,0
2024-04-17 01:30,4,1,3,0,0,0
2024-04-17 01:45,1,0,1,0,0,0
2024-04-17 02:00,3,1,2,0,0,0
2024-04-17 02:15,2,0,2,0,0,0
2024-04-17 02:30,0,0,0,0,0,0
2024-04-17 02:45,2,2,0,0,0,0
2024-04-17 03:00,0,0,0,0,0,0
2024-04-17 03:15,0,0,0,0,0,0
2024-04-17 03:30,0,0,0,0,0,0
2024-04-17 03:45,6,1,5,0,0,0
2024-04-17 04:00,0,0,0,0,0,0
2024-04-17 04:15,3,1,2,0,0,0
2024-04-17 04:30,4,1,3,0,0,0
2024-04-17 04:45,7,2,5,0,0,0
2024-04-17 05:00,5,3,2,0,0,0
2024-04-17 05:15,11,4,7,0,0,0
2024-04-17 05:30,28,12,16,0,0,0
2024-04-17 05:45,14,3,11,0,0,0
2024-04-17 06:00,20,3,17,0,0,0
2024-04-17 06:15,38,17,21,0,0,0
2024-04-17 06:30,62,18,44,0,0,0
2024-04-17 06:45,91,43,48,0,0,0
2024-04-17 07:00,114,40,74,0,0,0
2024-04-17 07:15,151,44,107,0,0,0
2024-04-17 07:30,288,55,233,0,0,0
2024-04-17 07:45,337,95,242,0,0,0
2024-04-17 08:00,248,74,174,0,0,0
2024-04-17 08:15,224,60,164,0,0,0
2024-04-17 08:30,204,49,155,0,0,0
2024-04-17 08:45,221,57,164,0,0,0
2024-04-17 09:00,165,60,105,0,0,0
2024-04-17 09:15,108,35,73,0,0,0
2024-04-17 09:30,136,28,108,0,0,0
2024-04-17 09:45,221,47,174,0,0,0
2024-04-17 10:00,156,55,101,0,0,0
2024-04-17 10:15,119,50,69,0,0,0
2024-04-17 10:30,86,27,59,0,0,0
2024-04-17 10:45,123,50,73,0,0,0
2024-04-17 11:00,95,42,53,0,0,0
2024-04-17 11:15,105,44,61,0,0,0
2024-04-17 11:30,142,58,84,0,0,0
2024-04-17 11:45,188,86,102,0,0,0
2024-04-17 12:00,163,67,96,0,0,0
2024-04-17 12:15,143,72,71,0,0,0
2024-04-17 12:30,145,82,63,0,0,0
2024-04-17 12:45,141,60,81,0,0,0
2024-04-17 13:00,156,85,71,0,0,0
2024-04-17 13:15,157,77,80,0,0,0
2024-04-17 13:30,156,75,81,0,0,0
2024-04-17 13:45,219,107,112,0,0,0
2024-04-17 14:00,178,101,77,0,0,0
2024-04-17 14:15,156,93,63,0,0,0
2024-04-17 14:30,99,55,44,0,0,0
2024-04-17 14:45,148,77,71,0,0,0
2024-04-17 15:00,128,69,59,0,0,0
2024-04-17 15:15,132,74,58,0,0,0
2024-04-17 15:30,156,72,84,0,0,0
2024-04-17 15:45,218,103,115,0,0,0
2024-04-17 16:00,218,131,87,0,0,0
2024-04-17 16:15,194,114,80,0,0,0
2024-04-17 16:30,195,108,87,0,0,0
2024-04-17 16:45,196,101,95,0,0,0
2024-04-17 17:00,205,115,90,0,0,0
2024-04-17 17:15,201,114,87,0,0,0
2024-04-17 17:30,210,103,107,0,0,0
2024-04-17 17:45,284,162,122,0,0,0
2024-04-17 18:00,213,121,92,0,0,0
2024-04-17 18:15,205,109,96,0,0,0
2024-04-17 18:30,190,110,80,0,0,0
2024-04-17 18:45,233,112,121,0,0,0
2024-04-17 19:00,167,104,63,0,0,0
2024-04-17 19:15,167,95,72,0,0,0
2024-04-17 19:30,160,97,63,0,0,0
2024-04-17 19:45,164,95,69,0,0,0
2024-04-17 20:00,141,81,60,0,0,0
2024-04-17 20:15,129,70,59,0,0,0
2024-04-17 20:30,105,51,54,0,0,0
2024-04-17 20:45,107,50,57,0,0,0
2024-04-17 21:00,88,56,32,0,0,0
2024-04-17 21:15,82,40,42,0,0,0
2024-04-17 21:30,79,43,36,0,0,0
2024-04-17 21:45,98,54,44,0,0,0
2024-04-17 22:00,66,36,30,0,0,0
2024-04-17 22:15,89,47,42,0,0,0
2024-04-17 22:30,52,35,17,0,0,0
2024-04-17 22:45,48,28,20,0,0,0
2024-04-17 23:00,68,37,31,0,0,0
2024-04-17 23:15,52,33,19,0,0,0
2024-04-17 23:30,28,17,11,0,0,0
2024-04-17 23:45,52,30,22,0,0,0
2024-04-18 00:00,56,29,27,0,0,0
2024-04-18 00:15,23,9,14,0,0,0
2024-04-18 00:30,14,10,4,0,0,0
2024-04-18 00:45,14,7,7,0,0,0
2024-04-18 01:00,13,10,3,0,0,0
2024-04-18 01:15,13,9,4,0,0,0
2024-04-18 01:30,11,4,7,0,0,0
2024-04-18 01:45,9,4,5,0,0,0
2024-04-18 02:00,16,5,11,0,0,0
2024-04-18 02:15,16,12,4,0,0,0
2024-04-18 02:30,13,7,6,0,0,0
2024-04-18 02:45,3,2,1,0,0,0
2024-04-18 03:00,8,6,2,0,0,0
2024-04-18 03:15,12,9,3,0,0,0
2024-04-18 03:30,7,3,4,0,0,0
2024-04-18 03:45,8,5,3,0,0,0
2024-04-18 04:00,7,1,6,0,0,0
2024-04-18 04:15,7,4,3,0,0,0
2024-04-18 04:30,5,2,3,0,0,0
2024-04-18 04:45,5,4,1,0,0,0
2024-04-18 05:00,4,2,2,0,0,0
2024-04-18 05:15,9,6,3,0,0,0
2024-04-18 05:30,28,13,15,0,0,0
2024-04-18 05:45,16,6,10,0,0,0
2024-04-18 06:00,21,8,13,0,0,0
2024-04-18 06:15,42,18,24,0,0,0
2024-04-18 06:30,61,19,42,0,0,0
2024-04-18 06:45,92,35,57,0,0,0
2024-04-18 07:00,84,33,51,0,0,0
2024-04-18 07:15,152,43,109,0,0,0
2024-04-18 07:30,277,56,221,0,0,0
2024-04-18 07:45,345,100,245,0,0,0
2024-04-18 08:00,241,64,177,0,0,0
2024-04-18 08:15,207,71,136,0,0,0
2024-04-18 08:30,196,53,143,0,0,0
2024-04-18 08:45,209,68,141,0,0,0
2024-04-18 09:00,120,35,85,0,0,0
2024-04-18 09:15,134,40,94,0,0,0
2024-04-18 09:30,142,36,106,0,0,0
2024-04-18 09:45,220,37,183,0,0,0
2024-04-18 10:00,194,68,126,0,0,0
2024-04-18 10:15,99,36,63,0,0,0
2024-04-18 10:30,123,48,75,0,0,0
2024-04-18 10:45,138,53,85,0,0,0
2024-04-18 11:00,107,40,67,0,0,0
2024-04-18 11:15,116,51,65,0,0,0
2024-04-18 11:30,132,53,79,0,0,0
2024-04-18 11:45,182,68,114,0,0,0
2024-04-18 12:00,173,78,95,0,0,0
2024-04-18 12:15,135,72,63,0,0,0
2024-04-18 12:30,146,75,71,0,0,0
2024-04-18 12:45,188,79,109,0,0,0
2024-04-18 13:00,182,97,85,0,0,0
2024-04-18 13:15,158,75,83,0,0,0
2024-04-18 13:30,166,74,92,0,0,0
2024-04-18 13:45,220,103,117,0,0,0
2024-04-18 14:00,204,115,89,0,0,0
2024-04-18 14:15,156,90,66,0,0,0
2024-04-18 14:30,149,85,64,0,0,0
2024-04-18 14:45,185,97,88,0,0,0
2024-04-18 15:00,169,95,74,0,0,0
2024-04-18 15:15,199,111,88,0,0,0
2024-04-18 15:30,230,114,116,0,0,0
2024-04-18 15:45,256,119,137,0,0,0
2024-04-18 16:00,249,144,105,0,0,0
2024-04-18 16:15,227,133,94,0,0,0
2024-04-18 16:30,246,121,125,0,0,0
2024-04-18 16:45,265,138,127,0,0,0
2024-04-18 17:00,253,140,113,0,0,0
2024-04-18 17:15,265,128,137,0,0,0
2024-04-18 17:30,258,127,131,0,0,0
2024-04-18 17:45,261,141,120,0,0,0
2024-04-18 18:00,245,138,107,0,0,0
2024-04-18 18:15,218,120,98,0,0,0
2024-04-18 18:30,197,110,87,0,0,0
2024-04-18 18:45,187,98,89,0,0,0
2024-04-18 19:00,169,86,83,0,0,0
2024-04-18 19:15,156,90,66,0,0,0
2024-04-18 19:30,145,84,61,0,0,0
2024-04-18 19:45,175,92,83,0,0,0
2024-04-18 20:00,136,79,57,0,0,0
2024-04-18 20:15,127,73,54,0,0,0
2024-04-18 20:30,113,62,51,0,0,0
2024-04-18 20:45,93,50,43,0,0,0
2024-04-18 21:00,84,52,32,0,0,0
2024-04-18 21:15,68,36,32,0,0,0
2024-04-18 21:30,73,37,36,0,0,0
2024-04-18 21:45,82,53,29,0,0,0
2024-04-18 22:00,86,44,42,0,0,0
2024-04-18 22:15,81,48,33,0,0,0
2024-04-18 22:30,75,44,31,0,0,0
2024-04-18 22:45,62,26,36,0,0,0
2024-04-18 23:00,60,23,37,0,0,0
2024-04-18 23:15,59,27,32,0,0,0
2024-04-18 23:30,60,22,38,0,0,0
2024-04-18 23:45,27,10,17,0,0,0
2024-04-19 00:00,19,16,3,0,0,0
2024-04-19 00:15,26,18,8,0,0,0
2024-04-19 00:30,16,10,6,0,0,0
2024-04-19 00:45,7,4,3,0,0,0
2024-04-19 01:00,19,12,7,0,0,0
2024-04-19 01:15,12,3,9,0,0,0
2024-04-19 01:30,3,1,2,0,0,0
2024-04-19 01:45,1,1,0,0,0,0
2024-04-19 02:00,7,3,4,0,0,0
2024-04-19 02:15,4,0,4,0,0,0
2024-04-19 02:30,4,2,2,0,0,0
2024-04-19 02:45,4,1,3,0,0,0
2024-04-19 03:00,0,0,0,0,0,0
2024-04-19 03:15,3,2,1,0,0,0
2024-04-19 03:30,5,2,3,0,0,0
2024-04-19 03:45,5,0,5,0,0,0
2024-04-19 04:00,6,2,4,0,0,0
2024-04-19 04:15,1,1,0,0,0,0
2024-04-19 04:30,1,0,1,0,0,0
2024-04-19 04:45,7,1,6,0,0,0
2024-04-19 05:00,3,3,0,0,0,0
2024-04-19 05:15,6,4,2,0,0,0
2024-04-19 05:30,13,5,8,0,0,0
2024-04-19 05:45,10,5,5,0,0,0
2024-04-19 06:00,18,4,14,0,0,0
2024-04-19 06:15,36,18,18,0,0,0
2024-04-19 06:30,34,11,23,0,0,0
2024-04-19 06:45,42,19,23,0,0,0
2024-04-19 07:00,80,34,46,0,0,0
2024-04-19 07:15,111,47,64,0,0,0
2024-04-19 07:30,226,56,170,0,0,0
2024-04-19 07:45,238,78,160,0,0,0
2024-04-19 08:00,136,39,97,0,0,0
2024-04-19 08:15,158,38,120,0,0,0
2024-04-19 08:30,126,34,92,0,0,0
2024-04-19 08:45,136,42,94,0,0,0
2024-04-19 09:00,103,36,67,0,0,0
2024-04-19 09:15,92,29,63,0,0,0
2024-04-19 09:30,106,35,71,0,0,0
2024-04-19 09:45,135,25,110,0,0,0
2024-04-19 10:00,101,41,60,0,0,0
2024-04-19 10:15,92,31,61,0,0,0
2024-04-19 10:30,86,35,51,0,0,0
2024-04-19 10:45,119,35,84,0,0,0
2024-04-19 11:00,86,37,49,0,0,0
2024-04-19 11:15,108,44,64,0,0,0
2024-04-19 11:30,110,50,60,0,0,0
2024-04-19 11:45,149,59,90,0,0,0
2024-04-19 12:00,118,56,62,0,0,0
2024-04-19 12:15,113,62,51,0,0,0
2024-04-19 12:30,122,72,50,0,0,0
2024-04-19 12:45,169,82,87,0,0,0
2024-04-19 13:00,150,77,73,0,0,0
2024-04-19 13:15,150,80,70,0,0,0
2024-04-19 13:30,147,78,69,0,0,0
2024-04-19 13:45,141,74,67,0,0,0
2024-04-19 14:00,141,79,62,0,0,0
2024-04-19 14:15,168,93,75,0,0,0
2024-04-19 14:30,165,76,89,0,0,0
2024-04-19 14:45,154,69,85,0,0,0
2024-04-19 15:00,120,73,47,0,0,0
2024-04-19 15:15,159,88,71,0,0,0
2024-04-19 15:30,144,66,78,0,0,0
2024-04-19 15:45,127,60,67,0,0,0
2024-04-19 16:00,147,77,70,0,0,0
2024-04-19 16:15,166,106,60,0,0,0
2024-04-19 16:30,121,57,64,0,0,0
2024-04-19 16:45,132,73,59,0,0,0
2024-04-19 17:00,140,86,54,0,0,0
2024-04-19 17:15,165,80,85,0,0,0
2024-04-19 17:30,115,69,46,0,0,0
2024-04-19 17:45,152,78,74,0,0,0
2024-04-19 18:00,157,92,65,0,0,0
2024-04-19 18:15,168,109,59,0,0,0
2024-04-19 18:30,152,86,66,0,0,0
2024-04-19 18:45,123,64,59,0,0,0
2024-04-19 19:00,153,81,72,0,0,0
2024-04-19 19:15,111,58,53,0,0,0
2024-04-19 19:30,93,46,47,0,0,0
2024-04-19 19:45,133,74,59,0,0,0
2024-04-19 20:00,118,67,51,0,0,0
2024-04-19 20:15,107,56,51,0,0,0
2024-04-19 20:30,102,52,50,0,0,0
2024-04-19 20:45,71,35,36,0,0,0
2024-04-19 21:00,76,31,45,0,0,0
2024-04-19 21:15,72,40,32,0,0,0
2024-04-19 21:30,56,35,21,0,0,0
2024-04-19 21:45,64,34,30,0,0,0
2024-04-19 22:00,56,22,34,0,0,0
2024-04-19 22:15,81,47,34,0,0,0
2024-04-19 22:30,55,30,25,0,0,0
2024-04-19 22:45,53,33,20,0,0,0
2024-04-19 23:00,58,24,34,0,0,0
2024-04-19 23:15,59,26,33,0,0,0
2024-04-19 23:30,40,25,15,0,0,0
2024-04-19 23:45,61,26,35,0,0,0
2024-04-20 00:00,59,28,31,0,0,0
2024-04-20 00:15,43,20,23,0,0,0
2024-04-20 00:30,46,34,12,0,0,0
2024-04-20 00:45,33,15,18,0,0,0
2024-04-20 01:00,34,19,15,0,0,0
2024-04-20 01:15,38,20,18,0,0,0
2024-04-20 01:30,42,21,21,0,0,0
2024-04-20 01:45,22,13,9,0,0,0
2024-04-20 02:00,21,8,13,0,0,0
2024-04-20 02:15,21,9,12,0,0,0
2024-04-20 02:30,15,9,6,0,0,0
2024-04-20 02:45,16,8,8,0,0,0
2024-04-20 03:00,26,14,12,0,0,0
2024-04-20 03:15,13,5,8,0,0,0
2024-04-20 03:30,14,6,8,0,0,0
2024-04-20 03:45,12,5,7,0,0,0
2024-04-20 04:00,13,4,9,0,0,0
2024-04-20 04:15,9,3,6,0,0,0
2024-04-20 04:30,7,5,2,0,0,0
2024-04-20 04:45,15,4,11,0,0,0
2024-04-20 05:00,9,4,5,0,0,0
2024-04-20 05:15,3,1,2,0,0,0
2024-04-20 05:30,13,6,7,0,0,0
2024-04-20 05:45,13,4,9,0,0,0
2024-04-20 06:00,14,5,9,0,0,0
2024-04-20 06:15,18,5,13,0,0,0
2024-04-20 06:30,13,2,11,0,0,0
2024-04-20 06:45,8,2,6,0,0,0
2024-04-20 07:00,13,2,11,0,0,0
2024-04-20 07:15,13,6,7,0,0,0
2024-04-20 07:30,23,4,19,0,0,0
2024-04-20 07:45,49,15,34,0,0,0
2024-04-20 08:00,24,11,13,0,0,0
2024-04-20 08:15,53,23,30,0,0,0
2024-04-20 08:30,65,21,44,0,0,0
2024-04-20 08:45,70,19,51,0,0,0
2024-04-20 09:00,66,25,41,0,0,0
2024-04-20 09:15,100,34,66,0,0,0
2024-04-20 09:30,102,34,68,0,0,0
2024-04-20 09:45,136,45,91,0,0,0
2024-04-20 10:00,102,34,68,0,0,0
2024-04-20 10:15,107,35,72,0,0,0
2024-04-20 10:30,100,26,74,0,0,0
2024-04-20 10:45,132,52,80,0,0,0
2024-04-20 11:00,97,31,66,0,0,0
2024-04-20 11:15,131,46,85,0,0,0
2024-04-20 11:30,132,46,86,0,0,0
2024-04-20 11:45,147,61,86,0,0,0
2024-04-20 12:00,121,47,74,0,0,0
2024-04-20 12:15,131,67,64,0,0,0
2024-04-20 12:30,161,73,88,0,0,0
2024-04-20 12:45,146,67,79,0,0,0
2024-04-20 13:00,132,75,57,0,0,0
2024-04-20 13:15,153,87,66,0,0,0
2024-04-20 13:30,134,62,72,0,0,0
2024-04-20 13:45,134,73,61,0,0,0
2024-04-20 14:00,136,66,70,0,0,0
2024-04-20 14:15,124,78,46,0,0,0
2024-04-20 14:30,130,59,71,0,0,0
2024-04-20 14:45,129,71,58,0,0,0
2024-04-20 15:00,125,69,56,0,0,0
2024-04-20 15:15,115,65,50,0,0,0
2024-04-20 15:30,111,58,53,0,0,0
2024-04-20 15:45,88,44,44,0,0,0
2024-04-20 16:00,88,53,35,0,0,0
2024-04-20 16:15,128,84,44,0,0,0
2024-04-20 16:30,109,60,49,0,0,0
2024-04-20 16:45,104,54,50,0,0,0
2024-04-20 17:00,111,66,45,0,0,0
2024-04-20 17:15,102,59,43,0,0,0
2024-04-20 17:30,39,21,18,0,0,0
2024-04-20 17:45,126,65,61,0,0,0
2024-04-20 18:00,99,57,42,0,0,0
2024-04-20 18:15,81,49,32,0,0,0
2024-04-20 18:30,90,53,37,0,0,0
2024-04-20 18:45,105,59,46,0,0,0
2024-04-20 19:00,108,73,35,0,0,0
2024-04-20 19:15,86,42,44,0,0,0
2024-04-20 19:30,84,40,44,0,0,0
2024-04-20 19:45,92,39,53,0,0,0
2024-04-20 20:00,70,37,33,0,0,0
2024-04-20 20:15,103,51,52,0,0,0
2024-04-20 20:30,60,30,30,0,0,0
2024-04-20 20:45,60,29,31,0,0,0
2024-04-20 21:00,40,19,21,0,0,0
2024-04-20 21:15,37,10,27,0,0,0
2024-04-20 21:30,40,24,16,0,0,0
2024-04-20 21:45,48,23,25,0,0,0
2024-04-20 22:00,44,19,25,0,0,0
2024-04-20 22:15,57,25,32,0,0,0
2024-04-20 22:30,69,56,13,0,0,0
2024-04-20 22:45,51,37,14,0,0,0
2024-04-20 23:00,46,20,26,0,0,0
2024-04-20 23:15,50,19,31,0,0,0
2024-04-20 23:30,34,18,16,0,0,0
2024-04-20 23:45,35,24,11,0,0,0
2024-04-21 00:00,51,27,24,0,0,0
2024-04-21 00:15,37,19,18,0,0,0
2024-04-21 00:30,50,25,25,0,0,0
2024-04-21 00:45,44,23,21,0,0,0
2024-04-21 01:00,33,17,16,0,0,0
2024-04-21 01:15,25,16,9,0,0,0
2024-04-21 01:30,25,18,7,0,0,0
2024-04-21 01:45,35,12,23,0,0,0
2024-04-21 02:00,16,11,5,0,0,0
2024-04-21 02:15,29,18,11,0,0,0
2024-04-21 02:30,16,9,7,0,0,0
2024-04-21 02:45,13,9,4,0,0,0
2024-04-21 03:00,24,13,11,0,0,0
2024-04-21 03:15,18,10,8,0,0,0
2024-04-21 03:30,12,1,11,0,0,0
2024-04-21 03:45,13,3,10,0,0,0
2024-04-21 04:00,7,2,5,0,0,0
2024-04-21 04:15,8,5,3,0,0,0
2024-04-21 04:30,16,8,8,0,0,0
2024-04-21 04:45,10,2,8,0,0,0
2024-04-21 05:00,2,1,1,0,0,0
2024-04-21 05:15,8,3,5,0,0,0
2024-04-21 05:30,7,2,5,0,0,0
2024-04-21 05:45,6,2,4,0,0,0
2024-04-21 06:00,8,3,5,0,0,0
2024-04-21 06:15,2,0,2,0,0,0
2024-04-21 06:30,4,0,4,0,0,0
2024-04-21 06:45,8,2,6,0,0,0
2024-04-21 07:00,10,5,5,0,0,0
2024-04-21 07:15,13,5,8,0,0,0
2024-04-21 07:30,8,2,6,0,0,0
2024-04-21 07:45,21,14,7,0,0,0
2024-04-21 08:00,7,4,3,0,0,0
2024-04-21 08:15,9,7,2,0,0,0
2024-04-21 08:30,13,3,10,0,0,0
2024-04-21 08:45,22,9,13,0,0,0
2024-04-21 09:00,24,11,13,0,0,0
2024-04-21 09:15,35,15,20,0,0,0
2024-04-21 09:30,33,14,19,0,0,0
2024-04-21 09:45,59,29,30,0,0,0
2024-04-21 10:00,51,18,33,0,0,0
2024-04-21 10:15,66,31,35,0,0,0
2024-04-21 10:30,47,19,28,0,0,0
2024-04-21 10:45,81,38,43,0,0,0
2024-04-21 11:00,80,45,35,0,0,0
2024-04-21 11:15,47,21,26,0,0,0
2024-04-21 11:30,70,29,41,0,0,0
2024-04-21 11:45,59,26,33,0,0,0
2024-04-21 12:00,69,27,42,0,0,0
2024-04-21 12:15,61,32,29,0,0,0
2024-04-21 12:30,91,42,49,0,0,0
2024-04-21 12:45,90,36,54,0,0,0
2024-04-21 13:00,77,40,37,0,0,0
2024-04-21 13:15,95,46,49,0,0,0
2024-04-21 13:30,78,36,42,0,0,0
2024-04-21 13:45,93,42,51,0,0,0
2024-04-21 14:00,67,33,34,0,0,0
2024-04-21 14:15,90,50,40,0,0,0
2024-04-21 14:30,90,36,54,0,0,0
2024-04-21 14:45,113,60,53,0,0,0
2024-04-21 15:00,95,33,62,0,0,0
2024-04-21 15:15,88,33,55,0,0,0
2024-04-21 15:30,96,44,52,0,0,0
2024-04-21 15:45,105,47,58,0,0,0
2024-04-21 16:00,90,52,38,0,0,0
2024-04-21 16:15,81,46,35,0,0,0
2024-04-21 16:30,89,41,48,0,0,0
2024-04-21 16:45,88,43,45,0,0,0
2024-04-21 17:00,77,32,45,0,0,0
2024-04-21 17:15,98,52,46,0,0,0
2024-04-21 17:30,77,34,43,0,0,0
2024-04-21 17:45,99,34,65,0,0,0
2024-04-21 18:00,85,47,38,0,0,0
2024-04-21 18:15,89,56,33,0,0,0
2024-04-21 18:30,77,36,41,0,0,0
2024-04-21 18:45,95,55,40,0,0,0
2024-04-21 19:00,91,51,40,0,0,0
2024-04-21 19:15,84,33,51,0,0,0
2024-04-21 19:30,90,45,45,0,0,0
2024-04-21 19:45,88,52,36,0,0,0
2024-04-21 20:00,78,31,47,0,0,0
2024-04-21 20:15,69,43,26,0,0,0
2024-04-21 20:30,75,34,41,0,0,0
2024-04-21 20:45,47,29,18,0,0,0
2024-04-21 21:00,37,26,11,0,0,0
2024-04-21 21:15,47,21,26,0,0,0
2024-04-21 21:30,55,25,30,0,0,0
2024-04-21 21:45,26,12,14,0,0,0
2024-04-21 22:00,36,12,24,0,0,0
2024-04-21 22:15,57,16,41,0,0,0
2024-04-21 22:30,37,17,20,0,0,0
2024-04-21 22:45,14,8,6,0,0,0
2024-04-21 23:00,24,12,12,0,0,0
2024-04-21 23:15,27,8,19,0,0,0
2024-04-21 23:30,12,5,7,0,0,0
2024-04-21 23:45,11,5,6,0,0,0
2024-04-22 00:00,5,3,2,0,0,0
2024-04-22 00:15,8,5,3,0,0,0
2024-04-22 00:30,8,4,4,0,0,0
2024-04-22 00:45,2,0,2,0,0,0
2024-04-22 01:00,3,0,3,0,0,0
2024-04-22 01:15,1,1,0,0,0,0
2024-04-22 01:30,4,1,3,0,0,0
2024-04-22 01:45,6,5,1,0,0,0
2024-04-22 02:00,0,0,0,0,0,0
2024-04-22 02:15,2,0,2,0,0,0
2024-04-22 02:30,0,0,0,0,0,0
2024-04-22 02:45,1,1,0,0,0,0
2024-04-22 03:00,1,1,0,0,0,0
2024-04-22 03:15,2,2,0,0,0,0
2024-04-22 03:30,4,0,4,0,0,0
2024-04-22 03:45,1,0,1,0,0,0
2024-04-22 04:00,3,1,2,0,0,0
2024-04-22 04:15,4,2,2,0,0,0
2024-04-22 04:30,3,2,1,0,0,0
2024-04-22 04:45,5,2,3,0,0,0
2024-04-22 05:00,4,4,0,0,0,0
2024-04-22 05:15,15,7,8,0,0,0
2024-04-22 05:30,8,4,4,0,0,0
2024-04-22 05:45,25,9,16,0,0,0
2024-04-22 06:00,19,2,17,0,0,0
2024-04-22 06:15,49,24,25,0,0,0
2024-04-22 06:30,65,22,43,0,0,0
2024-04-22 06:45,86,37,49,0,0,0
2024-04-22 07:00,92,34,58,0,0,0
2024-04-22 07:15,174,64,110,0,0,0
2024-04-22 07:30,322,78,244,0,0,0
2024-04-22 07:45,311,81,230,0,0,0
2024-04-22 08:00,248,87,161,0,0,0
2024-04-22 08:15,215,72,143,0,0,0
2024-04-22 08:30,210,55,155,0,0,0
2024-04-22 08:45,203,60,143,0,0,0
2024-04-22 09:00,140,41,99,0,0,0
2024-04-22 09:15,133,35,98,0,0,0
2024-04-22 09:30,170,45,125,0,0,0
2024-04-22 09:45,226,45,181,0,0,0
2024-04-22 10:00,158,49,109,0,0,0
2024-04-22 10:15,113,45,68,0,0,0
2024-04-22 10:30,106,40,66,0,0,0
2024-04-22 10:45,144,47,97,0,0,0
2024-04-22 11:00,111,55,56,0,0,0
2024-04-22 11:15,113,42,71,0,0,0
2024-04-22 11:30,131,60,71,0,0,0
2024-04-22 11:45,173,62,111,0,0,0
2024-04-22 12:00,168,75,93,0,0,0
2024-04-22 12:15,151,72,79,0,0,0
2024-04-22 12:30,135,70,65,0,0,0
2024-04-22 12:45,148,64,84,0,0,0
2024-04-22 13:00,177,94,83,0,0,0
2024-04-22 13:15,141,65,76,0,0,0
2024-04-22 13:30,158,76,82,0,0,0
2024-04-22 13:45,190,94,96,0,0,0
2024-04-22 14:00,213,125,88,0,0,0
2024-04-22 14:15,156,66,90,0,0,0
2024-04-22 14:30,160,76,84,0,0,0
2024-04-22 14:45,205,104,101,0,0,0
2024-04-22 15:00,183,99,84,0,0,0
2024-04-22 15:15,200,119,81,0,0,0
2024-04-22 15:30,205,99,106,0,0,0
2024-04-22 15:45,282,164,118,0,0,0
2024-04-22 16:00,256,144,112,0,0,0
2024-04-22 16:15,227,133,94,0,0,0
2024-04-22 16:30,255,121,134,0,0,0
2024-04-22 16:45,261,140,121,0,0,0
2024-04-22 17:00,239,129,110,0,0,0
2024-04-22 17:15,222,115,107,0,0,0
2024-04-22 17:30,245,128,117,0,0,0
2024-04-22 17:45,293,154,139,0,0,0
2024-04-22 18:00,280,165,115,0,0,0
2024-04-22 18:15,214,115,99,0,0,0
2024-04-22 18:30,203,97,106,0,0,0
2024-04-22 18:45,190,91,99,0,0,0
2024-04-22 19:00,160,79,81,0,0,0
2024-04-22 19:15,160,79,81,0,0,0
2024-04-22 19:30,136,69,67,0,0,0
2024-04-22 19:45,162,90,72,0,0,0
2024-04-22 20:00,144,78,66,0,0,0
2024-04-22 20:15,92,40,52,0,0,0
2024-04-22 20:30,111,63,48,0,0,0
2024-04-22 20:45,98,55,43,0,0,0
2024-04-22 21:00,69,36,33,0,0,0
2024-04-22 21:15,70,37,33,0,0,0
2024-04-22 21:30,69,40,29,0,0,0
2024-04-22 21:45,59,33,26,0,0,0
2024-04-22 22:00,50,33,17,0,0,0
2024-04-22 22:15,77,41,36,0,0,0
2024-04-22 22:30,54,24,30,0,0,0
2024-04-22 22:45,38,21,17,0,0,0
2024-04-22 23:00,49,15,34,0,0,0
2024-04-22 23:15,26,17,9,0,0,0
2024-04-22 23:30,25,18,7,0,0,0
2024-04-22 23:45,19,9,10,0,0,0
2024-04-23 00:00,18,10,8,0,0,0
2024-04-23 00:15,14,11,3,0,0,0
2024-04-23 00:30,16,13,3,0,0,0
2024-04-23 00:45,10,10,0,0,0,0
2024-04-23 01:00,11,9,2,0,0,0
2024-04-23 01:15,2,2,0,0,0,0
2024-04-23 01:30,10,10,0,0,0,0
2024-04-23 01:45,4,4,0,0,0,0
2024-04-23 02:00,5,4,1,0,0,0
2024-04-23 02:15,6,6,0,0,0,0
2024-04-23 02:30,3,3,0,0,0,0
2024-04-23 02:45,3,3,0,0,0,0
2024-04-23 03:00,6,5,1,0,0,0
2024-04-23 03:15,0,0,0,0,0,0
2024-04-23 03:30,2,1,1,0,0,0
2024-04-23 03:45,3,2,1,0,0,0
2024-04-23 04:00,4,1,3,0,0,0
2024-04-23 04:15,3,2,1,0,0,0
2024-04-23 04:30,3,2,1,0,0,0
2024-04-23 04:45,6,3,3,0,0,0
2024-04-23 05:00,3,3,0,0,0,0
2024-04-23 05:15,15,10,5,0,0,0
2024-04-23 05:30,9,5,4,0,0,0
2024-04-23 05:45,33,12,21,0,0,0
2024-04-23 06:00,22,6,16,0,0,0
2024-04-23 06:15,55,28,27,0,0,0
2024-04-23 06:30,66,21,45,0,0,0
2024-04-23 06:45,96,30,66,0,0,0
2024-04-23 07:00,84,31,53,0,0,0
2024-04-23 07:15,171,58,113,0,0,0
2024-04-23 07:30,295,73,222,0,0,0
2024-04-23 07:45,338,93,245,0,0,0
2024-04-23 08:00,203,65,138,0,0,0
2024-04-23 08:15,216,69,147,0,0,0
2024-04-23 08:30,216,65,151,0,0,0
2024-04-23 08:45,212,74,138,0,0,0
2024-04-23 09:00,139,38,101,0,0,0
2024-04-23 09:15,143,42,101,0,0,0
2024-04-23 09:30,142,43,99,0,0,0
2024-04-23 09:45,225,50,175,0,0,0
2024-04-23 10:00,165,43,122,0,0,0
2024-04-23 10:15,117,46,71,0,0,0
2024-04-23 10:30,122,47,75,0,0,0
2024-04-23 10:45,113,39,74,0,0,0
2024-04-23 11:00,120,56,64,0,0,0
2024-04-23 11:15,130,52,78,0,0,0
2024-04-23 11:30,131,52,79,0,0,0
2024-04-23 11:45,166,66,100,0,0,0
2024-04-23 12:00,174,74,100,0,0,0
2024-04-23 12:15,137,69,68,0,0,0
2024-04-23 12:30,160,88,72,0,0,0
2024-04-23 12:45,138,69,69,0,0,0
2024-04-23 13:00,191,91,100,0,0,0
2024-04-23 13:15,177,91,86,0,0,0
2024-04-23 13:30,151,67,84,0,0,0
2024-04-23 13:45,212,111,101,0,0,0
2024-04-23 14:00,188,103,85,0,0,0
2024-04-23 14:15,188,98,90,0,0,0
2024-04-23 14:30,128,59,69,0,0,0
2024-04-23 14:45,194,91,103,0,0,0
2024-04-23 15:00,174,84,90,0,0,0
2024-04-23 15:15,173,93,80,0,0,0
2024-04-23 15:30,209,96,113,0,0,0
2024-04-23 15:45,261,134,127,0,0,0
2024-04-23 16:00,232,130,102,0,0,0
2024-04-23 16:15,221,134,87,0,0,0
2024-04-23 16:30,229,127,102,0,0,0
2024-04-23 16:45,254,125,129,0,0,0
2024-04-23 17:00,255,142,113,0,0,0
2024-04-23 17:15,246,122,124,0,0,0
2024-04-23 17:30,269,143,126,0,0,0
2024-04-23 17:45,267,161,106,0,0,0
2024-04-23 18:00,285,177,108,0,0,0
2024-04-23 18:15,236,141,95,0,0,0
2024-04-23 18:30,216,127,89,0,0,0
2024-04-23 18:45,215,121,94,0,0,0
2024-04-23 19:00,190,115,75,0,0,0
2024-04-23 19:15,134,74,60,0,0,0
2024-04-23 19:30,148,80,68,0,0,0
2024-04-23 19:45,168,99,69,0,0,0
2024-04-23 20:00,148,94,54,0,0,0
2024-04-23 20:15,126,72,54,0,0,0
2024-04-23 20:30,96,52,44,0,0,0
2024-04-23 20:45,79,37,42,0,0,0
2024-04-23 21:00,80,42,38,0,0,0
2024-04-23 21:15,88,40,48,0,0,0
2024-04-23 21:30,92,53,39,0,0,0
2024-04-23 21:45,78,44,34,0,0,0
2024-04-23 22:00,80,29,51,0,0,0
2024-04-23 22:15,69,32,37,0,0,0
2024-04-23 22:30,89,51,38,0,0,0
2024-04-23 22:45,41,21,20,0,0,0
2024-04-23 23:00,42,23,19,0,0,0
2024-04-23 23:15,37,15,22,0,0,0
2024-04-23 23:30,23,14,9,0,0,0
2024-04-23 23:45,12,3,9,0,0,0
