Datetime,100031300 (Hafenstraße),101031300 (Hafenstraße Fahrräder IN),102031300 (Hafenstraße Fahrräder OUT),100031300-status,101031300-status,102031300-status
2023-12-01 00:00,37,4,33,0,0,0
2023-12-01 00:15,16,2,14,0,0,0
2023-12-01 00:30,5,2,3,0,0,0
2023-12-01 00:45,9,3,6,0,0,0
2023-12-01 01:00,8,2,6,0,0,0
2023-12-01 01:15,2,0,2,0,0,0
2023-12-01 01:30,8,2,6,0,0,0
2023-12-01 01:45,16,8,8,0,0,0
2023-12-01 02:00,5,3,2,0,0,0
2023-12-01 02:15,10,5,5,0,0,0
2023-12-01 02:30,3,1,2,0,0,0
2023-12-01 02:45,1,0,1,0,0,0
2023-12-01 03:00,1,1,0,0,0,0
2023-12-01 03:15,0,0,0,0,0,0
2023-12-01 03:30,1,0,1,0,0,0
2023-12-01 03:45,2,1,1,0,0,0
2023-12-01 04:00,2,1,1,0,0,0
2023-12-01 04:15,4,3,1,0,0,0
2023-12-01 04:30,2,1,1,0,0,0
2023-12-01 04:45,4,2,2,0,0,0
2023-12-01 05:00,5,3,2,0,0,0
2023-12-01 05:15,12,4,8,0,0,0
2023-12-01 05:30,17,7,10,0,0,0
2023-12-01 05:45,14,8,6,0,0,0
2023-12-01 06:00,19,3,16,0,0,0
2023-12-01 06:15,41,26,15,0,0,0
2023-12-01 06:30,35,16,19,0,0,0
2023-12-01 06:45,59,35,24,0,0,0
2023-12-01 07:00,60,31,29,0,0,0
2023-12-01 07:15,96,39,57,0,0,0
2023-12-01 07:30,130,52,78,0,0,0
2023-12-01 07:45,151,63,88,0,0,0
2023-12-01 08:00,108,46,62,0,0,0
2023-12-01 08:15,108,49,59,0,0,0
2023-12-01 08:30,107,47,60,0,0,0
2023-12-01 08:45,100,41,59,0,0,0
2023-12-01 09:00,94,26,68,0,0,0
2023-12-01 09:15,82,22,60,0,0,0
2023-12-01 09:30,79,15,64,0,0,0
2023-12-01 09:45,100,38,62,0,0,0
2023-12-01 10:00,83,28,55,0,0,0
2023-12-01 10:15,64,18,46,0,0,0
2023-12-01 10:30,66,21,45,0,0,0
2023-12-01 10:45,87,39,48,0,0,0
2023-12-01 11:00,107,41,66,0,0,0
2023-12-01 11:15,96,41,55,0,0,0
2023-12-01 11:30,102,40,62,0,0,0
2023-12-01 11:45,105,34,71,0,0,0
2023-12-01 12:00,99,35,64,0,0,0
2023-12-01 12:15,114,48,66,0,0,0
2023-12-01 12:30,106,43,63,0,0,0
2023-12-01 12:45,86,31,55,0,0,0
2023-12-01 13:00,118,47,71,0,0,0
2023-12-01 13:15,106,48,58,0,0,0
2023-12-01 13:30,128,48,80,0,0,0
2023-12-01 13:45,122,40,82,0,0,0
2023-12-01 14:00,111,43,68,0,0,0
2023-12-01 14:15,116,48,68,0,0,0
2023-12-01 14:30,81,38,43,0,0,0
2023-12-01 14:45,122,46,76,0,0,0
2023-12-01 15:00,140,45,95,0,0,0
2023-12-01 15:15,117,45,72,0,0,0
2023-12-01 15:30,115,50,65,0,0,0
2023-12-01 15:45,105,51,54,0,0,0
2023-12-01 16:00,91,38,53,0,0,0
2023-12-01 16:15,120,43,77,0,0,0
2023-12-01 16:30,109,46,63,0,0,0
2023-12-01 16:45,122,43,79,0,0,0
2023-12-01 17:00,101,39,62,0,0,0
2023-12-01 17:15,99,49,50,0,0,0
2023-12-01 17:30,78,41,37,0,0,0
2023-12-01 17:45,105,38,67,0,0,0
2023-12-01 18:00,113,47,66,0,0,0
2023-12-01 18:15,108,27,81,0,0,0
2023-12-01 18:30,87,46,41,0,0,0
2023-12-01 18:45,93,37,56,0,0,0
2023-12-01 19:00,93,43,50,0,0,0
2023-12-01 19:15,76,34,42,0,0,0
2023-12-01 19:30,65,38,27,0,0,0
2023-12-01 19:45,102,49,53,0,0,0
2023-12-01 20:00,87,46,41,0,0,0
2023-12-01 20:15,65,17,48,0,0,0
2023-12-01 20:30,69,30,39,0,0,0
2023-12-01 20:45,72,23,49,0,0,0
2023-12-01 21:00,57,23,34,0,0,0
2023-12-01 21:15,55,27,28,0,0,0
2023-12-01 21:30,42,21,21,0,0,0
2023-12-01 21:45,45,18,27,0,0,0
2023-12-01 22:00,74,27,47,0,0,0
2023-12-01 22:15,81,22,59,0,0,0
2023-12-01 22:30,67,21,46,0,0,0
2023-12-01 22:45,51,24,27,0,0,0
2023-12-01 23:00,42,8,34,0,0,0
2023-12-01 23:15,74,20,54,0,0,0
2023-12-01 23:30,54,11,43,0,0,0
2023-12-01 23:45,39,15,24,0,0,0
2023-12-02 00:00,35,13,22,0,0,0
2023-12-02 00:15,32,7,25,0,0,0
2023-12-02 00:30,34,15,19,0,0,0
2023-12-02 00:45,44,24,20,0,0,0
2023-12-02 01:00,38,16,22,0,0,0
2023-12-02 01:15,33,8,25,0,0,0
2023-12-02 01:30,35,13,22,0,0,0
2023-12-02 01:45,35,16,19,0,0,0
2023-12-02 02:00,25,15,10,0,0,0
2023-12-02 02:15,25,3,22,0,0,0
2023-12-02 02:30,12,2,10,0,0,0
2023-12-02 02:45,24,10,14,0,0,0
2023-12-02 03:00,19,6,13,0,0,0
2023-12-02 03:15,26,8,18,0,0,0
2023-12-02 03:30,15,4,11,0,0,0
2023-12-02 03:45,16,3,13,0,0,0
2023-12-02 04:00,20,6,14,0,0,0
2023-12-02 04:15,12,7,5,0,0,0
2023-12-02 04:30,12,8,4,0,0,0
2023-12-02 04:45,8,3,5,0,0,0
2023-12-02 05:00,3,1,2,0,0,0
2023-12-02 05:15,15,2,13,0,0,0
2023-12-02 05:30,16,4,12,0,0,0
2023-12-02 05:45,9,2,7,0,0,0
2023-12-02 06:00,5,3,2,0,0,0
2023-12-02 06:15,11,3,8,0,0,0
2023-12-02 06:30,11,3,8,0,0,0
2023-12-02 06:45,16,6,10,0,0,0
2023-12-02 07:00,6,2,4,0,0,0
2023-12-02 07:15,10,5,5,0,0,0
2023-12-02 07:30,11,7,4,0,0,0
2023-12-02 07:45,17,5,12,0,0,0
2023-12-02 08:00,10,5,5,0,0,0
2023-12-02 08:15,26,9,17,0,0,0
2023-12-02 08:30,29,15,14,0,0,0
2023-12-02 08:45,41,14,27,0,0,0
2023-12-02 09:00,29,14,15,0,0,0
2023-12-02 09:15,42,13,29,0,0,0
2023-12-02 09:30,32,16,16,0,0,0
2023-12-02 09:45,51,19,32,0,0,0
2023-12-02 10:00,57,22,35,0,0,0
2023-12-02 10:15,77,20,57,0,0,0
2023-12-02 10:30,58,21,37,0,0,0
2023-12-02 10:45,83,25,58,0,0,0
2023-12-02 11:00,66,29,37,0,0,0
2023-12-02 11:15,63,18,45,0,0,0
2023-12-02 11:30,59,23,36,0,0,0
2023-12-02 11:45,80,23,57,0,0,0
2023-12-02 12:00,82,20,62,0,0,0
2023-12-02 12:15,81,32,49,0,0,0
2023-12-02 12:30,79,35,44,0,0,0
2023-12-02 12:45,78,25,53,0,0,0
2023-12-02 13:00,84,29,55,0,0,0
2023-12-02 13:15,79,36,43,0,0,0
2023-12-02 13:30,78,37,41,0,0,0
2023-12-02 13:45,86,32,54,0,0,0
2023-12-02 14:00,80,32,48,0,0,0
2023-12-02 14:15,55,24,31,0,0,0
2023-12-02 14:30,70,32,38,0,0,0
2023-12-02 14:45,88,32,56,0,0,0
2023-12-02 15:00,87,33,54,0,0,0
2023-12-02 15:15,91,38,53,0,0,0
2023-12-02 15:30,85,23,62,0,0,0
2023-12-02 15:45,99,51,48,0,0,0
2023-12-02 16:00,81,27,54,0,0,0
2023-12-02 16:15,92,22,70,0,0,0
2023-12-02 16:30,66,30,36,0,0,0
2023-12-02 16:45,78,20,58,0,0,0
2023-12-02 17:00,79,22,57,0,0,0
2023-12-02 17:15,83,33,50,0,0,0
2023-12-02 17:30,92,46,46,0,0,0
2023-12-02 17:45,78,27,51,0,0,0
2023-12-02 18:00,106,49,57,0,0,0
2023-12-02 18:15,93,42,51,0,0,0
2023-12-02 18:30,62,28,34,0,0,0
2023-12-02 18:45,83,32,51,0,0,0
2023-12-02 19:00,93,47,46,0,0,0
2023-12-02 19:15,96,42,54,0,0,0
2023-12-02 19:30,76,30,46,0,0,0
2023-12-02 19:45,79,30,49,0,0,0
2023-12-02 20:00,85,38,47,0,0,0
2023-12-02 20:15,83,24,59,0,0,0
2023-12-02 20:30,80,36,44,0,0,0
2023-12-02 20:45,54,25,29,0,0,0
2023-12-02 21:00,62,27,35,0,0,0
2023-12-02 21:15,46,20,26,0,0,0
2023-12-02 21:30,44,27,17,0,0,0
2023-12-02 21:45,45,11,34,0,0,0
2023-12-02 22:00,45,11,34,0,0,0
2023-12-02 22:15,35,12,23,0,0,0
2023-12-02 22:30,47,26,21,0,0,0
2023-12-02 22:45,43,17,26,0,0,0
2023-12-02 23:00,52,16,36,0,0,0
2023-12-02 23:15,43,21,22,0,0,0
2023-12-02 23:30,54,18,36,0,0,0
2023-12-02 23:45,54,21,33,0,0,0
2023-12-03 00:00,23,10,13,0,0,0
2023-12-03 00:15,38,15,23,0,0,0
2023-12-03 00:30,33,16,17,0,0,0
2023-12-03 00:45,41,20,21,0,0,0
2023-12-03 01:00,31,16,15,0,0,0
2023-12-03 01:15,33,10,23,0,0,0
2023-12-03 01:30,33,11,22,0,0,0
2023-12-03 01:45,28,13,15,0,0,0
2023-12-03 02:00,15,4,11,0,0,0
2023-12-03 02:15,15,3,12,0,0,0
2023-12-03 02:30,13,5,8,0,0,0
2023-12-03 02:45,21,6,15,0,0,0
2023-12-03 03:00,27,9,18,0,0,0
2023-12-03 03:15,14,7,7,0,0,0
2023-12-03 03:30,7,3,4,0,0,0
2023-12-03 03:45,7,1,6,0,0,0
2023-12-03 04:00,13,3,10,0,0,0
2023-12-03 04:15,23,2,21,0,0,0
2023-12-03 04:30,12,1,11,0,0,0
2023-12-03 04:45,11,1,10,0,0,0
2023-12-03 05:00,6,3,3,0,0,0
2023-12-03 05:15,12,1,11,0,0,0
2023-12-03 05:30,6,4,2,0,0,0
2023-12-03 05:45,6,0,6,0,0,0
2023-12-03 06:00,13,6,7,0,0,0
2023-12-03 06:15,8,1,7,0,0,0
2023-12-03 06:30,8,2,6,0,0,0
2023-12-03 06:45,7,1,6,0,0,0
2023-12-03 07:00,4,1,3,0,0,0
2023-12-03 07:15,4,1,3,0,0,0
2023-12-03 07:30,6,2,4,0,0,0
2023-12-03 07:45,4,0,4,0,0,0
2023-12-03 08:00,9,5,4,0,0,0
2023-12-03 08:15,5,2,3,0,0,0
2023-12-03 08:30,3,2,1,0,0,0
2023-12-03 08:45,13,5,8,0,0,0
2023-12-03 09:00,19,3,16,0,0,0
2023-12-03 09:15,22,9,13,0,0,0
2023-12-03 09:30,36,10,26,0,0,0
2023-12-03 09:45,55,16,39,0,0,0
2023-12-03 10:00,37,13,24,0,0,0
2023-12-03 10:15,36,10,26,0,0,0
2023-12-03 10:30,35,13,22,0,0,0
2023-12-03 10:45,54,20,34,0,0,0
2023-12-03 11:00,49,12,37,0,0,0
2023-12-03 11:15,52,10,42,0,0,0
2023-12-03 11:30,31,7,24,0,0,0
2023-12-03 11:45,50,19,31,0,0,0
2023-12-03 12:00,71,13,58,0,0,0
2023-12-03 12:15,56,16,40,0,0,0
2023-12-03 12:30,54,22,32,0,0,0
2023-12-03 12:45,80,32,48,0,0,0
2023-12-03 13:00,56,16,40,0,0,0
2023-12-03 13:15,61,24,37,0,0,0
2023-12-03 13:30,65,17,48,0,0,0
2023-12-03 13:45,71,26,45,0,0,0
2023-12-03 14:00,72,28,44,0,0,0
2023-12-03 14:15,64,21,43,0,0,0
2023-12-03 14:30,73,16,57,0,0,0
2023-12-03 14:45,77,29,48,0,0,0
2023-12-03 15:00,83,31,52,0,0,0
2023-12-03 15:15,98,34,64,0,0,0
2023-12-03 15:30,73,22,51,0,0,0
2023-12-03 15:45,66,27,39,0,0,0
2023-12-03 16:00,83,20,63,0,0,0
2023-12-03 16:15,88,37,51,0,0,0
2023-12-03 16:30,80,23,57,0,0,0
2023-12-03 16:45,74,26,48,0,0,0
2023-12-03 17:00,68,19,49,0,0,0
2023-12-03 17:15,59,23,36,0,0,0
2023-12-03 17:30,80,25,55,0,0,0
2023-12-03 17:45,65,28,37,0,0,0
2023-12-03 18:00,75,28,47,0,0,0
2023-12-03 18:15,59,11,48,0,0,0
2023-12-03 18:30,57,24,33,0,0,0
2023-12-03 18:45,74,29,45,0,0,0
2023-12-03 19:00,68,25,43,0,0,0
2023-12-03 19:15,60,21,39,0,0,0
2023-12-03 19:30,62,18,44,0,0,0
2023-12-03 19:45,61,28,33,0,0,0
2023-12-03 20:00,49,29,20,0,0,0
2023-12-03 20:15,71,16,55,0,0,0
2023-12-03 20:30,49,20,29,0,0,0
2023-12-03 20:45,36,11,25,0,0,0
2023-12-03 21:00,25,11,14,0,0,0
2023-12-03 21:15,23,10,13,0,0,0
2023-12-03 21:30,29,9,20,0,0,0
2023-12-03 21:45,29,11,18,0,0,0
2023-12-03 22:00,23,8,15,0,0,0
2023-12-03 22:15,28,4,24,0,0,0
2023-12-03 22:30,18,11,7,0,0,0
2023-12-03 22:45,16,6,10,0,0,0
2023-12-03 23:00,22,6,16,0,0,0
2023-12-03 23:15,15,5,10,0,0,0
2023-12-03 23:30,13,5,8,0,0,0
2023-12-03 23:45,11,3,8,0,0,0
2023-12-04 00:00,6,3,3,0,0,0
2023-12-04 00:15,11,4,7,0,0,0
2023-12-04 00:30,0,0,0,0,0,0
2023-12-04 00:45,9,4,5,0,0,0
2023-12-04 01:00,3,1,2,0,0,0
2023-12-04 01:15,1,1,0,0,0,0
2023-12-04 01:30,2,2,0,0,0,0
2023-12-04 01:45,2,0,2,0,0,0
2023-12-04 02:00,5,1,4,0,0,0
2023-12-04 02:15,6,0,6,0,0,0
2023-12-04 02:30,2,1,1,0,0,0
2023-12-04 02:45,1,0,1,0,0,0
2023-12-04 03:00,3,2,1,0,0,0
2023-12-04 03:15,3,1,2,0,0,0
2023-12-04 03:30,1,0,1,0,0,0
2023-12-04 03:45,3,2,1,0,0,0
2023-12-04 04:00,1,0,1,0,0,0
2023-12-04 04:15,0,0,0,0,0,0
2023-12-04 04:30,1,1,0,0,0,0
2023-12-04 04:45,12,5,7,0,0,0
2023-12-04 05:00,4,1,3,0,0,0
2023-12-04 05:15,7,2,5,0,0,0
2023-12-04 05:30,10,4,6,0,0,0
2023-12-04 05:45,15,11,4,0,0,0
2023-12-04 06:00,23,8,15,0,0,0
2023-12-04 06:15,39,19,20,0,0,0
2023-12-04 06:30,39,16,23,0,0,0
2023-12-04 06:45,42,17,25,0,0,0
2023-12-04 07:00,57,31,26,0,0,0
2023-12-04 07:15,102,37,65,0,0,0
2023-12-04 07:30,120,51,69,0,0,0
2023-12-04 07:45,156,71,85,0,0,0
2023-12-04 08:00,140,58,82,0,0,0
2023-12-04 08:15,136,54,82,0,0,0
2023-12-04 08:30,130,51,79,0,0,0
2023-12-04 08:45,99,41,58,0,0,0
2023-12-04 09:00,104,50,54,0,0,0
2023-12-04 09:15,80,30,50,0,0,0
2023-12-04 09:30,83,28,55,0,0,0
2023-12-04 09:45,106,30,76,0,0,0
2023-12-04 10:00,113,32,81,0,0,0
2023-12-04 10:15,82,25,57,0,0,0
2023-12-04 10:30,59,21,38,0,0,0
2023-12-04 10:45,73,20,53,0,0,0
2023-12-04 11:00,70,24,46,0,0,0
2023-12-04 11:15,64,14,50,0,0,0
2023-12-04 11:30,76,23,53,0,0,0
2023-12-04 11:45,106,41,65,0,0,0
2023-12-04 12:00,108,33,75,0,0,0
2023-12-04 12:15,79,29,50,0,0,0
2023-12-04 12:30,95,43,52,0,0,0
2023-12-04 12:45,106,37,69,0,0,0
2023-12-04 13:00,92,40,52,0,0,0
2023-12-04 13:15,91,33,58,0,0,0
2023-12-04 13:30,79,24,55,0,0,0
2023-12-04 13:45,126,47,79,0,0,0
2023-12-04 14:00,127,60,67,0,0,0
2023-12-04 14:15,101,30,71,0,0,0
2023-12-04 14:30,85,36,49,0,0,0
2023-12-04 14:45,92,34,58,0,0,0
2023-12-04 15:00,134,46,88,0,0,0
2023-12-04 15:15,96,33,63,0,0,0
2023-12-04 15:30,110,60,50,0,0,0
2023-12-04 15:45,124,70,54,0,0,0
2023-12-04 16:00,137,62,75,0,0,0
2023-12-04 16:15,147,54,93,0,0,0
2023-12-04 16:30,133,51,82,0,0,0
2023-12-04 16:45,136,41,95,0,0,0
2023-12-04 17:00,117,41,76,0,0,0
2023-12-04 17:15,129,51,78,0,0,0
2023-12-04 17:30,126,53,73,0,0,0
2023-12-04 17:45,140,64,76,0,0,0
2023-12-04 18:00,146,60,86,0,0,0
2023-12-04 18:15,100,58,42,0,0,0
2023-12-04 18:30,109,52,57,0,0,0
2023-12-04 18:45,92,43,49,0,0,0
2023-12-04 19:00,104,58,46,0,0,0
2023-12-04 19:15,94,35,59,0,0,0
2023-12-04 19:30,78,33,45,0,0,0
2023-12-04 19:45,103,55,48,0,0,0
2023-12-04 20:00,78,41,37,0,0,0
2023-12-04 20:15,73,38,35,0,0,0
2023-12-04 20:30,47,23,24,0,0,0
2023-12-04 20:45,61,30,31,0,0,0
2023-12-04 21:00,26,12,14,0,0,0
2023-12-04 21:15,45,24,21,0,0,0
2023-12-04 21:30,40,18,22,0,0,0
2023-12-04 21:45,37,16,21,0,0,0
2023-12-04 22:00,41,20,21,0,0,0
2023-12-04 22:15,48,14,34,0,0,0
2023-12-04 22:30,35,15,20,0,0,0
2023-12-04 22:45,36,10,26,0,0,0
2023-12-04 23:00,22,8,14,0,0,0
2023-12-04 23:15,26,15,11,0,0,0
2023-12-04 23:30,20,10,10,0,0,0
2023-12-04 23:45,11,3,8,0,0,0
2023-12-05 00:00,7,2,5,0,0,0
2023-12-05 00:15,6,4,2,0,0,0
2023-12-05 00:30,4,3,1,0,0,0
2023-12-05 00:45,4,1,3,0,0,0
2023-12-05 01:00,5,3,2,0,0,0
2023-12-05 01:15,6,4,2,0,0,0
2023-12-05 01:30,8,4,4,0,0,0
2023-12-05 01:45,3,1,2,0,0,0
2023-12-05 02:00,4,4,0,0,0,0
2023-12-05 02:15,2,1,1,0,0,0
2023-12-05 02:30,1,1,0,0,0,0
2023-12-05 02:45,2,1,1,0,0,0
2023-12-05 03:00,0,0,0,0,0,0
2023-12-05 03:15,0,0,0,0,0,0
2023-12-05 03:30,0,0,0,0,0,0
2023-12-05 03:45,1,0,1,0,0,0
2023-12-05 04:00,0,0,0,0,0,0
2023-12-05 04:15,1,1,0,0,0,0
2023-12-05 04:30,3,1,2,0,0,0
2023-12-05 04:45,5,1,4,0,0,0
2023-12-05 05:00,2,0,2,0,0,0
2023-12-05 05:15,1,1,0,0,0,0
2023-12-05 05:30,9,1,8,0,0,0
2023-12-05 05:45,25,13,12,0,0,0
2023-12-05 06:00,26,12,14,0,0,0
2023-12-05 06:15,29,14,15,0,0,0
2023-12-05 06:30,30,13,17,0,0,0
2023-12-05 06:45,61,28,33,0,0,0
2023-12-05 07:00,76,35,41,0,0,0
2023-12-05 07:15,99,45,54,0,0,0
2023-12-05 07:30,127,48,79,0,0,0
2023-12-05 07:45,183,77,106,0,0,0
2023-12-05 08:00,142,53,89,0,0,0
2023-12-05 08:15,155,61,94,0,0,0
2023-12-05 08:30,122,47,75,0,0,0
2023-12-05 08:45,135,59,76,0,0,0
2023-12-05 09:00,93,37,56,0,0,0
2023-12-05 09:15,78,23,55,0,0,0
2023-12-05 09:30,81,19,62,0,0,0
2023-12-05 09:45,107,27,80,0,0,0
2023-12-05 10:00,114,32,82,0,0,0
2023-12-05 10:15,77,19,58,0,0,0
2023-12-05 10:30,73,21,52,0,0,0
2023-12-05 10:45,77,26,51,0,0,0
2023-12-05 11:00,72,22,50,0,0,0
2023-12-05 11:15,85,33,52,0,0,0
2023-12-05 11:30,101,29,72,0,0,0
2023-12-05 11:45,127,44,83,0,0,0
2023-12-05 12:00,112,52,60,0,0,0
2023-12-05 12:15,96,35,61,0,0,0
2023-12-05 12:30,102,49,53,0,0,0
2023-12-05 12:45,125,44,81,0,0,0
2023-12-05 13:00,104,38,66,0,0,0
2023-12-05 13:15,124,63,61,0,0,0
2023-12-05 13:30,98,45,53,0,0,0
2023-12-05 13:45,131,51,80,0,0,0
2023-12-05 14:00,146,65,81,0,0,0
2023-12-05 14:15,121,58,63,0,0,0
2023-12-05 14:30,82,39,43,0,0,0
2023-12-05 14:45,115,44,71,0,0,0
2023-12-05 15:00,118,36,82,0,0,0
2023-12-05 15:15,104,48,56,0,0,0
2023-12-05 15:30,88,42,46,0,0,0
2023-12-05 15:45,121,56,65,0,0,0
2023-12-05 16:00,150,82,68,0,0,0
2023-12-05 16:15,156,70,86,0,0,0
2023-12-05 16:30,125,64,61,0,0,0
2023-12-05 16:45,119,49,70,0,0,0
2023-12-05 17:00,132,47,85,0,0,0
2023-12-05 17:15,127,43,84,0,0,0
2023-12-05 17:30,119,46,73,0,0,0
2023-12-05 17:45,195,83,112,0,0,0
2023-12-05 18:00,185,82,103,0,0,0
2023-12-05 18:15,130,59,71,0,0,0
2023-12-05 18:30,124,50,74,0,0,0
2023-12-05 18:45,104,47,57,0,0,0
2023-12-05 19:00,104,59,45,0,0,0
2023-12-05 19:15,109,58,51,0,0,0
2023-12-05 19:30,68,32,36,0,0,0
2023-12-05 19:45,102,51,51,0,0,0
2023-12-05 20:00,101,53,48,0,0,0
2023-12-05 20:15,86,41,45,0,0,0
2023-12-05 20:30,45,23,22,0,0,0
2023-12-05 20:45,67,24,43,0,0,0
2023-12-05 21:00,57,28,29,0,0,0
2023-12-05 21:15,53,23,30,0,0,0
2023-12-05 21:30,56,21,35,0,0,0
2023-12-05 21:45,53,20,33,0,0,0
2023-12-05 22:00,46,25,21,0,0,0
2023-12-05 22:15,59,25,34,0,0,0
2023-12-05 22:30,31,12,19,0,0,0
2023-12-05 22:45,53,22,31,0,0,0
2023-12-05 23:00,41,10,31,0,0,0
2023-12-05 23:15,23,7,16,0,0,0
2023-12-05 23:30,20,6,14,0,0,0
2023-12-05 23:45,11,4,7,0,0,0
2023-12-06 00:00,7,3,4,0,0,0
2023-12-06 00:15,9,5,4,0,0,0
2023-12-06 00:30,12,3,9,0,0,0
2023-12-06 00:45,4,0,4,0,0,0
2023-12-06 01:00,7,2,5,0,0,0
2023-12-06 01:15,4,1,3,0,0,0
2023-12-06 01:30,6,2,4,0,0,0
2023-12-06 01:45,4,2,2,0,0,0
2023-12-06 02:00,4,1,3,0,0,0
2023-12-06 02:15,1,0,1,0,0,0
2023-12-06 02:30,2,0,2,0,0,0
2023-12-06 02:45,0,0,0,0,0,0
2023-12-06 03:00,0,0,0,0,0,0
2023-12-06 03:15,1,0,1,0,0,0
2023-12-06 03:30,4,0,4,0,0,0
2023-12-06 03:45,0,0,0,0,0,0
2023-12-06 04:00,2,1,1,0,0,0
2023-12-06 04:15,1,1,0,0,0,0
2023-12-06 04:30,7,1,6,0,0,0
2023-12-06 04:45,7,5,2,0,0,0
2023-12-06 05:00,3,2,1,0,0,0
2023-12-06 05:15,10,4,6,0,0,0
2023-12-06 05:30,9,2,7,0,0,0
2023-12-06 05:45,22,11,11,0,0,0
2023-12-06 06:00,20,4,16,0,0,0
2023-12-06 06:15,47,19,28,0,0,0
2023-12-06 06:30,43,21,22,0,0,0
2023-12-06 06:45,64,39,25,0,0,0
2023-12-06 07:00,75,32,43,0,0,0
2023-12-06 07:15,93,41,52,0,0,0
2023-12-06 07:30,129,38,91,0,0,0
2023-12-06 07:45,153,68,85,0,0,0
2023-12-06 08:00,153,61,92,0,0,0
2023-12-06 08:15,126,56,70,0,0,0
2023-12-06 08:30,142,64,78,0,0,0
2023-12-06 08:45,145,61,84,0,0,0
2023-12-06 09:00,102,39,63,0,0,0
2023-12-06 09:15,64,17,47,0,0,0
2023-12-06 09:30,69,17,52,0,0,0
2023-12-06 09:45,98,27,71,0,0,0
2023-12-06 10:00,87,17,70,0,0,0
2023-12-06 10:15,78,22,56,0,0,0
2023-12-06 10:30,97,42,55,0,0,0
2023-12-06 10:45,71,19,52,0,0,0
2023-12-06 11:00,76,28,48,0,0,0
2023-12-06 11:15,77,29,48,0,0,0
2023-12-06 11:30,82,28,54,0,0,0
2023-12-06 11:45,109,38,71,0,0,0
2023-12-06 12:00,140,45,95,0,0,0
2023-12-06 12:15,102,44,58,0,0,0
2023-12-06 12:30,107,40,67,0,0,0
2023-12-06 12:45,120,56,64,0,0,0
2023-12-06 13:00,95,40,55,0,0,0
2023-12-06 13:15,127,62,65,0,0,0
2023-12-06 13:30,117,39,78,0,0,0
2023-12-06 13:45,116,42,74,0,0,0
2023-12-06 14:00,127,51,76,0,0,0
2023-12-06 14:15,93,40,53,0,0,0
2023-12-06 14:30,87,38,49,0,0,0
2023-12-06 14:45,112,49,63,0,0,0
2023-12-06 15:00,118,55,63,0,0,0
2023-12-06 15:15,105,50,55,0,0,0
2023-12-06 15:30,92,39,53,0,0,0
2023-12-06 15:45,180,93,87,0,0,0
2023-12-06 16:00,156,85,71,0,0,0
2023-12-06 16:15,141,68,73,0,0,0
2023-12-06 16:30,136,61,75,0,0,0
2023-12-06 16:45,137,57,80,0,0,0
2023-12-06 17:00,168,78,90,0,0,0
2023-12-06 17:15,132,51,81,0,0,0
2023-12-06 17:30,164,66,98,0,0,0
2023-12-06 17:45,189,100,89,0,0,0
2023-12-06 18:00,129,65,64,0,0,0
2023-12-06 18:15,168,84,84,0,0,0
2023-12-06 18:30,134,70,64,0,0,0
2023-12-06 18:45,140,72,68,0,0,0
2023-12-06 19:00,101,54,47,0,0,0
2023-12-06 19:15,97,48,49,0,0,0
2023-12-06 19:30,88,45,43,0,0,0
2023-12-06 19:45,105,59,46,0,0,0
2023-12-06 20:00,101,58,43,0,0,0
2023-12-06 20:15,74,38,36,0,0,0
2023-12-06 20:30,75,35,40,0,0,0
2023-12-06 20:45,63,31,32,0,0,0
2023-12-06 21:00,67,36,31,0,0,0
2023-12-06 21:15,68,22,46,0,0,0
2023-12-06 21:30,81,20,61,0,0,0
2023-12-06 21:45,96,27,69,0,0,0
2023-12-06 22:00,89,25,64,0,0,0
2023-12-06 22:15,90,32,58,0,0,0
2023-12-06 22:30,55,20,35,0,0,0
2023-12-06 22:45,37,18,19,0,0,0
2023-12-06 23:00,51,29,22,0,0,0
2023-12-06 23:15,34,22,12,0,0,0
2023-12-06 23:30,25,11,14,0,0,0
2023-12-06 23:45,36,17,19,0,0,0
2023-12-07 00:00,29,12,17,0,0,0
2023-12-07 00:15,27,15,12,0,0,0
2023-12-07 00:30,18,9,9,0,0,0
2023-12-07 00:45,12,5,7,0,0,0
2023-12-07 01:00,17,3,14,0,0,0
2023-12-07 01:15,23,10,13,0,0,0
2023-12-07 01:30,12,6,6,0,0,0
2023-12-07 01:45,13,4,9,0,0,0
2023-12-07 02:00,13,4,9,0,0,0
2023-12-07 02:15,16,6,10,0,0,0
2023-12-07 02:30,4,0,4,0,0,0
2023-12-07 02:45,14,4,10,0,0,0
2023-12-07 03:00,11,0,11,0,0,0
2023-12-07 03:15,4,1,3,0,0,0
2023-12-07 03:30,4,0,4,0,0,0
2023-12-07 03:45,10,2,8,0,0,0
2023-12-07 04:00,12,3,9,0,0,0
2023-12-07 04:15,5,0,5,0,0,0
2023-12-07 04:30,2,1,1,0,0,0
2023-12-07 04:45,3,2,1,0,0,0
2023-12-07 05:00,1,0,1,0,0,0
2023-12-07 05:15,5,2,3,0,0,0
2023-12-07 05:30,11,4,7,0,0,0
2023-12-07 05:45,22,10,12,0,0,0
2023-12-07 06:00,17,9,8,0,0,0
2023-12-07 06:15,44,19,25,0,0,0
2023-12-07 06:30,52,23,29,0,0,0
2023-12-07 06:45,51,25,26,0,0,0
2023-12-07 07:00,62,27,35,0,0,0
2023-12-07 07:15,80,35,45,0,0,0
2023-12-07 07:30,148,67,81,0,0,0
2023-12-07 07:45,171,69,102,0,0,0
2023-12-07 08:00,147,58,89,0,0,0
2023-12-07 08:15,142,63,79,0,0,0
2023-12-07 08:30,138,69,69,0,0,0
2023-12-07 08:45,151,66,85,0,0,0
2023-12-07 09:00,92,33,59,0,0,0
2023-12-07 09:15,104,33,71,0,0,0
2023-12-07 09:30,88,29,59,0,0,0
2023-12-07 09:45,94,23,71,0,0,0
2023-12-07 10:00,87,34,53,0,0,0
2023-12-07 10:15,93,27,66,0,0,0
2023-12-07 10:30,90,36,54,0,0,0
2023-12-07 10:45,90,27,63,0,0,0
2023-12-07 11:00,90,29,61,0,0,0
2023-12-07 11:15,91,40,51,0,0,0
2023-12-07 11:30,107,38,69,0,0,0
2023-12-07 11:45,130,53,77,0,0,0
2023-12-07 12:00,135,61,74,0,0,0
2023-12-07 12:15,122,49,73,0,0,0
2023-12-07 12:30,127,59,68,0,0,0
2023-12-07 12:45,130,41,89,0,0,0
2023-12-07 13:00,141,68,73,0,0,0
2023-12-07 13:15,134,63,71,0,0,0
2023-12-07 13:30,104,42,62,0,0,0
2023-12-07 13:45,134,58,76,0,0,0
2023-12-07 14:00,94,66,28,0,0,0
2023-12-07 14:15,118,56,62,0,0,0
2023-12-07 14:30,123,58,65,0,0,0
2023-12-07 14:45,153,70,83,0,0,0
2023-12-07 15:00,132,65,67,0,0,0
2023-12-07 15:15,124,53,71,0,0,0
2023-12-07 15:30,145,54,91,0,0,0
2023-12-07 15:45,145,77,68,0,0,0
2023-12-07 16:00,170,85,85,0,0,0
2023-12-07 16:15,164,91,73,0,0,0
2023-12-07 16:30,158,72,86,0,0,0
2023-12-07 16:45,178,66,112,0,0,0
2023-12-07 17:00,140,55,85,0,0,0
2023-12-07 17:15,146,48,98,0,0,0
2023-12-07 17:30,147,54,93,0,0,0
2023-12-07 17:45,175,71,104,0,0,0
2023-12-07 18:00,158,62,96,0,0,0
2023-12-07 18:15,165,80,85,0,0,0
2023-12-07 18:30,126,60,66,0,0,0
2023-12-07 18:45,149,75,74,0,0,0
2023-12-07 19:00,115,62,53,0,0,0
2023-12-07 19:15,116,58,58,0,0,0
2023-12-07 19:30,103,61,42,0,0,0
2023-12-07 19:45,120,71,49,0,0,0
2023-12-07 20:00,93,55,38,0,0,0
2023-12-07 20:15,83,46,37,0,0,0
2023-12-07 20:30,90,46,44,0,0,0
2023-12-07 20:45,75,44,31,0,0,0
2023-12-07 21:00,48,21,27,0,0,0
2023-12-07 21:15,43,20,23,0,0,0
2023-12-07 21:30,59,27,32,0,0,0
2023-12-07 21:45,71,37,34,0,0,0
2023-12-07 22:00,69,20,49,0,0,0
2023-12-07 22:15,72,17,55,0,0,0
2023-12-07 22:30,72,19,53,0,0,0
2023-12-07 22:45,68,25,43,0,0,0
2023-12-07 23:00,75,23,52,0,0,0
2023-12-07 23:15,40,16,24,0,0,0
2023-12-07 23:30,41,8,33,0,0,0
2023-12-07 23:45,36,11,25,0,0,0
2023-12-08 00:00,31,12,19,0,0,0
2023-12-08 00:15,21,6,15,0,0,0
2023-12-08 00:30,11,9,2,0,0,0
2023-12-08 00:45,18,11,7,0,0,0
2023-12-08 01:00,8,4,4,0,0,0
2023-12-08 01:15,4,3,1,0,0,0
2023-12-08 01:30,18,6,12,0,0,0
2023-12-08 01:45,6,1,5,0,0,0
2023-12-08 02:00,5,2,3,0,0,0
2023-12-08 02:15,13,2,11,0,0,0
2023-12-08 02:30,6,1,5,0,0,0
2023-12-08 02:45,7,1,6,0,0,0
2023-12-08 03:00,5,2,3,0,0,0
2023-12-08 03:15,6,2,4,0,0,0
2023-12-08 03:30,4,2,2,0,0,0
2023-12-08 03:45,4,1,3,0,0,0
2023-12-08 04:00,2,1,1,0,0,0
2023-12-08 04:15,5,4,1,0,0,0
2023-12-08 04:30,2,0,2,0,0,0
2023-12-08 04:45,4,1,3,0,0,0
2023-12-08 05:00,1,0,1,0,0,0
2023-12-08 05:15,9,5,4,0,0,0
2023-12-08 05:30,16,2,14,0,0,0
2023-12-08 05:45,11,5,6,0,0,0
2023-12-08 06:00,19,9,10,0,0,0
2023-12-08 06:15,27,11,16,0,0,0
2023-12-08 06:30,29,9,20,0,0,0
2023-12-08 06:45,41,18,23,0,0,0
2023-12-08 07:00,73,34,39,0,0,0
2023-12-08 07:15,95,28,67,0,0,0
2023-12-08 07:30,115,35,80,0,0,0
2023-12-08 07:45,158,73,85,0,0,0
2023-12-08 08:00,107,42,65,0,0,0
2023-12-08 08:15,121,48,73,0,0,0
2023-12-08 08:30,114,53,61,0,0,0
2023-12-08 08:45,103,47,56,0,0,0
2023-12-08 09:00,97,43,54,0,0,0
2023-12-08 09:15,89,40,49,0,0,0
2023-12-08 09:30,77,31,46,0,0,0
2023-12-08 09:45,97,36,61,0,0,0
2023-12-08 10:00,97,27,70,0,0,0
2023-12-08 10:15,71,28,43,0,0,0
2023-12-08 10:30,77,24,53,0,0,0
2023-12-08 10:45,72,33,39,0,0,0
2023-12-08 11:00,99,23,76,0,0,0
2023-12-08 11:15,96,31,65,0,0,0
2023-12-08 11:30,90,29,61,0,0,0
2023-12-08 11:45,112,55,57,0,0,0
2023-12-08 12:00,98,32,66,0,0,0
2023-12-08 12:15,97,26,71,0,0,0
2023-12-08 12:30,113,48,65,0,0,0
2023-12-08 12:45,110,39,71,0,0,0
2023-12-08 13:00,114,53,61,0,0,0
2023-12-08 13:15,123,50,73,0,0,0
2023-12-08 13:30,108,33,75,0,0,0
2023-12-08 13:45,129,50,79,0,0,0
2023-12-08 14:00,108,56,52,0,0,0
2023-12-08 14:15,122,61,61,0,0,0
2023-12-08 14:30,117,65,52,0,0,0
2023-12-08 14:45,91,34,57,0,0,0
2023-12-08 15:00,129,57,72,0,0,0
2023-12-08 15:15,132,65,67,0,0,0
2023-12-08 15:30,107,52,55,0,0,0
2023-12-08 15:45,126,71,55,0,0,0
2023-12-08 16:00,115,52,63,0,0,0
2023-12-08 16:15,126,53,73,0,0,0
2023-12-08 16:30,141,51,90,0,0,0
2023-12-08 16:45,128,60,68,0,0,0
2023-12-08 17:00,130,53,77,0,0,0
2023-12-08 17:15,119,56,63,0,0,0
2023-12-08 17:30,125,53,72,0,0,0
2023-12-08 17:45,145,68,77,0,0,0
2023-12-08 18:00,131,68,63,0,0,0
2023-12-08 18:15,125,49,76,0,0,0
2023-12-08 18:30,108,49,59,0,0,0
2023-12-08 18:45,139,74,65,0,0,0
2023-12-08 19:00,110,61,49,0,0,0
2023-12-08 19:15,97,50,47,0,0,0
2023-12-08 19:30,94,61,33,0,0,0
2023-12-08 19:45,100,58,42,0,0,0
2023-12-08 20:00,95,49,46,0,0,0
2023-12-08 20:15,84,37,47,0,0,0
2023-12-08 20:30,73,30,43,0,0,0
2023-12-08 20:45,56,31,25,0,0,0
2023-12-08 21:00,64,34,30,0,0,0
2023-12-08 21:15,75,33,42,0,0,0
2023-12-08 21:30,69,29,40,0,0,0
2023-12-08 21:45,43,12,31,0,0,0
2023-12-08 22:00,69,30,39,0,0,0
2023-12-08 22:15,72,24,48,0,0,0
2023-12-08 22:30,76,27,49,0,0,0
2023-12-08 22:45,75,22,53,0,0,0
2023-12-08 23:00,67,36,31,0,0,0
2023-12-08 23:15,57,33,24,0,0,0
2023-12-08 23:30,53,30,23,0,0,0
2023-12-08 23:45,81,35,46,0,0,0
2023-12-09 00:00,82,48,34,0,0,0
2023-12-09 00:15,65,37,28,0,0,0
2023-12-09 00:30,47,21,26,0,0,0
2023-12-09 00:45,68,27,41,0,0,0
2023-12-09 01:00,46,18,28,0,0,0
2023-12-09 01:15,52,22,30,0,0,0
2023-12-09 01:30,48,19,29,0,0,0
2023-12-09 01:45,26,8,18,0,0,0
2023-12-09 02:00,29,11,18,0,0,0
2023-12-09 02:15,34,11,23,0,0,0
2023-12-09 02:30,26,9,17,0,0,0
2023-12-09 02:45,17,6,11,0,0,0
2023-12-09 03:00,30,9,21,0,0,0
2023-12-09 03:15,19,3,16,0,0,0
2023-12-09 03:30,23,8,15,0,0,0
2023-12-09 03:45,17,3,14,0,0,0
2023-12-09 04:00,24,0,24,0,0,0
2023-12-09 04:15,31,2,29,0,0,0
2023-12-09 04:30,23,8,15,0,0,0
2023-12-09 04:45,14,4,10,0,0,0
2023-12-09 05:00,5,0,5,0,0,0
2023-12-09 05:15,25,3,22,0,0,0
2023-12-09 05:30,22,3,19,0,0,0
2023-12-09 05:45,21,3,18,0,0,0
2023-12-09 06:00,13,2,11,0,0,0
2023-12-09 06:15,18,1,17,0,0,0
2023-12-09 06:30,15,5,10,0,0,0
2023-12-09 06:45,17,7,10,0,0,0
2023-12-09 07:00,17,3,14,0,0,0
2023-12-09 07:15,39,6,33,0,0,0
2023-12-09 07:30,23,8,15,0,0,0
2023-12-09 07:45,32,13,19,0,0,0
2023-12-09 08:00,30,11,19,0,0,0
2023-12-09 08:15,32,15,17,0,0,0
2023-12-09 08:30,39,13,26,0,0,0
2023-12-09 08:45,36,16,20,0,0,0
2023-12-09 09:00,28,12,16,0,0,0
2023-12-09 09:15,52,16,36,0,0,0
2023-12-09 09:30,57,15,42,0,0,0
2023-12-09 09:45,61,18,43,0,0,0
2023-12-09 10:00,52,17,35,0,0,0
2023-12-09 10:15,86,26,60,0,0,0
2023-12-09 10:30,48,20,28,0,0,0
2023-12-09 10:45,62,22,40,0,0,0
2023-12-09 11:00,67,32,35,0,0,0
2023-12-09 11:15,90,33,57,0,0,0
2023-12-09 11:30,86,29,57,0,0,0
2023-12-09 11:45,65,23,42,0,0,0
2023-12-09 12:00,88,38,50,0,0,0
2023-12-09 12:15,92,38,54,0,0,0
2023-12-09 12:30,77,21,56,0,0,0
2023-12-09 12:45,103,39,64,0,0,0
2023-12-09 13:00,85,32,53,0,0,0
2023-12-09 13:15,77,34,43,0,0,0
2023-12-09 13:30,108,49,59,0,0,0
2023-12-09 13:45,96,42,54,0,0,0
2023-12-09 14:00,95,48,47,0,0,0
2023-12-09 14:15,89,38,51,0,0,0
2023-12-09 14:30,79,31,48,0,0,0
2023-12-09 14:45,76,39,37,0,0,0
2023-12-09 15:00,71,17,54,0,0,0
2023-12-09 15:15,82,30,52,0,0,0
2023-12-09 15:30,90,26,64,0,0,0
2023-12-09 15:45,104,53,51,0,0,0
2023-12-09 16:00,90,28,62,0,0,0
2023-12-09 16:15,86,20,66,0,0,0
2023-12-09 16:30,77,33,44,0,0,0
2023-12-09 16:45,63,25,38,0,0,0
2023-12-09 17:00,59,22,37,0,0,0
2023-12-09 17:15,72,26,46,0,0,0
2023-12-09 17:30,72,17,55,0,0,0
2023-12-09 17:45,81,43,38,0,0,0
2023-12-09 18:00,40,29,11,0,0,0
2023-12-09 18:15,67,33,34,0,0,0
2023-12-09 18:30,63,37,26,0,0,0
2023-12-09 18:45,46,17,29,0,0,0
2023-12-09 19:00,71,42,29,0,0,0
2023-12-09 19:15,53,26,27,0,0,0
2023-12-09 19:30,73,28,45,0,0,0
2023-12-09 19:45,54,30,24,0,0,0
2023-12-09 20:00,53,27,26,0,0,0
2023-12-09 20:15,63,30,33,0,0,0
2023-12-09 20:30,55,27,28,0,0,0
2023-12-09 20:45,50,27,23,0,0,0
2023-12-09 21:00,50,20,30,0,0,0
2023-12-09 21:15,36,8,28,0,0,0
2023-12-09 21:30,28,12,16,0,0,0
2023-12-09 21:45,53,19,34,0,0,0
2023-12-09 22:00,54,22,32,0,0,0
2023-12-09 22:15,63,20,43,0,0,0
2023-12-09 22:30,56,22,34,0,0,0
2023-12-09 22:45,44,17,27,0,0,0
2023-12-09 23:00,48,20,28,0,0,0
2023-12-09 23:15,61,23,38,0,0,0
2023-12-09 23:30,50,14,36,0,0,0
2023-12-09 23:45,41,13,28,0,0,0
2023-12-10 00:00,59,29,30,0,0,0
2023-12-10 00:15,24,13,11,0,0,0
2023-12-10 00:30,45,21,24,0,0,0
2023-12-10 00:45,36,18,18,0,0,0
2023-12-10 01:00,32,8,24,0,0,0
2023-12-10 01:15,24,10,14,0,0,0
2023-12-10 01:30,37,21,16,0,0,0
2023-12-10 01:45,40,19,21,0,0,0
2023-12-10 02:00,32,8,24,0,0,0
2023-12-10 02:15,25,8,17,0,0,0
2023-12-10 02:30,19,5,14,0,0,0
2023-12-10 02:45,24,10,14,0,0,0
2023-12-10 03:00,41,10,31,0,0,0
2023-12-10 03:15,12,2,10,0,0,0
2023-12-10 03:30,25,5,20,0,0,0
2023-12-10 03:45,30,1,29,0,0,0
2023-12-10 04:00,20,1,19,0,0,0
2023-12-10 04:15,23,2,21,0,0,0
2023-12-10 04:30,22,1,21,0,0,0
2023-12-10 04:45,11,1,10,0,0,0
2023-12-10 05:00,15,0,15,0,0,0
2023-12-10 05:15,14,2,12,0,0,0
2023-12-10 05:30,9,1,8,0,0,0
2023-12-10 05:45,17,2,15,0,0,0
2023-12-10 06:00,11,1,10,0,0,0
2023-12-10 06:15,6,0,6,0,0,0
2023-12-10 06:30,10,0,10,0,0,0
2023-12-10 06:45,9,2,7,0,0,0
2023-12-10 07:00,2,0,2,0,0,0
2023-12-10 07:15,10,1,9,0,0,0
2023-12-10 07:30,8,1,7,0,0,0
2023-12-10 07:45,11,1,10,0,0,0
2023-12-10 08:00,6,2,4,0,0,0
2023-12-10 08:15,4,2,2,0,0,0
2023-12-10 08:30,2,1,1,0,0,0
2023-12-10 08:45,19,1,18,0,0,0
2023-12-10 09:00,15,5,10,0,0,0
2023-12-10 09:15,20,7,13,0,0,0
2023-12-10 09:30,20,8,12,0,0,0
2023-12-10 09:45,31,11,20,0,0,0
2023-12-10 10:00,37,19,18,0,0,0
2023-12-10 10:15,31,9,22,0,0,0
2023-12-10 10:30,25,11,14,0,0,0
2023-12-10 10:45,49,18,31,0,0,0
2023-12-10 11:00,27,10,17,0,0,0
2023-12-10 11:15,38,13,25,0,0,0
2023-12-10 11:30,49,15,34,0,0,0
2023-12-10 11:45,53,18,35,0,0,0
2023-12-10 12:00,53,16,37,0,0,0
2023-12-10 12:15,48,18,30,0,0,0
2023-12-10 12:30,53,21,32,0,0,0
2023-12-10 12:45,65,29,36,0,0,0
2023-12-10 13:00,64,29,35,0,0,0
2023-12-10 13:15,65,31,34,0,0,0
2023-12-10 13:30,73,23,50,0,0,0
2023-12-10 13:45,75,34,41,0,0,0
2023-12-10 14:00,43,21,22,0,0,0
2023-12-10 14:15,65,21,44,0,0,0
2023-12-10 14:30,62,13,49,0,0,0
2023-12-10 14:45,95,34,61,0,0,0
2023-12-10 15:00,65,14,51,0,0,0
2023-12-10 15:15,67,27,40,0,0,0
2023-12-10 15:30,54,17,37,0,0,0
2023-12-10 15:45,65,23,42,0,0,0
2023-12-10 16:00,76,24,52,0,0,0
2023-12-10 16:15,93,40,53,0,0,0
2023-12-10 16:30,60,23,37,0,0,0
2023-12-10 16:45,62,26,36,0,0,0
2023-12-10 17:00,61,32,29,0,0,0
2023-12-10 17:15,62,27,35,0,0,0
2023-12-10 17:30,74,29,45,0,0,0
2023-12-10 17:45,95,39,56,0,0,0
2023-12-10 18:00,88,34,54,0,0,0
2023-12-10 18:15,74,32,42,0,0,0
2023-12-10 18:30,59,34,25,0,0,0
2023-12-10 18:45,85,34,51,0,0,0
2023-12-10 19:00,86,48,38,0,0,0
2023-12-10 19:15,48,19,29,0,0,0
2023-12-10 19:30,52,18,34,0,0,0
2023-12-10 19:45,64,30,34,0,0,0
2023-12-10 20:00,53,23,30,0,0,0
2023-12-10 20:15,53,27,26,0,0,0
2023-12-10 20:30,33,11,22,0,0,0
2023-12-10 20:45,27,15,12,0,0,0
2023-12-10 21:00,23,14,9,0,0,0
2023-12-10 21:15,32,16,16,0,0,0
2023-12-10 21:30,28,9,19,0,0,0
2023-12-10 21:45,43,18,25,0,0,0
2023-12-10 22:00,34,9,25,0,0,0
2023-12-10 22:15,25,8,17,0,0,0
2023-12-10 22:30,31,6,25,0,0,0
2023-12-10 22:45,29,6,23,0,0,0
2023-12-10 23:00,17,5,12,0,0,0
2023-12-10 23:15,11,1,10,0,0,0
2023-12-10 23:30,11,8,3,0,0,0
2023-12-10 23:45,25,5,20,0,0,0
2023-12-11 00:00,11,1,10,0,0,0
2023-12-11 00:15,6,5,1,0,0,0
2023-12-11 00:30,6,0,6,0,0,0
2023-12-11 00:45,13,3,10,0,0,0
2023-12-11 01:00,2,1,1,0,0,0
2023-12-11 01:15,4,2,2,0,0,0
2023-12-11 01:30,0,0,0,0,0,0
2023-12-11 01:45,4,2,2,0,0,0
2023-12-11 02:00,4,3,1,0,0,0
2023-12-11 02:15,1,0,1,0,0,0
2023-12-11 02:30,6,0,6,0,0,0
2023-12-11 02:45,3,1,2,0,0,0
2023-12-11 03:00,3,2,1,0,0,0
2023-12-11 03:15,0,0,0,0,0,0
2023-12-11 03:30,0,0,0,0,0,0
2023-12-11 03:45,0,0,0,0,0,0
2023-12-11 04:00,2,2,0,0,0,0
2023-12-11 04:15,1,0,1,0,0,0
2023-12-11 04:30,0,0,0,0,0,0
2023-12-11 04:45,5,2,3,0,0,0
2023-12-11 05:00,6,3,3,0,0,0
2023-12-11 05:15,7,3,4,0,0,0
2023-12-11 05:30,17,7,10,0,0,0
2023-12-11 05:45,17,9,8,0,0,0
2023-12-11 06:00,24,9,15,0,0,0
2023-12-11 06:15,46,23,23,0,0,0
2023-12-11 06:30,31,13,18,0,0,0
2023-12-11 06:45,49,30,19,0,0,0
2023-12-11 07:00,54,29,25,0,0,0
2023-12-11 07:15,100,45,55,0,0,0
2023-12-11 07:30,117,41,76,0,0,0
2023-12-11 07:45,160,69,91,0,0,0
2023-12-11 08:00,155,65,90,0,0,0
2023-12-11 08:15,140,68,72,0,0,0
2023-12-11 08:30,129,66,63,0,0,0
2023-12-11 08:45,146,68,78,0,0,0
2023-12-11 09:00,100,42,58,0,0,0
2023-12-11 09:15,105,45,60,0,0,0
2023-12-11 09:30,81,25,56,0,0,0
2023-12-11 09:45,104,40,64,0,0,0
2023-12-11 10:00,87,22,65,0,0,0
2023-12-11 10:15,61,24,37,0,0,0
2023-12-11 10:30,64,17,47,0,0,0
2023-12-11 10:45,82,30,52,0,0,0
2023-12-11 11:00,64,15,49,0,0,0
2023-12-11 11:15,71,19,52,0,0,0
2023-12-11 11:30,76,21,55,0,0,0
2023-12-11 11:45,97,20,77,0,0,0
2023-12-11 12:00,117,43,74,0,0,0
2023-12-11 12:15,99,50,49,0,0,0
2023-12-11 12:30,106,49,57,0,0,0
2023-12-11 12:45,107,32,75,0,0,0
2023-12-11 13:00,109,48,61,0,0,0
2023-12-11 13:15,81,32,49,0,0,0
2023-12-11 13:30,97,45,52,0,0,0
2023-12-11 13:45,127,50,77,0,0,0
2023-12-11 14:00,120,47,73,0,0,0
2023-12-11 14:15,95,39,56,0,0,0
2023-12-11 14:30,95,38,57,0,0,0
2023-12-11 14:45,95,54,41,0,0,0
2023-12-11 15:00,113,48,65,0,0,0
2023-12-11 15:15,106,46,60,0,0,0
2023-12-11 15:30,114,50,64,0,0,0
2023-12-11 15:45,155,81,74,0,0,0
2023-12-11 16:00,123,56,67,0,0,0
2023-12-11 16:15,135,65,70,0,0,0
2023-12-11 16:30,137,53,84,0,0,0
2023-12-11 16:45,136,54,82,0,0,0
2023-12-11 17:00,158,71,87,0,0,0
2023-12-11 17:15,153,65,88,0,0,0
2023-12-11 17:30,163,66,97,0,0,0
2023-12-11 17:45,185,103,82,0,0,0
2023-12-11 18:00,133,60,73,0,0,0
2023-12-11 18:15,169,81,88,0,0,0
2023-12-11 18:30,117,54,63,0,0,0
2023-12-11 18:45,104,53,51,0,0,0
2023-12-11 19:00,106,57,49,0,0,0
2023-12-11 19:15,115,62,53,0,0,0
2023-12-11 19:30,97,56,41,0,0,0
2023-12-11 19:45,105,60,45,0,0,0
2023-12-11 20:00,106,56,50,0,0,0
2023-12-11 20:15,74,34,40,0,0,0
2023-12-11 20:30,72,40,32,0,0,0
2023-12-11 20:45,69,36,33,0,0,0
2023-12-11 21:00,63,34,29,0,0,0
2023-12-11 21:15,57,27,30,0,0,0
2023-12-11 21:30,55,21,34,0,0,0
2023-12-11 21:45,45,19,26,0,0,0
2023-12-11 22:00,60,20,40,0,0,0
2023-12-11 22:15,47,22,25,0,0,0
2023-12-11 22:30,29,13,16,0,0,0
2023-12-11 22:45,57,15,42,0,0,0
2023-12-11 23:00,38,10,28,0,0,0
2023-12-11 23:15,38,9,29,0,0,0
2023-12-11 23:30,15,4,11,0,0,0
2023-12-11 23:45,13,6,7,0,0,0
2023-12-12 00:00,18,7,11,0,0,0
2023-12-12 00:15,15,8,7,0,0,0
2023-12-12 00:30,7,6,1,0,0,0
2023-12-12 00:45,14,4,10,0,0,0
2023-12-12 01:00,2,0,2,0,0,0
2023-12-12 01:15,7,3,4,0,0,0
2023-12-12 01:30,3,0,3,0,0,0
2023-12-12 01:45,1,0,1,0,0,0
2023-12-12 02:00,0,0,0,0,0,0
2023-12-12 02:15,11,7,4,0,0,0
2023-12-12 02:30,1,0,1,0,0,0
2023-12-12 02:45,6,4,2,0,0,0
2023-12-12 03:00,4,1,3,0,0,0
2023-12-12 03:15,1,1,0,0,0,0
2023-12-12 03:30,3,2,1,0,0,0
2023-12-12 03:45,1,0,1,0,0,0
2023-12-12 04:00,5,3,2,0,0,0
2023-12-12 04:15,4,2,2,0,0,0
2023-12-12 04:30,2,1,1,0,0,0
2023-12-12 04:45,12,4,8,0,0,0
2023-12-12 05:00,1,0,1,0,0,0
2023-12-12 05:15,14,7,7,0,0,0
2023-12-12 05:30,17,4,13,0,0,0
2023-12-12 05:45,24,13,11,0,0,0
2023-12-12 06:00,26,15,11,0,0,0
2023-12-12 06:15,46,19,27,0,0,0
2023-12-12 06:30,51,22,29,0,0,0
2023-12-12 06:45,54,30,24,0,0,0
2023-12-12 07:00,80,42,38,0,0,0
2023-12-12 07:15,117,54,63,0,0,0
2023-12-12 07:30,171,68,103,0,0,0
2023-12-12 07:45,172,80,92,0,0,0
2023-12-12 08:00,200,92,108,0,0,0
2023-12-12 08:15,167,68,99,0,0,0
2023-12-12 08:30,143,64,79,0,0,0
2023-12-12 08:45,139,58,81,0,0,0
2023-12-12 09:00,99,39,60,0,0,0
2023-12-12 09:15,74,35,39,0,0,0
2023-12-12 09:30,100,30,70,0,0,0
2023-12-12 09:45,128,49,79,0,0,0
2023-12-12 10:00,102,29,73,0,0,0
2023-12-12 10:15,96,48,48,0,0,0
2023-12-12 10:30,74,25,49,0,0,0
2023-12-12 10:45,83,42,41,0,0,0
2023-12-12 11:00,65,27,38,0,0,0
2023-12-12 11:15,86,35,51,0,0,0
2023-12-12 11:30,81,30,51,0,0,0
2023-12-12 11:45,111,39,72,0,0,0
2023-12-12 12:00,134,60,74,0,0,0
2023-12-12 12:15,115,57,58,0,0,0
2023-12-12 12:30,117,65,52,0,0,0
2023-12-12 12:45,114,43,71,0,0,0
2023-12-12 13:00,145,70,75,0,0,0
2023-12-12 13:15,114,48,66,0,0,0
2023-12-12 13:30,126,51,75,0,0,0
2023-12-12 13:45,161,72,89,0,0,0
2023-12-12 14:00,165,86,79,0,0,0
2023-12-12 14:15,119,67,52,0,0,0
2023-12-12 14:30,101,49,52,0,0,0
2023-12-12 14:45,104,42,62,0,0,0
2023-12-12 15:00,122,63,59,0,0,0
2023-12-12 15:15,113,53,60,0,0,0
2023-12-12 15:30,121,65,56,0,0,0
2023-12-12 15:45,150,65,85,0,0,0
2023-12-12 16:00,150,79,71,0,0,0
2023-12-12 16:15,163,70,93,0,0,0
2023-12-12 16:30,142,72,70,0,0,0
2023-12-12 16:45,144,53,91,0,0,0
2023-12-12 17:00,151,66,85,0,0,0
2023-12-12 17:15,149,57,92,0,0,0
2023-12-12 17:30,136,54,82,0,0,0
2023-12-12 17:45,157,83,74,0,0,0
2023-12-12 18:00,145,63,82,0,0,0
2023-12-12 18:15,128,66,62,0,0,0
2023-12-12 18:30,93,44,49,0,0,0
2023-12-12 18:45,98,59,39,0,0,0
2023-12-12 19:00,100,58,42,0,0,0
2023-12-12 19:15,116,68,48,0,0,0
2023-12-12 19:30,80,46,34,0,0,0
2023-12-12 19:45,99,55,44,0,0,0
2023-12-12 20:00,77,42,35,0,0,0
2023-12-12 20:15,76,35,41,0,0,0
2023-12-12 20:30,59,32,27,0,0,0
2023-12-12 20:45,62,28,34,0,0,0
2023-12-12 21:00,54,25,29,0,0,0
2023-12-12 21:15,50,20,30,0,0,0
2023-12-12 21:30,50,21,29,0,0,0
2023-12-12 21:45,59,31,28,0,0,0
2023-12-12 22:00,44,19,25,0,0,0
2023-12-12 22:15,69,25,44,0,0,0
2023-12-12 22:30,51,22,29,0,0,0
2023-12-12 22:45,67,20,47,0,0,0
2023-12-12 23:00,49,16,33,0,0,0
2023-12-12 23:15,27,20,7,0,0,0
2023-12-12 23:30,26,14,12,0,0,0
2023-12-12 23:45,20,4,16,0,0,0
2023-12-13 00:00,9,2,7,0,0,0
2023-12-13 00:15,15,7,8,0,0,0
2023-12-13 00:30,9,5,4,0,0,0
2023-12-13 00:45,6,3,3,0,0,0
2023-12-13 01:00,2,1,1,0,0,0
2023-12-13 01:15,11,4,7,0,0,0
2023-12-13 01:30,12,8,4,0,0,0
2023-12-13 01:45,4,0,4,0,0,0
2023-12-13 02:00,6,3,3,0,0,0
2023-12-13 02:15,2,0,2,0,0,0
2023-12-13 02:30,1,0,1,0,0,0
2023-12-13 02:45,1,1,0,0,0,0
2023-12-13 03:00,2,0,2,0,0,0
2023-12-13 03:15,2,1,1,0,0,0
2023-12-13 03:30,3,1,2,0,0,0
2023-12-13 03:45,3,2,1,0,0,0
2023-12-13 04:00,2,1,1,0,0,0
2023-12-13 04:15,2,1,1,0,0,0
2023-12-13 04:30,4,1,3,0,0,0
2023-12-13 04:45,6,1,5,0,0,0
2023-12-13 05:00,2,2,0,0,0,0
2023-12-13 05:15,14,7,7,0,0,0
2023-12-13 05:30,10,4,6,0,0,0
2023-12-13 05:45,10,5,5,0,0,0
2023-12-13 06:00,24,9,15,0,0,0
2023-12-13 06:15,41,16,25,0,0,0
2023-12-13 06:30,33,11,22,0,0,0
2023-12-13 06:45,74,39,35,0,0,0
2023-12-13 07:00,71,40,31,0,0,0
2023-12-13 07:15,111,41,70,0,0,0
2023-12-13 07:30,140,49,91,0,0,0
2023-12-13 07:45,174,92,82,0,0,0
2023-12-13 08:00,135,48,87,0,0,0
2023-12-13 08:15,136,73,63,0,0,0
2023-12-13 08:30,152,84,68,0,0,0
2023-12-13 08:45,152,72,80,0,0,0
2023-12-13 09:00,110,49,61,0,0,0
2023-12-13 09:15,89,34,55,0,0,0
2023-12-13 09:30,86,32,54,0,0,0
2023-12-13 09:45,129,45,84,0,0,0
2023-12-13 10:00,95,29,66,0,0,0
2023-12-13 10:15,71,25,46,0,0,0
2023-12-13 10:30,82,35,47,0,0,0
2023-12-13 10:45,76,23,53,0,0,0
2023-12-13 11:00,86,25,61,0,0,0
2023-12-13 11:15,75,27,48,0,0,0
2023-12-13 11:30,98,21,77,0,0,0
2023-12-13 11:45,110,40,70,0,0,0
2023-12-13 12:00,126,47,79,0,0,0
2023-12-13 12:15,108,45,63,0,0,0
2023-12-13 12:30,89,40,49,0,0,0
2023-12-13 12:45,76,26,50,0,0,0
2023-12-13 13:00,96,37,59,0,0,0
2023-12-13 13:15,125,55,70,0,0,0
2023-12-13 13:30,87,35,52,0,0,0
2023-12-13 13:45,120,48,72,0,0,0
2023-12-13 14:00,111,54,57,0,0,0
2023-12-13 14:15,110,52,58,0,0,0
2023-12-13 14:30,78,34,44,0,0,0
2023-12-13 14:45,113,42,71,0,0,0
2023-12-13 15:00,94,33,61,0,0,0
2023-12-13 15:15,107,51,56,0,0,0
2023-12-13 15:30,137,61,76,0,0,0
2023-12-13 15:45,145,66,79,0,0,0
2023-12-13 16:00,160,84,76,0,0,0
2023-12-13 16:15,136,57,79,0,0,0
2023-12-13 16:30,117,54,63,0,0,0
2023-12-13 16:45,156,72,84,0,0,0
2023-12-13 17:00,139,53,86,0,0,0
2023-12-13 17:15,160,73,87,0,0,0
2023-12-13 17:30,140,56,84,0,0,0
2023-12-13 17:45,174,81,93,0,0,0
2023-12-13 18:00,168,88,80,0,0,0
2023-12-13 18:15,152,61,91,0,0,0
2023-12-13 18:30,129,56,73,0,0,0
2023-12-13 18:45,117,59,58,0,0,0
2023-12-13 19:00,106,59,47,0,0,0
2023-12-13 19:15,103,53,50,0,0,0
2023-12-13 19:30,104,61,43,0,0,0
2023-12-13 19:45,113,75,38,0,0,0
2023-12-13 20:00,99,52,47,0,0,0
2023-12-13 20:15,101,57,44,0,0,0
2023-12-13 20:30,69,40,29,0,0,0
2023-12-13 20:45,66,31,35,0,0,0
2023-12-13 21:00,54,33,21,0,0,0
2023-12-13 21:15,47,26,21,0,0,0
2023-12-13 21:30,57,32,25,0,0,0
2023-12-13 21:45,48,21,27,0,0,0
2023-12-13 22:00,58,26,32,0,0,0
2023-12-13 22:15,58,31,27,0,0,0
2023-12-13 22:30,48,26,22,0,0,0
2023-12-13 22:45,68,16,52,0,0,0
2023-12-13 23:00,49,31,18,0,0,0
2023-12-13 23:15,38,23,15,0,0,0
2023-12-13 23:30,43,22,21,0,0,0
2023-12-13 23:45,67,50,17,0,0,0
2023-12-14 00:00,42,29,13,0,0,0
2023-12-14 00:15,63,41,22,0,0,0
2023-12-14 00:30,42,39,3,0,0,0
2023-12-14 00:45,28,16,12,0,0,0
2023-12-14 01:00,40,21,19,0,0,0
2023-12-14 01:15,22,13,9,0,0,0
2023-12-14 01:30,18,2,16,0,0,0
2023-12-14 01:45,10,1,9,0,0,0
2023-12-14 02:00,30,5,25,0,0,0
2023-12-14 02:15,25,3,22,0,0,0
2023-12-14 02:30,37,0,37,0,0,0
2023-12-14 02:45,36,2,34,0,0,0
2023-12-14 03:00,33,0,33,0,0,0
2023-12-14 03:15,25,0,25,0,0,0
2023-12-14 03:30,26,3,23,0,0,0
2023-12-14 03:45,34,4,30,0,0,0
2023-12-14 04:00,37,4,33,0,0,0
2023-12-14 04:15,28,4,24,0,0,0
2023-12-14 04:30,12,3,9,0,0,0
2023-12-14 04:45,26,4,22,0,0,0
2023-12-14 05:00,5,0,5,0,0,0
2023-12-14 05:15,23,9,14,0,0,0
2023-12-14 05:30,30,4,26,0,0,0
2023-12-14 05:45,25,7,18,0,0,0
2023-12-14 06:00,17,7,10,0,0,0
2023-12-14 06:15,49,18,31,0,0,0
2023-12-14 06:30,44,20,24,0,0,0
2023-12-14 06:45,63,35,28,0,0,0
2023-12-14 07:00,86,45,41,0,0,0
2023-12-14 07:15,117,55,62,0,0,0
2023-12-14 07:30,135,56,79,0,0,0
2023-12-14 07:45,150,65,85,0,0,0
2023-12-14 08:00,155,63,92,0,0,0
2023-12-14 08:15,155,66,89,0,0,0
2023-12-14 08:30,135,67,68,0,0,0
2023-12-14 08:45,153,64,89,0,0,0
2023-12-14 09:00,99,43,56,0,0,0
2023-12-14 09:15,67,23,44,0,0,0
2023-12-14 09:30,90,30,60,0,0,0
2023-12-14 09:45,129,42,87,0,0,0
2023-12-14 10:00,90,30,60,0,0,0
2023-12-14 10:15,82,28,54,0,0,0
2023-12-14 10:30,80,18,62,0,0,0
2023-12-14 10:45,94,33,61,0,0,0
2023-12-14 11:00,77,33,44,0,0,0
2023-12-14 11:15,95,41,54,0,0,0
2023-12-14 11:30,81,33,48,0,0,0
2023-12-14 11:45,118,47,71,0,0,0
2023-12-14 12:00,122,47,75,0,0,0
2023-12-14 12:15,111,42,69,0,0,0
2023-12-14 12:30,118,51,67,0,0,0
2023-12-14 12:45,130,59,71,0,0,0
2023-12-14 13:00,116,59,57,0,0,0
2023-12-14 13:15,117,49,68,0,0,0
2023-12-14 13:30,115,33,82,0,0,0
2023-12-14 13:45,145,61,84,0,0,0
2023-12-14 14:00,129,63,66,0,0,0
2023-12-14 14:15,124,55,69,0,0,0
2023-12-14 14:30,118,48,70,0,0,0
2023-12-14 14:45,118,48,70,0,0,0
2023-12-14 15:00,131,69,62,0,0,0
2023-12-14 15:15,137,53,84,0,0,0
2023-12-14 15:30,145,66,79,0,0,0
2023-12-14 15:45,162,83,79,0,0,0
2023-12-14 16:00,167,95,72,0,0,0
2023-12-14 16:15,147,66,81,0,0,0
2023-12-14 16:30,162,71,91,0,0,0
2023-12-14 16:45,141,67,74,0,0,0
2023-12-14 17:00,152,76,76,0,0,0
2023-12-14 17:15,166,73,93,0,0,0
2023-12-14 17:30,170,69,101,0,0,0
2023-12-14 17:45,169,85,84,0,0,0
2023-12-14 18:00,190,97,93,0,0,0
2023-12-14 18:15,167,86,81,0,0,0
2023-12-14 18:30,139,70,69,0,0,0
2023-12-14 18:45,138,74,64,0,0,0
2023-12-14 19:00,93,40,53,0,0,0
2023-12-14 19:15,121,68,53,0,0,0
2023-12-14 19:30,116,60,56,0,0,0
2023-12-14 19:45,120,85,35,0,0,0
2023-12-14 20:00,104,64,40,0,0,0
2023-12-14 20:15,73,40,33,0,0,0
2023-12-14 20:30,70,35,35,0,0,0
2023-12-14 20:45,56,29,27,0,0,0
2023-12-14 21:00,64,31,33,0,0,0
2023-12-14 21:15,80,39,41,0,0,0
2023-12-14 21:30,70,31,39,0,0,0
2023-12-14 21:45,52,27,25,0,0,0
2023-12-14 22:00,57,35,22,0,0,0
2023-12-14 22:15,97,31,66,0,0,0
2023-12-14 22:30,42,17,25,0,0,0
2023-12-14 22:45,56,13,43,0,0,0
2023-12-14 23:00,57,27,30,0,0,0
2023-12-14 23:15,33,16,17,0,0,0
2023-12-14 23:30,42,11,31,0,0,0
2023-12-14 23:45,18,12,6,0,0,0
2023-12-15 00:00,34,14,20,0,0,0
2023-12-15 00:15,20,8,12,0,0,0
2023-12-15 00:30,21,4,17,0,0,0
2023-12-15 00:45,15,6,9,0,0,0
2023-12-15 01:00,19,3,16,0,0,0
2023-12-15 01:15,13,5,8,0,0,0
2023-12-15 01:30,10,1,9,0,0,0
2023-12-15 01:45,12,4,8,0,0,0
2023-12-15 02:00,11,3,8,0,0,0
2023-12-15 02:15,13,6,7,0,0,0
2023-12-15 02:30,11,2,9,0,0,0
2023-12-15 02:45,10,1,9,0,0,0
2023-12-15 03:00,3,0,3,0,0,0
2023-12-15 03:15,1,1,0,0,0,0
2023-12-15 03:30,3,1,2,0,0,0
2023-12-15 03:45,4,3,1,0,0,0
2023-12-15 04:00,1,0,1,0,0,0
2023-12-15 04:15,1,0,1,0,0,0
2023-12-15 04:30,4,0,4,0,0,0
2023-12-15 04:45,3,1,2,0,0,0
2023-12-15 05:00,1,0,1,0,0,0
2023-12-15 05:15,13,6,7,0,0,0
2023-12-15 05:30,14,8,6,0,0,0
2023-12-15 05:45,17,5,12,0,0,0
2023-12-15 06:00,24,12,12,0,0,0
2023-12-15 06:15,25,10,15,0,0,0
2023-12-15 06:30,48,24,24,0,0,0
2023-12-15 06:45,49,30,19,0,0,0
2023-12-15 07:00,72,36,36,0,0,0
2023-12-15 07:15,83,38,45,0,0,0
2023-12-15 07:30,127,40,87,0,0,0
2023-12-15 07:45,155,68,87,0,0,0
2023-12-15 08:00,150,83,67,0,0,0
2023-12-15 08:15,126,65,61,0,0,0
2023-12-15 08:30,114,47,67,0,0,0
2023-12-15 08:45,130,70,60,0,0,0
2023-12-15 09:00,88,39,49,0,0,0
2023-12-15 09:15,91,27,64,0,0,0
2023-12-15 09:30,87,30,57,0,0,0
2023-12-15 09:45,102,35,67,0,0,0
2023-12-15 10:00,90,29,61,0,0,0
2023-12-15 10:15,83,33,50,0,0,0
2023-12-15 10:30,90,35,55,0,0,0
2023-12-15 10:45,93,43,50,0,0,0
2023-12-15 11:00,83,34,49,0,0,0
2023-12-15 11:15,89,42,47,0,0,0
2023-12-15 11:30,103,47,56,0,0,0
2023-12-15 11:45,121,40,81,0,0,0
2023-12-15 12:00,111,39,72,0,0,0
2023-12-15 12:15,102,38,64,0,0,0
2023-12-15 12:30,135,48,87,0,0,0
2023-12-15 12:45,148,67,81,0,0,0
2023-12-15 13:00,112,54,58,0,0,0
2023-12-15 13:15,143,61,82,0,0,0
2023-12-15 13:30,127,49,78,0,0,0
2023-12-15 13:45,116,52,64,0,0,0
2023-12-15 14:00,112,44,68,0,0,0
2023-12-15 14:15,128,52,76,0,0,0
2023-12-15 14:30,100,47,53,0,0,0
2023-12-15 14:45,118,58,60,0,0,0
2023-12-15 15:00,147,75,72,0,0,0
2023-12-15 15:15,127,55,72,0,0,0
2023-12-15 15:30,143,65,78,0,0,0
2023-12-15 15:45,151,58,93,0,0,0
2023-12-15 16:00,146,45,101,0,0,0
2023-12-15 16:15,124,61,63,0,0,0
2023-12-15 16:30,122,67,55,0,0,0
2023-12-15 16:45,126,52,74,0,0,0
2023-12-15 17:00,115,56,59,0,0,0
2023-12-15 17:15,137,64,73,0,0,0
2023-12-15 17:30,136,50,86,0,0,0
2023-12-15 17:45,129,62,67,0,0,0
2023-12-15 18:00,128,57,71,0,0,0
2023-12-15 18:15,115,49,66,0,0,0
2023-12-15 18:30,118,64,54,0,0,0
2023-12-15 18:45,105,65,40,0,0,0
2023-12-15 19:00,111,48,63,0,0,0
2023-12-15 19:15,100,51,49,0,0,0
2023-12-15 19:30,87,39,48,0,0,0
2023-12-15 19:45,81,46,35,0,0,0
2023-12-15 20:00,75,41,34,0,0,0
2023-12-15 20:15,91,51,40,0,0,0
2023-12-15 20:30,85,38,47,0,0,0
2023-12-15 20:45,69,38,31,0,0,0
2023-12-15 21:00,74,33,41,0,0,0
2023-12-15 21:15,73,41,32,0,0,0
2023-12-15 21:30,69,51,18,0,0,0
2023-12-15 21:45,44,20,24,0,0,0
2023-12-15 22:00,50,31,19,0,0,0
2023-12-15 22:15,69,23,46,0,0,0
2023-12-15 22:30,76,26,50,0,0,0
2023-12-15 22:45,80,32,48,0,0,0
2023-12-15 23:00,77,22,55,0,0,0
2023-12-15 23:15,39,13,26,0,0,0
2023-12-15 23:30,51,14,37,0,0,0
2023-12-15 23:45,76,51,25,0,0,0
2023-12-16 00:00,52,20,32,0,0,0
2023-12-16 00:15,62,35,27,0,0,0
2023-12-16 00:30,42,23,19,0,0,0
2023-12-16 00:45,67,43,24,0,0,0
2023-12-16 01:00,39,19,20,0,0,0
2023-12-16 01:15,68,44,24,0,0,0
2023-12-16 01:30,54,21,33,0,0,0
2023-12-16 01:45,43,19,24,0,0,0
2023-12-16 02:00,20,9,11,0,0,0
2023-12-16 02:15,32,15,17,0,0,0
2023-12-16 02:30,32,6,26,0,0,0
2023-12-16 02:45,17,2,15,0,0,0
2023-12-16 03:00,38,15,23,0,0,0
2023-12-16 03:15,35,10,25,0,0,0
2023-12-16 03:30,49,9,40,0,0,0
2023-12-16 03:45,46,5,41,0,0,0
2023-12-16 04:00,26,4,22,0,0,0
2023-12-16 04:15,33,6,27,0,0,0
2023-12-16 04:30,24,8,16,0,0,0
2023-12-16 04:45,17,2,15,0,0,0
2023-12-16 05:00,8,0,8,0,0,0
2023-12-16 05:15,20,0,20,0,0,0
2023-12-16 05:30,18,3,15,0,0,0
2023-12-16 05:45,22,4,18,0,0,0
2023-12-16 06:00,8,3,5,0,0,0
2023-12-16 06:15,9,7,2,0,0,0
2023-12-16 06:30,6,2,4,0,0,0
2023-12-16 06:45,15,8,7,0,0,0
2023-12-16 07:00,19,6,13,0,0,0
2023-12-16 07:15,14,4,10,0,0,0
2023-12-16 07:30,19,8,11,0,0,0
2023-12-16 07:45,21,7,14,0,0,0
2023-12-16 08:00,22,8,14,0,0,0
2023-12-16 08:15,29,15,14,0,0,0
2023-12-16 08:30,19,6,13,0,0,0
2023-12-16 08:45,42,16,26,0,0,0
2023-12-16 09:00,45,14,31,0,0,0
2023-12-16 09:15,54,21,33,0,0,0
2023-12-16 09:30,44,17,27,0,0,0
2023-12-16 09:45,57,25,32,0,0,0
2023-12-16 10:00,63,30,33,0,0,0
2023-12-16 10:15,66,27,39,0,0,0
2023-12-16 10:30,70,28,42,0,0,0
2023-12-16 10:45,94,39,55,0,0,0
2023-12-16 11:00,66,22,44,0,0,0
2023-12-16 11:15,75,32,43,0,0,0
2023-12-16 11:30,94,37,57,0,0,0
2023-12-16 11:45,94,40,54,0,0,0
2023-12-16 12:00,87,32,55,0,0,0
2023-12-16 12:15,72,28,44,0,0,0
2023-12-16 12:30,92,47,45,0,0,0
2023-12-16 12:45,95,42,53,0,0,0
2023-12-16 13:00,81,36,45,0,0,0
2023-12-16 13:15,98,36,62,0,0,0
2023-12-16 13:30,88,32,56,0,0,0
2023-12-16 13:45,98,38,60,0,0,0
2023-12-16 14:00,86,40,46,0,0,0
2023-12-16 14:15,90,40,50,0,0,0
2023-12-16 14:30,89,42,47,0,0,0
2023-12-16 14:45,86,41,45,0,0,0
2023-12-16 15:00,89,42,47,0,0,0
2023-12-16 15:15,98,53,45,0,0,0
2023-12-16 15:30,83,39,44,0,0,0
2023-12-16 15:45,91,41,50,0,0,0
2023-12-16 16:00,91,46,45,0,0,0
2023-12-16 16:15,87,36,51,0,0,0
2023-12-16 16:30,76,33,43,0,0,0
2023-12-16 16:45,73,37,36,0,0,0
2023-12-16 17:00,78,37,41,0,0,0
2023-12-16 17:15,68,24,44,0,0,0
2023-12-16 17:30,83,39,44,0,0,0
2023-12-16 17:45,83,42,41,0,0,0
2023-12-16 18:00,102,46,56,0,0,0
2023-12-16 18:15,99,59,40,0,0,0
2023-12-16 18:30,66,25,41,0,0,0
2023-12-16 18:45,89,39,50,0,0,0
2023-12-16 19:00,91,43,48,0,0,0
2023-12-16 19:15,61,29,32,0,0,0
2023-12-16 19:30,70,34,36,0,0,0
2023-12-16 19:45,92,55,37,0,0,0
2023-12-16 20:00,79,35,44,0,0,0
2023-12-16 20:15,83,43,40,0,0,0
2023-12-16 20:30,42,18,24,0,0,0
2023-12-16 20:45,64,39,25,0,0,0
2023-12-16 21:00,68,33,35,0,0,0
2023-12-16 21:15,49,23,26,0,0,0
2023-12-16 21:30,56,26,30,0,0,0
2023-12-16 21:45,61,27,34,0,0,0
2023-12-16 22:00,45,15,30,0,0,0
2023-12-16 22:15,64,26,38,0,0,0
2023-12-16 22:30,60,18,42,0,0,0
2023-12-16 22:45,55,24,31,0,0,0
2023-12-16 23:00,50,21,29,0,0,0
2023-12-16 23:15,42,12,30,0,0,0
2023-12-16 23:30,57,24,33,0,0,0
2023-12-16 23:45,50,23,27,0,0,0
2023-12-17 00:00,37,16,21,0,0,0
2023-12-17 00:15,60,23,37,0,0,0
2023-12-17 00:30,44,17,27,0,0,0
2023-12-17 00:45,38,19,19,0,0,0
2023-12-17 01:00,80,43,37,0,0,0
2023-12-17 01:15,51,28,23,0,0,0
2023-12-17 01:30,41,22,19,0,0,0
2023-12-17 01:45,30,10,20,0,0,0
2023-12-17 02:00,18,4,14,0,0,0
2023-12-17 02:15,23,4,19,0,0,0
2023-12-17 02:30,17,4,13,0,0,0
2023-12-17 02:45,31,4,27,0,0,0
2023-12-17 03:00,20,6,14,0,0,0
2023-12-17 03:15,15,1,14,0,0,0
2023-12-17 03:30,17,4,13,0,0,0
2023-12-17 03:45,19,2,17,0,0,0
2023-12-17 04:00,21,4,17,0,0,0
2023-12-17 04:15,24,2,22,0,0,0
2023-12-17 04:30,16,2,14,0,0,0
2023-12-17 04:45,17,5,12,0,0,0
2023-12-17 05:00,8,0,8,0,0,0
2023-12-17 05:15,22,2,20,0,0,0
2023-12-17 05:30,26,3,23,0,0,0
2023-12-17 05:45,14,2,12,0,0,0
2023-12-17 06:00,6,1,5,0,0,0
2023-12-17 06:15,18,3,15,0,0,0
2023-12-17 06:30,8,0,8,0,0,0
2023-12-17 06:45,7,2,5,0,0,0
2023-12-17 07:00,5,1,4,0,0,0
2023-12-17 07:15,14,1,13,0,0,0
2023-12-17 07:30,11,1,10,0,0,0
2023-12-17 07:45,3,0,3,0,0,0
2023-12-17 08:00,10,2,8,0,0,0
2023-12-17 08:15,8,3,5,0,0,0
2023-12-17 08:30,8,3,5,0,0,0
2023-12-17 08:45,24,12,12,0,0,0
2023-12-17 09:00,21,8,13,0,0,0
2023-12-17 09:15,18,5,13,0,0,0
2023-12-17 09:30,31,18,13,0,0,0
2023-12-17 09:45,41,18,23,0,0,0
2023-12-17 10:00,21,7,14,0,0,0
2023-12-17 10:15,34,9,25,0,0,0
2023-12-17 10:30,42,10,32,0,0,0
2023-12-17 10:45,58,18,40,0,0,0
2023-12-17 11:00,50,16,34,0,0,0
2023-12-17 11:15,65,24,41,0,0,0
2023-12-17 11:30,53,18,35,0,0,0
2023-12-17 11:45,44,16,28,0,0,0
2023-12-17 12:00,51,16,35,0,0,0
2023-12-17 12:15,58,29,29,0,0,0
2023-12-17 12:30,48,21,27,0,0,0
2023-12-17 12:45,65,25,40,0,0,0
2023-12-17 13:00,69,25,44,0,0,0
2023-12-17 13:15,54,24,30,0,0,0
2023-12-17 13:30,47,15,32,0,0,0
2023-12-17 13:45,77,33,44,0,0,0
2023-12-17 14:00,83,37,46,0,0,0
2023-12-17 14:15,61,24,37,0,0,0
2023-12-17 14:30,77,29,48,0,0,0
2023-12-17 14:45,111,50,61,0,0,0
2023-12-17 15:00,51,28,23,0,0,0
2023-12-17 15:15,74,27,47,0,0,0
2023-12-17 15:30,57,19,38,0,0,0
2023-12-17 15:45,67,27,40,0,0,0
2023-12-17 16:00,74,23,51,0,0,0
2023-12-17 16:15,98,40,58,0,0,0
2023-12-17 16:30,73,24,49,0,0,0
2023-12-17 16:45,99,60,39,0,0,0
2023-12-17 17:00,78,39,39,0,0,0
2023-12-17 17:15,76,38,38,0,0,0
2023-12-17 17:30,78,32,46,0,0,0
2023-12-17 17:45,90,40,50,0,0,0
2023-12-17 18:00,86,39,47,0,0,0
2023-12-17 18:15,77,31,46,0,0,0
2023-12-17 18:30,72,35,37,0,0,0
2023-12-17 18:45,79,30,49,0,0,0
2023-12-17 19:00,72,33,39,0,0,0
2023-12-17 19:15,83,36,47,0,0,0
2023-12-17 19:30,49,14,35,0,0,0
2023-12-17 19:45,66,30,36,0,0,0
2023-12-17 20:00,72,38,34,0,0,0
2023-12-17 20:15,55,28,27,0,0,0
2023-12-17 20:30,46,20,26,0,0,0
2023-12-17 20:45,36,13,23,0,0,0
2023-12-17 21:00,38,11,27,0,0,0
2023-12-17 21:15,38,10,28,0,0,0
2023-12-17 21:30,47,20,27,0,0,0
2023-12-17 21:45,27,9,18,0,0,0
2023-12-17 22:00,27,9,18,0,0,0
2023-12-17 22:15,30,5,25,0,0,0
2023-12-17 22:30,20,8,12,0,0,0
2023-12-17 22:45,20,11,9,0,0,0
2023-12-17 23:00,32,9,23,0,0,0
2023-12-17 23:15,34,13,21,0,0,0
2023-12-17 23:30,15,4,11,0,0,0
2023-12-17 23:45,14,4,10,0,0,0
2023-12-18 00:00,13,4,9,0,0,0
2023-12-18 00:15,4,2,2,0,0,0
2023-12-18 00:30,11,3,8,0,0,0
2023-12-18 00:45,6,2,4,0,0,0
2023-12-18 01:00,4,2,2,0,0,0
2023-12-18 01:15,0,0,0,0,0,0
2023-12-18 01:30,6,4,2,0,0,0
2023-12-18 01:45,4,1,3,0,0,0
2023-12-18 02:00,4,1,3,0,0,0
2023-12-18 02:15,1,0,1,0,0,0
2023-12-18 02:30,1,0,1,0,0,0
2023-12-18 02:45,3,0,3,0,0,0
2023-12-18 03:00,1,0,1,0,0,0
2023-12-18 03:15,0,0,0,0,0,0
2023-12-18 03:30,2,0,2,0,0,0
2023-12-18 03:45,2,1,1,0,0,0
2023-12-18 04:00,3,2,1,0,0,0
2023-12-18 04:15,2,0,2,0,0,0
2023-12-18 04:30,0,0,0,0,0,0
2023-12-18 04:45,3,2,1,0,0,0
2023-12-18 05:00,4,3,1,0,0,0
2023-12-18 05:15,11,2,9,0,0,0
2023-12-18 05:30,18,4,14,0,0,0
2023-12-18 05:45,19,13,6,0,0,0
2023-12-18 06:00,25,11,14,0,0,0
2023-12-18 06:15,42,18,24,0,0,0
2023-12-18 06:30,43,21,22,0,0,0
2023-12-18 06:45,57,34,23,0,0,0
2023-12-18 07:00,51,28,23,0,0,0
2023-12-18 07:15,129,59,70,0,0,0
2023-12-18 07:30,113,49,64,0,0,0
2023-12-18 07:45,142,69,73,0,0,0
2023-12-18 08:00,150,77,73,0,0,0
2023-12-18 08:15,146,65,81,0,0,0
2023-12-18 08:30,143,63,80,0,0,0
2023-12-18 08:45,131,69,62,0,0,0
2023-12-18 09:00,110,45,65,0,0,0
2023-12-18 09:15,83,28,55,0,0,0
2023-12-18 09:30,85,32,53,0,0,0
2023-12-18 09:45,128,45,83,0,0,0
2023-12-18 10:00,114,31,83,0,0,0
2023-12-18 10:15,79,31,48,0,0,0
2023-12-18 10:30,90,33,57,0,0,0
2023-12-18 10:45,97,37,60,0,0,0
2023-12-18 11:00,95,38,57,0,0,0
2023-12-18 11:15,111,42,69,0,0,0
2023-12-18 11:30,112,35,77,0,0,0
2023-12-18 11:45,119,49,70,0,0,0
2023-12-18 12:00,137,46,91,0,0,0
2023-12-18 12:15,125,45,80,0,0,0
2023-12-18 12:30,124,45,79,0,0,0
2023-12-18 12:45,108,35,73,0,0,0
2023-12-18 13:00,119,45,74,0,0,0
2023-12-18 13:15,107,51,56,0,0,0
2023-12-18 13:30,101,48,53,0,0,0
2023-12-18 13:45,105,46,59,0,0,0
2023-12-18 14:00,124,60,64,0,0,0
2023-12-18 14:15,108,53,55,0,0,0
2023-12-18 14:30,107,52,55,0,0,0
2023-12-18 14:45,138,54,84,0,0,0
2023-12-18 15:00,130,59,71,0,0,0
2023-12-18 15:15,135,50,85,0,0,0
2023-12-18 15:30,123,54,69,0,0,0
2023-12-18 15:45,156,75,81,0,0,0
2023-12-18 16:00,158,72,86,0,0,0
2023-12-18 16:15,148,76,72,0,0,0
2023-12-18 16:30,159,60,99,0,0,0
2023-12-18 16:45,154,62,92,0,0,0
2023-12-18 17:00,169,74,95,0,0,0
2023-12-18 17:15,182,71,111,0,0,0
2023-12-18 17:30,147,50,97,0,0,0
2023-12-18 17:45,151,63,88,0,0,0
2023-12-18 18:00,172,93,79,0,0,0
2023-12-18 18:15,154,55,99,0,0,0
2023-12-18 18:30,113,46,67,0,0,0
2023-12-18 18:45,145,73,72,0,0,0
2023-12-18 19:00,108,62,46,0,0,0
2023-12-18 19:15,110,61,49,0,0,0
2023-12-18 19:30,119,71,48,0,0,0
2023-12-18 19:45,95,63,32,0,0,0
2023-12-18 20:00,95,66,29,0,0,0
2023-12-18 20:15,112,73,39,0,0,0
2023-12-18 20:30,70,43,27,0,0,0
2023-12-18 20:45,45,30,15,0,0,0
2023-12-18 21:00,59,25,34,0,0,0
2023-12-18 21:15,55,26,29,0,0,0
2023-12-18 21:30,53,25,28,0,0,0
2023-12-18 21:45,41,18,23,0,0,0
2023-12-18 22:00,47,18,29,0,0,0
2023-12-18 22:15,57,18,39,0,0,0
2023-12-18 22:30,42,18,24,0,0,0
2023-12-18 22:45,68,21,47,0,0,0
2023-12-18 23:00,44,11,33,0,0,0
2023-12-18 23:15,50,10,40,0,0,0
2023-12-18 23:30,25,9,16,0,0,0
2023-12-18 23:45,16,6,10,0,0,0
2023-12-19 00:00,16,8,8,0,0,0
2023-12-19 00:15,12,6,6,0,0,0
2023-12-19 00:30,5,4,1,0,0,0
2023-12-19 00:45,8,4,4,0,0,0
2023-12-19 01:00,4,2,2,0,0,0
2023-12-19 01:15,5,1,4,0,0,0
2023-12-19 01:30,3,2,1,0,0,0
2023-12-19 01:45,7,4,3,0,0,0
2023-12-19 02:00,5,3,2,0,0,0
2023-12-19 02:15,4,4,0,0,0,0
2023-12-19 02:30,2,2,0,0,0,0
2023-12-19 02:45,3,2,1,0,0,0
2023-12-19 03:00,2,1,1,0,0,0
2023-12-19 03:15,4,1,3,0,0,0
2023-12-19 03:30,1,0,1,0,0,0
2023-12-19 03:45,1,0,1,0,0,0
2023-12-19 04:00,4,3,1,0,0,0
2023-12-19 04:15,5,1,4,0,0,0
2023-12-19 04:30,0,0,0,0,0,0
2023-12-19 04:45,4,3,1,0,0,0
2023-12-19 05:00,4,2,2,0,0,0
2023-12-19 05:15,8,3,5,0,0,0
2023-12-19 05:30,14,6,8,0,0,0
2023-12-19 05:45,20,12,8,0,0,0
2023-12-19 06:00,22,10,12,0,0,0
2023-12-19 06:15,41,17,24,0,0,0
2023-12-19 06:30,37,13,24,0,0,0
2023-12-19 06:45,62,35,27,0,0,0
2023-12-19 07:00,55,31,24,0,0,0
2023-12-19 07:15,95,34,61,0,0,0
2023-12-19 07:30,131,40,91,0,0,0
2023-12-19 07:45,149,59,90,0,0,0
2023-12-19 08:00,145,74,71,0,0,0
2023-12-19 08:15,141,60,81,0,0,0
2023-12-19 08:30,110,57,53,0,0,0
2023-12-19 08:45,125,66,59,0,0,0
2023-12-19 09:00,76,35,41,0,0,0
2023-12-19 09:15,83,26,57,0,0,0
2023-12-19 09:30,89,34,55,0,0,0
2023-12-19 09:45,115,40,75,0,0,0
2023-12-19 10:00,129,31,98,0,0,0
2023-12-19 10:15,109,32,77,0,0,0
2023-12-19 10:30,104,43,61,0,0,0
2023-12-19 10:45,83,29,54,0,0,0
2023-12-19 11:00,67,22,45,0,0,0
2023-12-19 11:15,93,33,60,0,0,0
2023-12-19 11:30,92,24,68,0,0,0
2023-12-19 11:45,111,46,65,0,0,0
2023-12-19 12:00,83,23,60,0,0,0
2023-12-19 12:15,105,30,75,0,0,0
2023-12-19 12:30,87,35,52,0,0,0
2023-12-19 12:45,114,50,64,0,0,0
2023-12-19 13:00,98,51,47,0,0,0
2023-12-19 13:15,92,39,53,0,0,0
2023-12-19 13:30,104,24,80,0,0,0
2023-12-19 13:45,117,46,71,0,0,0
2023-12-19 14:00,123,58,65,0,0,0
2023-12-19 14:15,91,35,56,0,0,0
2023-12-19 14:30,87,37,50,0,0,0
2023-12-19 14:45,82,33,49,0,0,0
2023-12-19 15:00,108,41,67,0,0,0
2023-12-19 15:15,127,44,83,0,0,0
2023-12-19 15:30,114,46,68,0,0,0
2023-12-19 15:45,131,65,66,0,0,0
2023-12-19 16:00,146,65,81,0,0,0
2023-12-19 16:15,114,52,62,0,0,0
2023-12-19 16:30,115,52,63,0,0,0
2023-12-19 16:45,110,44,66,0,0,0
2023-12-19 17:00,124,31,93,0,0,0
2023-12-19 17:15,110,45,65,0,0,0
2023-12-19 17:30,113,41,72,0,0,0
2023-12-19 17:45,108,43,65,0,0,0
2023-12-19 18:00,127,59,68,0,0,0
2023-12-19 18:15,122,50,72,0,0,0
2023-12-19 18:30,100,42,58,0,0,0
2023-12-19 18:45,114,54,60,0,0,0
2023-12-19 19:00,75,33,42,0,0,0
2023-12-19 19:15,85,37,48,0,0,0
2023-12-19 19:30,70,33,37,0,0,0
2023-12-19 19:45,94,48,46,0,0,0
2023-12-19 20:00,87,41,46,0,0,0
2023-12-19 20:15,63,27,36,0,0,0
2023-12-19 20:30,43,20,23,0,0,0
2023-12-19 20:45,42,16,26,0,0,0
2023-12-19 21:00,45,16,29,0,0,0
2023-12-19 21:15,52,20,32,0,0,0
2023-12-19 21:30,35,16,19,0,0,0
2023-12-19 21:45,61,30,31,0,0,0
2023-12-19 22:00,64,30,34,0,0,0
2023-12-19 22:15,50,18,32,0,0,0
2023-12-19 22:30,62,18,44,0,0,0
2023-12-19 22:45,50,10,40,0,0,0
2023-12-19 23:00,44,8,36,0,0,0
2023-12-19 23:15,29,10,19,0,0,0
2023-12-19 23:30,15,7,8,0,0,0
2023-12-19 23:45,21,10,11,0,0,0
2023-12-20 00:00,19,8,11,0,0,0
2023-12-20 00:15,13,6,7,0,0,0
2023-12-20 00:30,11,5,6,0,0,0
2023-12-20 00:45,6,1,5,0,0,0
2023-12-20 01:00,10,5,5,0,0,0
2023-12-20 01:15,9,5,4,0,0,0
2023-12-20 01:30,3,0,3,0,0,0
2023-12-20 01:45,2,1,1,0,0,0
2023-12-20 02:00,4,1,3,0,0,0
2023-12-20 02:15,3,0,3,0,0,0
2023-12-20 02:30,2,0,2,0,0,0
2023-12-20 02:45,1,0,1,0,0,0
2023-12-20 03:00,1,1,0,0,0,0
2023-12-20 03:15,4,0,4,0,0,0
2023-12-20 03:30,3,0,3,0,0,0
2023-12-20 03:45,2,1,1,0,0,0
2023-12-20 04:00,5,2,3,0,0,0
2023-12-20 04:15,4,1,3,0,0,0
2023-12-20 04:30,5,3,2,0,0,0
2023-12-20 04:45,3,2,1,0,0,0
2023-12-20 05:00,8,3,5,0,0,0
2023-12-20 05:15,9,4,5,0,0,0
2023-12-20 05:30,13,3,10,0,0,0
2023-12-20 05:45,20,11,9,0,0,0
2023-12-20 06:00,20,10,10,0,0,0
2023-12-20 06:15,30,14,16,0,0,0
2023-12-20 06:30,57,17,40,0,0,0
2023-12-20 06:45,54,31,23,0,0,0
2023-12-20 07:00,74,39,35,0,0,0
2023-12-20 07:15,80,39,41,0,0,0
2023-12-20 07:30,112,42,70,0,0,0
2023-12-20 07:45,144,67,77,0,0,0
2023-12-20 08:00,136,58,78,0,0,0
2023-12-20 08:15,135,63,72,0,0,0
2023-12-20 08:30,139,71,68,0,0,0
2023-12-20 08:45,140,60,80,0,0,0
2023-12-20 09:00,111,55,56,0,0,0
2023-12-20 09:15,83,31,52,0,0,0
2023-12-20 09:30,92,35,57,0,0,0
2023-12-20 09:45,85,28,57,0,0,0
2023-12-20 10:00,102,29,73,0,0,0
2023-12-20 10:15,103,30,73,0,0,0
2023-12-20 10:30,110,47,63,0,0,0
2023-12-20 10:45,86,29,57,0,0,0
2023-12-20 11:00,88,41,47,0,0,0
2023-12-20 11:15,91,33,58,0,0,0
2023-12-20 11:30,111,36,75,0,0,0
2023-12-20 11:45,151,58,93,0,0,0
2023-12-20 12:00,125,44,81,0,0,0
2023-12-20 12:15,125,38,87,0,0,0
2023-12-20 12:30,119,58,61,0,0,0
2023-12-20 12:45,115,41,74,0,0,0
2023-12-20 13:00,100,46,54,0,0,0
2023-12-20 13:15,116,48,68,0,0,0
2023-12-20 13:30,106,34,72,0,0,0
2023-12-20 13:45,125,70,55,0,0,0
2023-12-20 14:00,117,55,62,0,0,0
2023-12-20 14:15,102,46,56,0,0,0
2023-12-20 14:30,92,39,53,0,0,0
2023-12-20 14:45,120,46,74,0,0,0
2023-12-20 15:00,104,50,54,0,0,0
2023-12-20 15:15,116,52,64,0,0,0
2023-12-20 15:30,98,42,56,0,0,0
2023-12-20 15:45,142,78,64,0,0,0
2023-12-20 16:00,143,71,72,0,0,0
2023-12-20 16:15,135,58,77,0,0,0
2023-12-20 16:30,135,54,81,0,0,0
2023-12-20 16:45,138,56,82,0,0,0
2023-12-20 17:00,131,55,76,0,0,0
2023-12-20 17:15,178,97,81,0,0,0
2023-12-20 17:30,122,58,64,0,0,0
2023-12-20 17:45,138,63,75,0,0,0
2023-12-20 18:00,131,59,72,0,0,0
2023-12-20 18:15,127,55,72,0,0,0
2023-12-20 18:30,96,44,52,0,0,0
2023-12-20 18:45,129,69,60,0,0,0
2023-12-20 19:00,148,81,67,0,0,0
2023-12-20 19:15,117,69,48,0,0,0
2023-12-20 19:30,94,50,44,0,0,0
2023-12-20 19:45,88,49,39,0,0,0
2023-12-20 20:00,65,39,26,0,0,0
2023-12-20 20:15,66,42,24,0,0,0
2023-12-20 20:30,63,20,43,0,0,0
2023-12-20 20:45,50,18,32,0,0,0
2023-12-20 21:00,52,22,30,0,0,0
2023-12-20 21:15,54,24,30,0,0,0
2023-12-20 21:30,78,18,60,0,0,0
2023-12-20 21:45,78,21,57,0,0,0
2023-12-20 22:00,86,30,56,0,0,0
2023-12-20 22:15,67,22,45,0,0,0
2023-12-20 22:30,69,20,49,0,0,0
2023-12-20 22:45,51,20,31,0,0,0
2023-12-20 23:00,46,15,31,0,0,0
2023-12-20 23:15,28,5,23,0,0,0
2023-12-20 23:30,37,13,24,0,0,0
2023-12-20 23:45,35,14,21,0,0,0
2023-12-21 00:00,31,8,23,0,0,0
2023-12-21 00:15,24,8,16,0,0,0
2023-12-21 00:30,31,17,14,0,0,0
2023-12-21 00:45,17,5,12,0,0,0
2023-12-21 01:00,25,6,19,0,0,0
2023-12-21 01:15,13,6,7,0,0,0
2023-12-21 01:30,10,2,8,0,0,0
2023-12-21 01:45,12,6,6,0,0,0
2023-12-21 02:00,11,3,8,0,0,0
2023-12-21 02:15,17,5,12,0,0,0
2023-12-21 02:30,15,4,11,0,0,0
2023-12-21 02:45,12,0,12,0,0,0
2023-12-21 03:00,4,3,1,0,0,0
2023-12-21 03:15,3,1,2,0,0,0
2023-12-21 03:30,6,4,2,0,0,0
2023-12-21 03:45,4,1,3,0,0,0
2023-12-21 04:00,9,5,4,0,0,0
2023-12-21 04:15,8,2,6,0,0,0
2023-12-21 04:30,6,2,4,0,0,0
2023-12-21 04:45,5,2,3,0,0,0
2023-12-21 05:00,10,5,5,0,0,0
2023-12-21 05:15,19,7,12,0,0,0
2023-12-21 05:30,13,6,7,0,0,0
2023-12-21 05:45,22,10,12,0,0,0
2023-12-21 06:00,18,12,6,0,0,0
2023-12-21 06:15,22,5,17,0,0,0
2023-12-21 06:30,45,18,27,0,0,0
2023-12-21 06:45,48,20,28,0,0,0
2023-12-21 07:00,31,16,15,0,0,0
2023-12-21 07:15,57,22,35,0,0,0
2023-12-21 07:30,68,34,34,0,0,0
2023-12-21 07:45,85,46,39,0,0,0
2023-12-21 08:00,78,45,33,0,0,0
2023-12-21 08:15,88,41,47,0,0,0
2023-12-21 08:30,96,46,50,0,0,0
2023-12-21 08:45,79,48,31,0,0,0
2023-12-21 09:00,78,35,43,0,0,0
2023-12-21 09:15,68,27,41,0,0,0
2023-12-21 09:30,59,23,36,0,0,0
2023-12-21 09:45,68,21,47,0,0,0
2023-12-21 10:00,69,13,56,0,0,0
2023-12-21 10:15,71,19,52,0,0,0
2023-12-21 10:30,82,21,61,0,0,0
2023-12-21 10:45,90,26,64,0,0,0
2023-12-21 11:00,74,23,51,0,0,0
2023-12-21 11:15,52,17,35,0,0,0
2023-12-21 11:30,78,20,58,0,0,0
2023-12-21 11:45,69,15,54,0,0,0
2023-12-21 12:00,77,15,62,0,0,0
2023-12-21 12:15,115,32,83,0,0,0
2023-12-21 12:30,83,26,57,0,0,0
2023-12-21 12:45,95,43,52,0,0,0
2023-12-21 13:00,82,35,47,0,0,0
2023-12-21 13:15,65,26,39,0,0,0
2023-12-21 13:30,111,49,62,0,0,0
2023-12-21 13:45,84,31,53,0,0,0
2023-12-21 14:00,107,34,73,0,0,0
2023-12-21 14:15,85,34,51,0,0,0
2023-12-21 14:30,80,32,48,0,0,0
2023-12-21 14:45,87,32,55,0,0,0
2023-12-21 15:00,90,29,61,0,0,0
2023-12-21 15:15,87,28,59,0,0,0
2023-12-21 15:30,78,32,46,0,0,0
2023-12-21 15:45,89,34,55,0,0,0
2023-12-21 16:00,87,38,49,0,0,0
2023-12-21 16:15,102,29,73,0,0,0
2023-12-21 16:30,92,34,58,0,0,0
2023-12-21 16:45,96,39,57,0,0,0
2023-12-21 17:00,104,31,73,0,0,0
2023-12-21 17:15,76,28,48,0,0,0
2023-12-21 17:30,71,25,46,0,0,0
2023-12-21 17:45,111,36,75,0,0,0
2023-12-21 18:00,106,26,80,0,0,0
2023-12-21 18:15,86,24,62,0,0,0
2023-12-21 18:30,72,34,38,0,0,0
2023-12-21 18:45,106,47,59,0,0,0
2023-12-21 19:00,68,31,37,0,0,0
2023-12-21 19:15,78,33,45,0,0,0
2023-12-21 19:30,56,19,37,0,0,0
2023-12-21 19:45,69,23,46,0,0,0
2023-12-21 20:00,76,39,37,0,0,0
2023-12-21 20:15,58,22,36,0,0,0
2023-12-21 20:30,51,23,28,0,0,0
2023-12-21 20:45,50,21,29,0,0,0
2023-12-21 21:00,42,18,24,0,0,0
2023-12-21 21:15,41,14,27,0,0,0
2023-12-21 21:30,37,13,24,0,0,0
2023-12-21 21:45,52,18,34,0,0,0
2023-12-21 22:00,32,11,21,0,0,0
2023-12-21 22:15,41,16,25,0,0,0
2023-12-21 22:30,38,14,24,0,0,0
2023-12-21 22:45,41,11,30,0,0,0
2023-12-21 23:00,32,10,22,0,0,0
2023-12-21 23:15,21,10,11,0,0,0
2023-12-21 23:30,21,13,8,0,0,0
2023-12-21 23:45,21,10,11,0,0,0
2023-12-22 00:00,13,3,10,0,0,0
2023-12-22 00:15,28,10,18,0,0,0
2023-12-22 00:30,8,2,6,0,0,0
2023-12-22 00:45,14,4,10,0,0,0
2023-12-22 01:00,11,2,9,0,0,0
2023-12-22 01:15,7,2,5,0,0,0
2023-12-22 01:30,12,5,7,0,0,0
2023-12-22 01:45,4,3,1,0,0,0
2023-12-22 02:00,8,2,6,0,0,0
2023-12-22 02:15,1,0,1,0,0,0
2023-12-22 02:30,8,1,7,0,0,0
2023-12-22 02:45,6,3,3,0,0,0
2023-12-22 03:00,7,1,6,0,0,0
2023-12-22 03:15,3,1,2,0,0,0
2023-12-22 03:30,2,1,1,0,0,0
2023-12-22 03:45,10,2,8,0,0,0
2023-12-22 04:00,2,1,1,0,0,0
2023-12-22 04:15,3,1,2,0,0,0
2023-12-22 04:30,0,0,0,0,0,0
2023-12-22 04:45,7,4,3,0,0,0
2023-12-22 05:00,4,2,2,0,0,0
2023-12-22 05:15,10,5,5,0,0,0
2023-12-22 05:30,14,5,9,0,0,0
2023-12-22 05:45,14,7,7,0,0,0
2023-12-22 06:00,17,5,12,0,0,0
2023-12-22 06:15,20,7,13,0,0,0
2023-12-22 06:30,31,15,16,0,0,0
2023-12-22 06:45,49,22,27,0,0,0
2023-12-22 07:00,42,21,21,0,0,0
2023-12-22 07:15,47,24,23,0,0,0
2023-12-22 07:30,54,30,24,0,0,0
2023-12-22 07:45,59,31,28,0,0,0
2023-12-22 08:00,56,20,36,0,0,0
2023-12-22 08:15,68,38,30,0,0,0
2023-12-22 08:30,53,28,25,0,0,0
2023-12-22 08:45,71,33,38,0,0,0
2023-12-22 09:00,44,18,26,0,0,0
2023-12-22 09:15,65,24,41,0,0,0
2023-12-22 09:30,54,20,34,0,0,0
2023-12-22 09:45,70,27,43,0,0,0
2023-12-22 10:00,63,22,41,0,0,0
2023-12-22 10:15,72,17,55,0,0,0
2023-12-22 10:30,66,23,43,0,0,0
2023-12-22 10:45,73,22,51,0,0,0
2023-12-22 11:00,87,25,62,0,0,0
2023-12-22 11:15,69,29,40,0,0,0
2023-12-22 11:30,58,28,30,0,0,0
2023-12-22 11:45,71,26,45,0,0,0
2023-12-22 12:00,95,27,68,0,0,0
2023-12-22 12:15,86,29,57,0,0,0
2023-12-22 12:30,62,21,41,0,0,0
2023-12-22 12:45,85,31,54,0,0,0
2023-12-22 13:00,58,21,37,0,0,0
2023-12-22 13:15,101,33,68,0,0,0
2023-12-22 13:30,95,34,61,0,0,0
2023-12-22 13:45,74,25,49,0,0,0
2023-12-22 14:00,98,32,66,0,0,0
2023-12-22 14:15,106,29,77,0,0,0
2023-12-22 14:30,78,30,48,0,0,0
2023-12-22 14:45,92,35,57,0,0,0
2023-12-22 15:00,59,22,37,0,0,0
2023-12-22 15:15,75,25,50,0,0,0
2023-12-22 15:30,51,19,32,0,0,0
2023-12-22 15:45,75,25,50,0,0,0
2023-12-22 16:00,69,23,46,0,0,0
2023-12-22 16:15,77,21,56,0,0,0
2023-12-22 16:30,61,17,44,0,0,0
2023-12-22 16:45,59,13,46,0,0,0
2023-12-22 17:00,54,21,33,0,0,0
2023-12-22 17:15,76,24,52,0,0,0
2023-12-22 17:30,58,21,37,0,0,0
2023-12-22 17:45,59,23,36,0,0,0
2023-12-22 18:00,77,24,53,0,0,0
2023-12-22 18:15,90,37,53,0,0,0
2023-12-22 18:30,79,39,40,0,0,0
2023-12-22 18:45,80,41,39,0,0,0
2023-12-22 19:00,63,25,38,0,0,0
2023-12-22 19:15,69,25,44,0,0,0
2023-12-22 19:30,54,21,33,0,0,0
2023-12-22 19:45,65,33,32,0,0,0
2023-12-22 20:00,55,35,20,0,0,0
2023-12-22 20:15,51,18,33,0,0,0
2023-12-22 20:30,42,22,20,0,0,0
2023-12-22 20:45,54,27,27,0,0,0
2023-12-22 21:00,34,16,18,0,0,0
2023-12-22 21:15,38,15,23,0,0,0
2023-12-22 21:30,47,16,31,0,0,0
2023-12-22 21:45,31,11,20,0,0,0
2023-12-22 22:00,21,3,18,0,0,0
2023-12-22 22:15,49,16,33,0,0,0
2023-12-22 22:30,33,14,19,0,0,0
2023-12-22 22:45,22,4,18,0,0,0
2023-12-22 23:00,39,13,26,0,0,0
2023-12-22 23:15,27,5,22,0,0,0
2023-12-22 23:30,18,8,10,0,0,0
2023-12-22 23:45,28,12,16,0,0,0
