Datetime,100031300 (Hafenstraße),101031300 (Hafenstraße Fahrräder IN),102031300 (Hafenstraße Fahrräder OUT),100031300-status,101031300-status,102031300-status
2025-06-01 00:00,82,17,65,0,0,0
2025-06-01 00:15,75,8,67,0,0,0
2025-06-01 00:30,57,11,46,0,0,0
2025-06-01 00:45,25,6,19,0,0,0
2025-06-01 01:00,40,11,29,0,0,0
2025-06-01 01:15,70,16,54,0,0,0
2025-06-01 01:30,37,6,31,0,0,0
2025-06-01 01:45,28,8,20,0,0,0
2025-06-01 02:00,32,6,26,0,0,0
2025-06-01 02:15,34,7,27,0,0,0
2025-06-01 02:30,28,3,25,0,0,0
2025-06-01 02:45,32,3,29,0,0,0
2025-06-01 03:00,23,1,22,0,0,0
2025-06-01 03:15,21,4,17,0,0,0
2025-06-01 03:30,9,2,7,0,0,0
2025-06-01 03:45,13,3,10,0,0,0
2025-06-01 04:00,17,1,16,0,0,0
2025-06-01 04:15,12,2,10,0,0,0
2025-06-01 04:30,16,1,15,0,0,0
2025-06-01 04:45,18,4,14,0,0,0
2025-06-01 05:00,2,0,2,0,0,0
2025-06-01 05:15,14,1,13,0,0,0
2025-06-01 05:30,9,2,7,0,0,0
2025-06-01 05:45,13,5,8,0,0,0
2025-06-01 06:00,10,2,8,0,0,0
2025-06-01 06:15,4,1,3,0,0,0
2025-06-01 06:30,6,5,1,0,0,0
2025-06-01 06:45,10,6,4,0,0,0
2025-06-01 07:00,6,2,4,0,0,0
2025-06-01 07:15,9,2,7,0,0,0
2025-06-01 07:30,13,4,9,0,0,0
2025-06-01 07:45,15,1,14,0,0,0
2025-06-01 08:00,14,8,6,0,0,0
2025-06-01 08:15,13,6,7,0,0,0
2025-06-01 08:30,15,6,9,0,0,0
2025-06-01 08:45,20,8,12,0,0,0
2025-06-01 09:00,26,9,17,0,0,0
2025-06-01 09:15,25,9,16,0,0,0
2025-06-01 09:30,24,10,14,0,0,0
2025-06-01 09:45,43,20,23,0,0,0
2025-06-01 10:00,42,19,23,0,0,0
2025-06-01 10:15,48,24,24,0,0,0
2025-06-01 10:30,57,25,32,0,0,0
2025-06-01 10:45,84,34,50,0,0,0
2025-06-01 11:00,48,21,27,0,0,0
2025-06-01 11:15,44,21,23,0,0,0
2025-06-01 11:30,59,16,43,0,0,0
2025-06-01 11:45,89,39,50,0,0,0
2025-06-01 12:00,63,35,28,0,0,0
2025-06-01 12:15,64,32,32,0,0,0
2025-06-01 12:30,68,32,36,0,0,0
2025-06-01 12:45,80,42,38,0,0,0
2025-06-01 13:00,65,31,34,0,0,0
2025-06-01 13:15,60,24,36,0,0,0
2025-06-01 13:30,73,34,39,0,0,0
2025-06-01 13:45,84,45,39,0,0,0
2025-06-01 14:00,91,39,52,0,0,0
2025-06-01 14:15,86,41,45,0,0,0
2025-06-01 14:30,86,44,42,0,0,0
2025-06-01 14:45,85,43,42,0,0,0
2025-06-01 15:00,76,28,48,0,0,0
2025-06-01 15:15,87,44,43,0,0,0
2025-06-01 15:30,64,21,43,0,0,0
2025-06-01 15:45,84,43,41,0,0,0
2025-06-01 16:00,81,34,47,0,0,0
2025-06-01 16:15,92,48,44,0,0,0
2025-06-01 16:30,94,25,69,0,0,0
2025-06-01 16:45,81,36,45,0,0,0
2025-06-01 17:00,74,32,42,0,0,0
2025-06-01 17:15,94,41,53,0,0,0
2025-06-01 17:30,74,36,38,0,0,0
2025-06-01 17:45,76,36,40,0,0,0
2025-06-01 18:00,102,53,49,0,0,0
2025-06-01 18:15,78,25,53,0,0,0
2025-06-01 18:30,80,34,46,0,0,0
2025-06-01 18:45,83,36,47,0,0,0
2025-06-01 19:00,85,35,50,0,0,0
2025-06-01 19:15,59,31,28,0,0,0
2025-06-01 19:30,79,19,60,0,0,0
2025-06-01 19:45,74,35,39,0,0,0
2025-06-01 20:00,76,26,50,0,0,0
2025-06-01 20:15,59,24,35,0,0,0
2025-06-01 20:30,43,23,20,0,0,0
2025-06-01 20:45,50,29,21,0,0,0
2025-06-01 21:00,53,17,36,0,0,0
2025-06-01 21:15,37,19,18,0,0,0
2025-06-01 21:30,41,14,27,0,0,0
2025-06-01 21:45,43,14,29,0,0,0
2025-06-01 22:00,24,12,12,0,0,0
2025-06-01 22:15,23,5,18,0,0,0
2025-06-01 22:30,36,18,18,0,0,0
2025-06-01 22:45,42,14,28,0,0,0
2025-06-01 23:00,19,7,12,0,0,0
2025-06-01 23:15,11,4,7,0,0,0
2025-06-01 23:30,9,4,5,0,0,0
2025-06-01 23:45,10,4,6,0,0,0
2025-06-02 00:00,10,4,6,0,0,0
2025-06-02 00:15,11,4,7,0,0,0
2025-06-02 00:30,6,4,2,0,0,0
2025-06-02 00:45,3,1,2,0,0,0
2025-06-02 01:00,5,4,1,0,0,0
2025-06-02 01:15,9,3,6,0,0,0
2025-06-02 01:30,1,0,1,0,0,0
2025-06-02 01:45,2,0,2,0,0,0
2025-06-02 02:00,1,1,0,0,0,0
2025-06-02 02:15,1,0,1,0,0,0
2025-06-02 02:30,0,0,0,0,0,0
2025-06-02 02:45,0,0,0,0,0,0
2025-06-02 03:00,2,0,2,0,0,0
2025-06-02 03:15,1,1,0,0,0,0
2025-06-02 03:30,1,1,0,0,0,0
2025-06-02 03:45,2,0,2,0,0,0
2025-06-02 04:00,3,3,0,0,0,0
2025-06-02 04:15,3,0,3,0,0,0
2025-06-02 04:30,2,0,2,0,0,0
2025-06-02 04:45,2,0,2,0,0,0
2025-06-02 05:00,7,4,3,0,0,0
2025-06-02 05:15,10,1,9,0,0,0
2025-06-02 05:30,14,5,9,0,0,0
2025-06-02 05:45,28,15,13,0,0,0
2025-06-02 06:00,28,17,11,0,0,0
2025-06-02 06:15,46,25,21,0,0,0
2025-06-02 06:30,54,24,30,0,0,0
2025-06-02 06:45,73,40,33,0,0,0
2025-06-02 07:00,76,44,32,0,0,0
2025-06-02 07:15,107,52,55,0,0,0
2025-06-02 07:30,154,90,64,0,0,0
2025-06-02 07:45,202,110,92,0,0,0
2025-06-02 08:00,165,79,86,0,0,0
2025-06-02 08:15,184,91,93,0,0,0
2025-06-02 08:30,155,73,82,0,0,0
2025-06-02 08:45,159,73,86,0,0,0
2025-06-02 09:00,106,47,59,0,0,0
2025-06-02 09:15,108,48,60,0,0,0
2025-06-02 09:30,87,18,69,0,0,0
2025-06-02 09:45,118,43,75,0,0,0
2025-06-02 10:00,106,38,68,0,0,0
2025-06-02 10:15,100,61,39,0,0,0
2025-06-02 10:30,94,53,41,0,0,0
2025-06-02 10:45,102,38,64,0,0,0
2025-06-02 11:00,91,47,44,0,0,0
2025-06-02 11:15,89,32,57,0,0,0
2025-06-02 11:30,84,40,44,0,0,0
2025-06-02 11:45,136,53,83,0,0,0
2025-06-02 12:00,125,63,62,0,0,0
2025-06-02 12:15,132,70,62,0,0,0
2025-06-02 12:30,126,68,58,0,0,0
2025-06-02 12:45,125,59,66,0,0,0
2025-06-02 13:00,102,45,57,0,0,0
2025-06-02 13:15,103,39,64,0,0,0
2025-06-02 13:30,97,40,57,0,0,0
2025-06-02 13:45,144,63,81,0,0,0
2025-06-02 14:00,148,71,77,0,0,0
2025-06-02 14:15,138,60,78,0,0,0
2025-06-02 14:30,122,63,59,0,0,0
2025-06-02 14:45,131,54,77,0,0,0
2025-06-02 15:00,126,77,49,0,0,0
2025-06-02 15:15,132,69,63,0,0,0
2025-06-02 15:30,132,75,57,0,0,0
2025-06-02 15:45,141,87,54,0,0,0
2025-06-02 16:00,178,94,84,0,0,0
2025-06-02 16:15,167,98,69,0,0,0
2025-06-02 16:30,165,78,87,0,0,0
2025-06-02 16:45,181,96,85,0,0,0
2025-06-02 17:00,178,72,106,0,0,0
2025-06-02 17:15,184,82,102,0,0,0
2025-06-02 17:30,173,102,71,0,0,0
2025-06-02 17:45,219,118,101,0,0,0
2025-06-02 18:00,200,115,85,0,0,0
2025-06-02 18:15,166,87,79,0,0,0
2025-06-02 18:30,141,66,75,0,0,0
2025-06-02 18:45,160,86,74,0,0,0
2025-06-02 19:00,127,64,63,0,0,0
2025-06-02 19:15,119,68,51,0,0,0
2025-06-02 19:30,125,60,65,0,0,0
2025-06-02 19:45,122,69,53,0,0,0
2025-06-02 20:00,92,38,54,0,0,0
2025-06-02 20:15,89,44,45,0,0,0
2025-06-02 20:30,65,23,42,0,0,0
2025-06-02 20:45,54,19,35,0,0,0
2025-06-02 21:00,67,29,38,0,0,0
2025-06-02 21:15,53,24,29,0,0,0
2025-06-02 21:30,60,27,33,0,0,0
2025-06-02 21:45,49,20,29,0,0,0
2025-06-02 22:00,60,29,31,0,0,0
2025-06-02 22:15,54,25,29,0,0,0
2025-06-02 22:30,50,19,31,0,0,0
2025-06-02 22:45,36,10,26,0,0,0
2025-06-02 23:00,20,7,13,0,0,0
2025-06-02 23:15,16,10,6,0,0,0
2025-06-02 23:30,19,6,13,0,0,0
2025-06-02 23:45,12,5,7,0,0,0
2025-06-03 00:00,16,6,10,0,0,0
2025-06-03 00:15,9,4,5,0,0,0
2025-06-03 00:30,14,7,7,0,0,0
2025-06-03 00:45,5,2,3,0,0,0
2025-06-03 01:00,6,3,3,0,0,0
2025-06-03 01:15,2,1,1,0,0,0
2025-06-03 01:30,5,0,5,0,0,0
2025-06-03 01:45,1,1,0,0,0,0
2025-06-03 02:00,1,1,0,0,0,0
2025-06-03 02:15,3,1,2,0,0,0
2025-06-03 02:30,0,0,0,0,0,0
2025-06-03 02:45,1,0,1,0,0,0
2025-06-03 03:00,3,1,2,0,0,0
2025-06-03 03:15,3,2,1,0,0,0
2025-06-03 03:30,1,0,1,0,0,0
2025-06-03 03:45,2,1,1,0,0,0
2025-06-03 04:00,2,1,1,0,0,0
2025-06-03 04:15,2,0,2,0,0,0
2025-06-03 04:30,9,0,9,0,0,0
2025-06-03 04:45,4,1,3,0,0,0
2025-06-03 05:00,4,0,4,0,0,0
2025-06-03 05:15,16,9,7,0,0,0
2025-06-03 05:30,18,5,13,0,0,0
2025-06-03 05:45,28,17,11,0,0,0
2025-06-03 06:00,26,13,13,0,0,0
2025-06-03 06:15,49,23,26,0,0,0
2025-06-03 06:30,55,30,25,0,0,0
2025-06-03 06:45,84,51,33,0,0,0
2025-06-03 07:00,98,56,42,0,0,0
2025-06-03 07:15,131,58,73,0,0,0
2025-06-03 07:30,171,84,87,0,0,0
2025-06-03 07:45,211,117,94,0,0,0
2025-06-03 08:00,204,96,108,0,0,0
2025-06-03 08:15,161,72,89,0,0,0
2025-06-03 08:30,135,60,75,0,0,0
2025-06-03 08:45,182,94,88,0,0,0
2025-06-03 09:00,126,62,64,0,0,0
2025-06-03 09:15,99,34,65,0,0,0
2025-06-03 09:30,103,33,70,0,0,0
2025-06-03 09:45,129,36,93,0,0,0
2025-06-03 10:00,127,48,79,0,0,0
2025-06-03 10:15,94,45,49,0,0,0
2025-06-03 10:30,85,29,56,0,0,0
2025-06-03 10:45,89,42,47,0,0,0
2025-06-03 11:00,82,34,48,0,0,0
2025-06-03 11:15,91,33,58,0,0,0
2025-06-03 11:30,90,37,53,0,0,0
2025-06-03 11:45,133,53,80,0,0,0
2025-06-03 12:00,129,55,74,0,0,0
2025-06-03 12:15,131,54,77,0,0,0
2025-06-03 12:30,143,78,65,0,0,0
2025-06-03 12:45,140,64,76,0,0,0
2025-06-03 13:00,129,55,74,0,0,0
2025-06-03 13:15,123,63,60,0,0,0
2025-06-03 13:30,115,57,58,0,0,0
2025-06-03 13:45,163,89,74,0,0,0
2025-06-03 14:00,165,99,66,0,0,0
2025-06-03 14:15,154,60,94,0,0,0
2025-06-03 14:30,120,66,54,0,0,0
2025-06-03 14:45,154,82,72,0,0,0
2025-06-03 15:00,142,69,73,0,0,0
2025-06-03 15:15,147,83,64,0,0,0
2025-06-03 15:30,144,75,69,0,0,0
2025-06-03 15:45,157,79,78,0,0,0
2025-06-03 16:00,189,81,108,0,0,0
2025-06-03 16:15,167,89,78,0,0,0
2025-06-03 16:30,210,118,92,0,0,0
2025-06-03 16:45,209,112,97,0,0,0
2025-06-03 17:00,191,91,100,0,0,0
2025-06-03 17:15,202,110,92,0,0,0
2025-06-03 17:30,191,84,107,0,0,0
2025-06-03 17:45,276,149,127,0,0,0
2025-06-03 18:00,223,131,92,0,0,0
2025-06-03 18:15,188,96,92,0,0,0
2025-06-03 18:30,151,82,69,0,0,0
2025-06-03 18:45,182,97,85,0,0,0
2025-06-03 19:00,151,92,59,0,0,0
2025-06-03 19:15,129,72,57,0,0,0
2025-06-03 19:30,119,62,57,0,0,0
2025-06-03 19:45,133,70,63,0,0,0
2025-06-03 20:00,138,77,61,0,0,0
2025-06-03 20:15,102,50,52,0,0,0
2025-06-03 20:30,109,44,65,0,0,0
2025-06-03 20:45,94,50,44,0,0,0
2025-06-03 21:00,91,40,51,0,0,0
2025-06-03 21:15,81,35,46,0,0,0
2025-06-03 21:30,70,32,38,0,0,0
2025-06-03 21:45,65,26,39,0,0,0
2025-06-03 22:00,70,29,41,0,0,0
2025-06-03 22:15,103,36,67,0,0,0
2025-06-03 22:30,56,26,30,0,0,0
2025-06-03 22:45,48,19,29,0,0,0
2025-06-03 23:00,42,15,27,0,0,0
2025-06-03 23:15,37,16,21,0,0,0
2025-06-03 23:30,21,11,10,0,0,0
2025-06-03 23:45,39,8,31,0,0,0
2025-06-04 00:00,18,6,12,0,0,0
2025-06-04 00:15,13,5,8,0,0,0
2025-06-04 00:30,10,4,6,0,0,0
2025-06-04 00:45,12,2,10,0,0,0
2025-06-04 01:00,7,1,6,0,0,0
2025-06-04 01:15,10,2,8,0,0,0
2025-06-04 01:30,7,4,3,0,0,0
2025-06-04 01:45,3,0,3,0,0,0
2025-06-04 02:00,2,0,2,0,0,0
2025-06-04 02:15,2,2,0,0,0,0
2025-06-04 02:30,1,0,1,0,0,0
2025-06-04 02:45,0,0,0,0,0,0
2025-06-04 03:00,5,3,2,0,0,0
2025-06-04 03:15,0,0,0,0,0,0
2025-06-04 03:30,2,2,0,0,0,0
2025-06-04 03:45,3,1,2,0,0,0
2025-06-04 04:00,3,1,2,0,0,0
2025-06-04 04:15,2,0,2,0,0,0
2025-06-04 04:30,7,0,7,0,0,0
2025-06-04 04:45,3,1,2,0,0,0
2025-06-04 05:00,3,2,1,0,0,0
2025-06-04 05:15,27,12,15,0,0,0
2025-06-04 05:30,18,5,13,0,0,0
2025-06-04 05:45,26,16,10,0,0,0
2025-06-04 06:00,26,9,17,0,0,0
2025-06-04 06:15,39,20,19,0,0,0
2025-06-04 06:30,53,26,27,0,0,0
2025-06-04 06:45,96,54,42,0,0,0
2025-06-04 07:00,97,47,50,0,0,0
2025-06-04 07:15,116,48,68,0,0,0
2025-06-04 07:30,189,79,110,0,0,0
2025-06-04 07:45,208,110,98,0,0,0
2025-06-04 08:00,194,96,98,0,0,0
2025-06-04 08:15,163,88,75,0,0,0
2025-06-04 08:30,165,85,80,0,0,0
2025-06-04 08:45,167,81,86,0,0,0
2025-06-04 09:00,111,59,52,0,0,0
2025-06-04 09:15,109,38,71,0,0,0
2025-06-04 09:30,88,38,50,0,0,0
2025-06-04 09:45,128,37,91,0,0,0
2025-06-04 10:00,142,52,90,0,0,0
2025-06-04 10:15,105,38,67,0,0,0
2025-06-04 10:30,104,49,55,0,0,0
2025-06-04 10:45,112,45,67,0,0,0
2025-06-04 11:00,93,50,43,0,0,0
2025-06-04 11:15,98,41,57,0,0,0
2025-06-04 11:30,91,31,60,0,0,0
2025-06-04 11:45,111,36,75,0,0,0
2025-06-04 12:00,127,56,71,0,0,0
2025-06-04 12:15,132,55,77,0,0,0
2025-06-04 12:30,128,65,63,0,0,0
2025-06-04 12:45,131,54,77,0,0,0
2025-06-04 13:00,169,90,79,0,0,0
2025-06-04 13:15,130,65,65,0,0,0
2025-06-04 13:30,116,45,71,0,0,0
2025-06-04 13:45,164,86,78,0,0,0
2025-06-04 14:00,154,77,77,0,0,0
2025-06-04 14:15,131,78,53,0,0,0
2025-06-04 14:30,120,58,62,0,0,0
2025-06-04 14:45,120,54,66,0,0,0
2025-06-04 15:00,125,56,69,0,0,0
2025-06-04 15:15,145,72,73,0,0,0
2025-06-04 15:30,144,66,78,0,0,0
2025-06-04 15:45,164,93,71,0,0,0
2025-06-04 16:00,185,103,82,0,0,0
2025-06-04 16:15,189,102,87,0,0,0
2025-06-04 16:30,183,79,104,0,0,0
2025-06-04 16:45,183,103,80,0,0,0
2025-06-04 17:00,210,106,104,0,0,0
2025-06-04 17:15,180,82,98,0,0,0
2025-06-04 17:30,179,81,98,0,0,0
2025-06-04 17:45,228,124,104,0,0,0
2025-06-04 18:00,195,105,90,0,0,0
2025-06-04 18:15,171,87,84,0,0,0
2025-06-04 18:30,156,68,88,0,0,0
2025-06-04 18:45,159,85,74,0,0,0
2025-06-04 19:00,127,73,54,0,0,0
2025-06-04 19:15,112,69,43,0,0,0
2025-06-04 19:30,138,85,53,0,0,0
2025-06-04 19:45,113,58,55,0,0,0
2025-06-04 20:00,100,49,51,0,0,0
2025-06-04 20:15,101,58,43,0,0,0
2025-06-04 20:30,70,26,44,0,0,0
2025-06-04 20:45,85,50,35,0,0,0
2025-06-04 21:00,63,16,47,0,0,0
2025-06-04 21:15,69,34,35,0,0,0
2025-06-04 21:30,58,17,41,0,0,0
2025-06-04 21:45,75,31,44,0,0,0
2025-06-04 22:00,65,29,36,0,0,0
2025-06-04 22:15,47,23,24,0,0,0
2025-06-04 22:30,41,14,27,0,0,0
2025-06-04 22:45,54,34,20,0,0,0
2025-06-04 23:00,39,17,22,0,0,0
2025-06-04 23:15,58,26,32,0,0,0
2025-06-04 23:30,30,10,20,0,0,0
2025-06-04 23:45,21,15,6,0,0,0
2025-06-05 00:00,29,10,19,0,0,0
2025-06-05 00:15,17,11,6,0,0,0
2025-06-05 00:30,10,5,5,0,0,0
2025-06-05 00:45,14,2,12,0,0,0
2025-06-05 01:00,12,6,6,0,0,0
2025-06-05 01:15,12,4,8,0,0,0
2025-06-05 01:30,11,2,9,0,0,0
2025-06-05 01:45,3,3,0,0,0,0
2025-06-05 02:00,10,5,5,0,0,0
2025-06-05 02:15,1,1,0,0,0,0
2025-06-05 02:30,0,0,0,0,0,0
2025-06-05 02:45,5,3,2,0,0,0
2025-06-05 03:00,5,3,2,0,0,0
2025-06-05 03:15,7,2,5,0,0,0
2025-06-05 03:30,7,5,2,0,0,0
2025-06-05 03:45,0,0,0,0,0,0
2025-06-05 04:00,2,2,0,0,0,0
2025-06-05 04:15,3,2,1,0,0,0
2025-06-05 04:30,6,1,5,0,0,0
2025-06-05 04:45,11,2,9,0,0,0
2025-06-05 05:00,2,0,2,0,0,0
2025-06-05 05:15,15,6,9,0,0,0
2025-06-05 05:30,25,8,17,0,0,0
2025-06-05 05:45,25,13,12,0,0,0
2025-06-05 06:00,19,8,11,0,0,0
2025-06-05 06:15,42,21,21,0,0,0
2025-06-05 06:30,47,25,22,0,0,0
2025-06-05 06:45,78,39,39,0,0,0
2025-06-05 07:00,75,42,33,0,0,0
2025-06-05 07:15,107,55,52,0,0,0
2025-06-05 07:30,204,81,123,0,0,0
2025-06-05 07:45,165,91,74,0,0,0
2025-06-05 08:00,171,88,83,0,0,0
2025-06-05 08:15,170,77,93,0,0,0
2025-06-05 08:30,162,90,72,0,0,0
2025-06-05 08:45,155,78,77,0,0,0
2025-06-05 09:00,104,52,52,0,0,0
2025-06-05 09:15,94,44,50,0,0,0
2025-06-05 09:30,82,35,47,0,0,0
2025-06-05 09:45,128,36,92,0,0,0
2025-06-05 10:00,140,41,99,0,0,0
2025-06-05 10:15,77,35,42,0,0,0
2025-06-05 10:30,79,25,54,0,0,0
2025-06-05 10:45,89,37,52,0,0,0
2025-06-05 11:00,61,25,36,0,0,0
2025-06-05 11:15,88,27,61,0,0,0
2025-06-05 11:30,88,30,58,0,0,0
2025-06-05 11:45,110,58,52,0,0,0
2025-06-05 12:00,128,51,77,0,0,0
2025-06-05 12:15,103,54,49,0,0,0
2025-06-05 12:30,120,64,56,0,0,0
2025-06-05 12:45,85,35,50,0,0,0
2025-06-05 13:00,120,53,67,0,0,0
2025-06-05 13:15,122,47,75,0,0,0
2025-06-05 13:30,96,46,50,0,0,0
2025-06-05 13:45,141,69,72,0,0,0
2025-06-05 14:00,148,71,77,0,0,0
2025-06-05 14:15,97,52,45,0,0,0
2025-06-05 14:30,139,52,87,0,0,0
2025-06-05 14:45,114,53,61,0,0,0
2025-06-05 15:00,111,58,53,0,0,0
2025-06-05 15:15,109,62,47,0,0,0
2025-06-05 15:30,123,58,65,0,0,0
2025-06-05 15:45,122,58,64,0,0,0
2025-06-05 16:00,85,43,42,0,0,0
2025-06-05 16:15,121,56,65,0,0,0
2025-06-05 16:30,139,53,86,0,0,0
2025-06-05 16:45,152,85,67,0,0,0
2025-06-05 17:00,159,65,94,0,0,0
2025-06-05 17:15,169,75,94,0,0,0
2025-06-05 17:30,142,67,75,0,0,0
2025-06-05 17:45,172,84,88,0,0,0
2025-06-05 18:00,155,75,80,0,0,0
2025-06-05 18:15,148,72,76,0,0,0
2025-06-05 18:30,131,67,64,0,0,0
2025-06-05 18:45,150,81,69,0,0,0
2025-06-05 19:00,110,41,69,0,0,0
2025-06-05 19:15,125,77,48,0,0,0
2025-06-05 19:30,89,51,38,0,0,0
2025-06-05 19:45,97,52,45,0,0,0
2025-06-05 20:00,82,52,30,0,0,0
2025-06-05 20:15,96,44,52,0,0,0
2025-06-05 20:30,74,38,36,0,0,0
2025-06-05 20:45,76,40,36,0,0,0
2025-06-05 21:00,85,41,44,0,0,0
2025-06-05 21:15,69,26,43,0,0,0
2025-06-05 21:30,50,21,29,0,0,0
2025-06-05 21:45,56,29,27,0,0,0
2025-06-05 22:00,54,22,32,0,0,0
2025-06-05 22:15,40,17,23,0,0,0
2025-06-05 22:30,49,19,30,0,0,0
2025-06-05 22:45,36,12,24,0,0,0
2025-06-05 23:00,36,13,23,0,0,0
2025-06-05 23:15,60,32,28,0,0,0
2025-06-05 23:30,58,45,13,0,0,0
2025-06-05 23:45,85,74,11,0,0,0
2025-06-06 00:00,49,32,17,0,0,0
2025-06-06 00:15,35,23,12,0,0,0
2025-06-06 00:30,25,5,20,0,0,0
2025-06-06 00:45,30,24,6,0,0,0
2025-06-06 01:00,12,4,8,0,0,0
2025-06-06 01:15,12,1,11,0,0,0
2025-06-06 01:30,8,0,8,0,0,0
2025-06-06 01:45,14,0,14,0,0,0
2025-06-06 02:00,34,1,33,0,0,0
2025-06-06 02:15,25,1,24,0,0,0
2025-06-06 02:30,16,0,16,0,0,0
2025-06-06 02:45,29,0,29,0,0,0
2025-06-06 03:00,28,1,27,0,0,0
2025-06-06 03:15,30,2,28,0,0,0
2025-06-06 03:30,26,1,25,0,0,0
2025-06-06 03:45,22,1,21,0,0,0
2025-06-06 04:00,27,1,26,0,0,0
2025-06-06 04:15,17,3,14,0,0,0
2025-06-06 04:30,10,0,10,0,0,0
2025-06-06 04:45,14,1,13,0,0,0
2025-06-06 05:00,1,0,1,0,0,0
2025-06-06 05:15,6,3,3,0,0,0
2025-06-06 05:30,15,6,9,0,0,0
2025-06-06 05:45,16,10,6,0,0,0
2025-06-06 06:00,20,14,6,0,0,0
2025-06-06 06:15,39,18,21,0,0,0
2025-06-06 06:30,43,14,29,0,0,0
2025-06-06 06:45,55,30,25,0,0,0
2025-06-06 07:00,65,28,37,0,0,0
2025-06-06 07:15,94,32,62,0,0,0
2025-06-06 07:30,121,37,84,0,0,0
2025-06-06 07:45,152,70,82,0,0,0
2025-06-06 08:00,113,50,63,0,0,0
2025-06-06 08:15,112,59,53,0,0,0
2025-06-06 08:30,121,65,56,0,0,0
2025-06-06 08:45,125,58,67,0,0,0
2025-06-06 09:00,95,51,44,0,0,0
2025-06-06 09:15,97,39,58,0,0,0
2025-06-06 09:30,99,39,60,0,0,0
2025-06-06 09:45,116,48,68,0,0,0
2025-06-06 10:00,92,25,67,0,0,0
2025-06-06 10:15,68,33,35,0,0,0
2025-06-06 10:30,88,46,42,0,0,0
2025-06-06 10:45,71,25,46,0,0,0
2025-06-06 11:00,89,45,44,0,0,0
2025-06-06 11:15,73,32,41,0,0,0
2025-06-06 11:30,65,31,34,0,0,0
2025-06-06 11:45,111,32,79,0,0,0
2025-06-06 12:00,118,38,80,0,0,0
2025-06-06 12:15,107,58,49,0,0,0
2025-06-06 12:30,107,56,51,0,0,0
2025-06-06 12:45,134,62,72,0,0,0
2025-06-06 13:00,130,58,72,0,0,0
2025-06-06 13:15,113,51,62,0,0,0
2025-06-06 13:30,130,56,74,0,0,0
2025-06-06 13:45,135,70,65,0,0,0
2025-06-06 14:00,138,68,70,0,0,0
2025-06-06 14:15,93,40,53,0,0,0
2025-06-06 14:30,123,52,71,0,0,0
2025-06-06 14:45,114,53,61,0,0,0
2025-06-06 15:00,120,57,63,0,0,0
2025-06-06 15:15,120,60,60,0,0,0
2025-06-06 15:30,132,68,64,0,0,0
2025-06-06 15:45,130,68,62,0,0,0
2025-06-06 16:00,119,53,66,0,0,0
2025-06-06 16:15,131,65,66,0,0,0
2025-06-06 16:30,129,64,65,0,0,0
2025-06-06 16:45,141,69,72,0,0,0
2025-06-06 17:00,120,53,67,0,0,0
2025-06-06 17:15,133,65,68,0,0,0
2025-06-06 17:30,114,55,59,0,0,0
2025-06-06 17:45,145,86,59,0,0,0
2025-06-06 18:00,118,70,48,0,0,0
2025-06-06 18:15,122,56,66,0,0,0
2025-06-06 18:30,108,57,51,0,0,0
2025-06-06 18:45,120,67,53,0,0,0
2025-06-06 19:00,101,48,53,0,0,0
2025-06-06 19:15,132,65,67,0,0,0
2025-06-06 19:30,111,64,47,0,0,0
2025-06-06 19:45,88,53,35,0,0,0
2025-06-06 20:00,70,37,33,0,0,0
2025-06-06 20:15,79,33,46,0,0,0
2025-06-06 20:30,48,18,30,0,0,0
2025-06-06 20:45,55,22,33,0,0,0
2025-06-06 21:00,71,35,36,0,0,0
2025-06-06 21:15,59,24,35,0,0,0
2025-06-06 21:30,47,16,31,0,0,0
2025-06-06 21:45,56,17,39,0,0,0
2025-06-06 22:00,50,22,28,0,0,0
2025-06-06 22:15,63,31,32,0,0,0
2025-06-06 22:30,59,25,34,0,0,0
2025-06-06 22:45,35,16,19,0,0,0
2025-06-06 23:00,58,13,45,0,0,0
2025-06-06 23:15,62,28,34,0,0,0
2025-06-06 23:30,58,28,30,0,0,0
2025-06-06 23:45,41,22,19,0,0,0
2025-06-07 00:00,33,19,14,0,0,0
2025-06-07 00:15,62,23,39,0,0,0
2025-06-07 00:30,25,9,16,0,0,0
2025-06-07 00:45,30,11,19,0,0,0
2025-06-07 01:00,23,6,17,0,0,0
2025-06-07 01:15,33,12,21,0,0,0
2025-06-07 01:30,18,12,6,0,0,0
2025-06-07 01:45,26,7,19,0,0,0
2025-06-07 02:00,13,8,5,0,0,0
2025-06-07 02:15,15,5,10,0,0,0
2025-06-07 02:30,20,7,13,0,0,0
2025-06-07 02:45,11,4,7,0,0,0
2025-06-07 03:00,32,12,20,0,0,0
2025-06-07 03:15,22,10,12,0,0,0
2025-06-07 03:30,7,1,6,0,0,0
2025-06-07 03:45,4,1,3,0,0,0
2025-06-07 04:00,4,3,1,0,0,0
2025-06-07 04:15,4,2,2,0,0,0
2025-06-07 04:30,5,1,4,0,0,0
2025-06-07 04:45,9,3,6,0,0,0
2025-06-07 05:00,0,0,0,0,0,0
2025-06-07 05:15,8,2,6,0,0,0
2025-06-07 05:30,5,3,2,0,0,0
2025-06-07 05:45,13,1,12,0,0,0
2025-06-07 06:00,6,2,4,0,0,0
2025-06-07 06:15,5,2,3,0,0,0
2025-06-07 06:30,11,3,8,0,0,0
2025-06-07 06:45,13,6,7,0,0,0
2025-06-07 07:00,6,3,3,0,0,0
2025-06-07 07:15,11,2,9,0,0,0
2025-06-07 07:30,20,12,8,0,0,0
2025-06-07 07:45,24,6,18,0,0,0
2025-06-07 08:00,16,3,13,0,0,0
2025-06-07 08:15,28,10,18,0,0,0
2025-06-07 08:30,19,5,14,0,0,0
2025-06-07 08:45,29,17,12,0,0,0
2025-06-07 09:00,29,11,18,0,0,0
2025-06-07 09:15,32,13,19,0,0,0
2025-06-07 09:30,35,11,24,0,0,0
2025-06-07 09:45,56,18,38,0,0,0
2025-06-07 10:00,72,24,48,0,0,0
2025-06-07 10:15,43,20,23,0,0,0
2025-06-07 10:30,60,20,40,0,0,0
2025-06-07 10:45,73,33,40,0,0,0
2025-06-07 11:00,67,24,43,0,0,0
2025-06-07 11:15,51,21,30,0,0,0
2025-06-07 11:30,61,23,38,0,0,0
2025-06-07 11:45,76,30,46,0,0,0
2025-06-07 12:00,68,19,49,0,0,0
2025-06-07 12:15,76,32,44,0,0,0
2025-06-07 12:30,50,11,39,0,0,0
2025-06-07 12:45,68,35,33,0,0,0
2025-06-07 13:00,55,20,35,0,0,0
2025-06-07 13:15,73,28,45,0,0,0
2025-06-07 13:30,74,24,50,0,0,0
2025-06-07 13:45,71,23,48,0,0,0
2025-06-07 14:00,76,33,43,0,0,0
2025-06-07 14:15,106,48,58,0,0,0
2025-06-07 14:30,78,34,44,0,0,0
2025-06-07 14:45,93,50,43,0,0,0
2025-06-07 15:00,82,33,49,0,0,0
2025-06-07 15:15,65,26,39,0,0,0
2025-06-07 15:30,71,24,47,0,0,0
2025-06-07 15:45,82,28,54,0,0,0
2025-06-07 16:00,80,37,43,0,0,0
2025-06-07 16:15,71,31,40,0,0,0
2025-06-07 16:30,60,26,34,0,0,0
2025-06-07 16:45,62,35,27,0,0,0
2025-06-07 17:00,67,37,30,0,0,0
2025-06-07 17:15,49,19,30,0,0,0
2025-06-07 17:30,75,38,37,0,0,0
2025-06-07 17:45,70,39,31,0,0,0
2025-06-07 18:00,53,26,27,0,0,0
2025-06-07 18:15,73,35,38,0,0,0
2025-06-07 18:30,71,29,42,0,0,0
2025-06-07 18:45,74,36,38,0,0,0
2025-06-07 19:00,65,28,37,0,0,0
2025-06-07 19:15,63,37,26,0,0,0
2025-06-07 19:30,62,23,39,0,0,0
2025-06-07 19:45,57,25,32,0,0,0
2025-06-07 20:00,53,32,21,0,0,0
2025-06-07 20:15,75,37,38,0,0,0
2025-06-07 20:30,68,41,27,0,0,0
2025-06-07 20:45,52,24,28,0,0,0
2025-06-07 21:00,54,21,33,0,0,0
2025-06-07 21:15,29,15,14,0,0,0
2025-06-07 21:30,50,23,27,0,0,0
2025-06-07 21:45,38,13,25,0,0,0
2025-06-07 22:00,27,9,18,0,0,0
2025-06-07 22:15,49,24,25,0,0,0
2025-06-07 22:30,24,6,18,0,0,0
2025-06-07 22:45,28,9,19,0,0,0
2025-06-07 23:00,40,17,23,0,0,0
2025-06-07 23:15,54,17,37,0,0,0
2025-06-07 23:30,55,22,33,0,0,0
2025-06-07 23:45,39,19,20,0,0,0
2025-06-08 00:00,41,16,25,0,0,0
2025-06-08 00:15,38,19,19,0,0,0
2025-06-08 00:30,42,17,25,0,0,0
2025-06-08 00:45,45,19,26,0,0,0
2025-06-08 01:00,34,9,25,0,0,0
2025-06-08 01:15,23,11,12,0,0,0
2025-06-08 01:30,23,7,16,0,0,0
2025-06-08 01:45,20,8,12,0,0,0
2025-06-08 02:00,13,1,12,0,0,0
2025-06-08 02:15,24,4,20,0,0,0
2025-06-08 02:30,10,2,8,0,0,0
2025-06-08 02:45,18,2,16,0,0,0
2025-06-08 03:00,23,6,17,0,0,0
2025-06-08 03:15,13,3,10,0,0,0
2025-06-08 03:30,11,1,10,0,0,0
2025-06-08 03:45,10,0,10,0,0,0
2025-06-08 04:00,11,2,9,0,0,0
2025-06-08 04:15,7,2,5,0,0,0
2025-06-08 04:30,6,0,6,0,0,0
2025-06-08 04:45,9,2,7,0,0,0
2025-06-08 05:00,2,1,1,0,0,0
2025-06-08 05:15,8,0,8,0,0,0
2025-06-08 05:30,6,2,4,0,0,0
2025-06-08 05:45,5,0,5,0,0,0
2025-06-08 06:00,8,5,3,0,0,0
2025-06-08 06:15,5,2,3,0,0,0
2025-06-08 06:30,6,1,5,0,0,0
2025-06-08 06:45,4,2,2,0,0,0
2025-06-08 07:00,2,1,1,0,0,0
2025-06-08 07:15,3,3,0,0,0,0
2025-06-08 07:30,6,0,6,0,0,0
2025-06-08 07:45,11,9,2,0,0,0
2025-06-08 08:00,15,4,11,0,0,0
2025-06-08 08:15,8,4,4,0,0,0
2025-06-08 08:30,11,7,4,0,0,0
2025-06-08 08:45,18,10,8,0,0,0
2025-06-08 09:00,9,5,4,0,0,0
2025-06-08 09:15,17,5,12,0,0,0
2025-06-08 09:30,27,9,18,0,0,0
2025-06-08 09:45,40,23,17,0,0,0
2025-06-08 10:00,31,17,14,0,0,0
2025-06-08 10:15,34,23,11,0,0,0
2025-06-08 10:30,40,23,17,0,0,0
2025-06-08 10:45,52,31,21,0,0,0
2025-06-08 11:00,34,17,17,0,0,0
2025-06-08 11:15,47,28,19,0,0,0
2025-06-08 11:30,47,14,33,0,0,0
2025-06-08 11:45,52,17,35,0,0,0
2025-06-08 12:00,35,4,31,0,0,0
2025-06-08 12:15,44,11,33,0,0,0
2025-06-08 12:30,44,22,22,0,0,0
2025-06-08 12:45,52,16,36,0,0,0
2025-06-08 13:00,36,15,21,0,0,0
2025-06-08 13:15,27,12,15,0,0,0
2025-06-08 13:30,43,21,22,0,0,0
2025-06-08 13:45,52,13,39,0,0,0
2025-06-08 14:00,60,25,35,0,0,0
2025-06-08 14:15,49,18,31,0,0,0
2025-06-08 14:30,71,28,43,0,0,0
2025-06-08 14:45,47,20,27,0,0,0
2025-06-08 15:00,41,16,25,0,0,0
2025-06-08 15:15,33,12,21,0,0,0
2025-06-08 15:30,52,21,31,0,0,0
2025-06-08 15:45,51,20,31,0,0,0
2025-06-08 16:00,55,21,34,0,0,0
2025-06-08 16:15,46,17,29,0,0,0
2025-06-08 16:30,41,11,30,0,0,0
2025-06-08 16:45,54,25,29,0,0,0
2025-06-08 17:00,52,13,39,0,0,0
2025-06-08 17:15,35,13,22,0,0,0
2025-06-08 17:30,47,19,28,0,0,0
2025-06-08 17:45,37,13,24,0,0,0
2025-06-08 18:00,38,7,31,0,0,0
2025-06-08 18:15,43,13,30,0,0,0
2025-06-08 18:30,38,18,20,0,0,0
2025-06-08 18:45,41,19,22,0,0,0
2025-06-08 19:00,41,15,26,0,0,0
2025-06-08 19:15,43,14,29,0,0,0
2025-06-08 19:30,38,18,20,0,0,0
2025-06-08 19:45,37,20,17,0,0,0
2025-06-08 20:00,36,18,18,0,0,0
2025-06-08 20:15,40,14,26,0,0,0
2025-06-08 20:30,36,14,22,0,0,0
2025-06-08 20:45,29,11,18,0,0,0
2025-06-08 21:00,21,8,13,0,0,0
2025-06-08 21:15,34,16,18,0,0,0
2025-06-08 21:30,24,12,12,0,0,0
2025-06-08 21:45,30,12,18,0,0,0
2025-06-08 22:00,25,12,13,0,0,0
2025-06-08 22:15,27,12,15,0,0,0
2025-06-08 22:30,17,6,11,0,0,0
2025-06-08 22:45,20,7,13,0,0,0
2025-06-08 23:00,23,6,17,0,0,0
2025-06-08 23:15,22,7,15,0,0,0
2025-06-08 23:30,23,6,17,0,0,0
2025-06-08 23:45,26,12,14,0,0,0
2025-06-09 00:00,30,13,17,0,0,0
2025-06-09 00:15,26,12,14,0,0,0
2025-06-09 00:30,9,3,6,0,0,0
2025-06-09 00:45,29,16,13,0,0,0
2025-06-09 01:00,17,10,7,0,0,0
2025-06-09 01:15,11,5,6,0,0,0
2025-06-09 01:30,7,4,3,0,0,0
2025-06-09 01:45,11,5,6,0,0,0
2025-06-09 02:00,8,1,7,0,0,0
2025-06-09 02:15,7,1,6,0,0,0
2025-06-09 02:30,2,1,1,0,0,0
2025-06-09 02:45,5,1,4,0,0,0
2025-06-09 03:00,7,0,7,0,0,0
2025-06-09 03:15,6,0,6,0,0,0
2025-06-09 03:30,4,0,4,0,0,0
2025-06-09 03:45,10,0,10,0,0,0
2025-06-09 04:00,10,2,8,0,0,0
2025-06-09 04:15,5,1,4,0,0,0
2025-06-09 04:30,4,0,4,0,0,0
2025-06-09 04:45,11,0,11,0,0,0
2025-06-09 05:00,1,0,1,0,0,0
2025-06-09 05:15,6,0,6,0,0,0
2025-06-09 05:30,8,1,7,0,0,0
2025-06-09 05:45,7,4,3,0,0,0
2025-06-09 06:00,9,2,7,0,0,0
2025-06-09 06:15,6,1,5,0,0,0
2025-06-09 06:30,6,2,4,0,0,0
2025-06-09 06:45,1,0,1,0,0,0
2025-06-09 07:00,6,3,3,0,0,0
2025-06-09 07:15,4,2,2,0,0,0
2025-06-09 07:30,6,3,3,0,0,0
2025-06-09 07:45,9,2,7,0,0,0
2025-06-09 08:00,11,0,11,0,0,0
2025-06-09 08:15,9,2,7,0,0,0
2025-06-09 08:30,9,5,4,0,0,0
2025-06-09 08:45,14,7,7,0,0,0
2025-06-09 09:00,13,5,8,0,0,0
2025-06-09 09:15,19,4,15,0,0,0
2025-06-09 09:30,29,7,22,0,0,0
2025-06-09 09:45,51,26,25,0,0,0
2025-06-09 10:00,36,17,19,0,0,0
2025-06-09 10:15,34,20,14,0,0,0
2025-06-09 10:30,37,20,17,0,0,0
2025-06-09 10:45,59,31,28,0,0,0
2025-06-09 11:00,34,18,16,0,0,0
2025-06-09 11:15,45,14,31,0,0,0
2025-06-09 11:30,58,23,35,0,0,0
2025-06-09 11:45,64,29,35,0,0,0
2025-06-09 12:00,51,19,32,0,0,0
2025-06-09 12:15,54,23,31,0,0,0
2025-06-09 12:30,49,23,26,0,0,0
2025-06-09 12:45,66,28,38,0,0,0
2025-06-09 13:00,66,27,39,0,0,0
2025-06-09 13:15,54,20,34,0,0,0
2025-06-09 13:30,69,31,38,0,0,0
2025-06-09 13:45,93,39,54,0,0,0
2025-06-09 14:00,90,31,59,0,0,0
2025-06-09 14:15,77,37,40,0,0,0
2025-06-09 14:30,70,31,39,0,0,0
2025-06-09 14:45,110,46,64,0,0,0
2025-06-09 15:00,62,30,32,0,0,0
2025-06-09 15:15,93,51,42,0,0,0
2025-06-09 15:30,71,34,37,0,0,0
2025-06-09 15:45,73,29,44,0,0,0
2025-06-09 16:00,89,36,53,0,0,0
2025-06-09 16:15,97,36,61,0,0,0
2025-06-09 16:30,77,40,37,0,0,0
2025-06-09 16:45,78,45,33,0,0,0
2025-06-09 17:00,82,43,39,0,0,0
2025-06-09 17:15,73,27,46,0,0,0
2025-06-09 17:30,83,42,41,0,0,0
2025-06-09 17:45,102,33,69,0,0,0
2025-06-09 18:00,67,39,28,0,0,0
2025-06-09 18:15,70,29,41,0,0,0
2025-06-09 18:30,58,28,30,0,0,0
2025-06-09 18:45,59,24,35,0,0,0
2025-06-09 19:00,70,27,43,0,0,0
2025-06-09 19:15,69,37,32,0,0,0
2025-06-09 19:30,72,33,39,0,0,0
2025-06-09 19:45,54,23,31,0,0,0
2025-06-09 20:00,54,24,30,0,0,0
2025-06-09 20:15,59,23,36,0,0,0
2025-06-09 20:30,46,12,34,0,0,0
2025-06-09 20:45,45,19,26,0,0,0
2025-06-09 21:00,53,26,27,0,0,0
2025-06-09 21:15,30,11,19,0,0,0
2025-06-09 21:30,28,11,17,0,0,0
2025-06-09 21:45,31,13,18,0,0,0
2025-06-09 22:00,27,8,19,0,0,0
2025-06-09 22:15,35,13,22,0,0,0
2025-06-09 22:30,18,10,8,0,0,0
2025-06-09 22:45,18,7,11,0,0,0
2025-06-09 23:00,40,12,28,0,0,0
2025-06-09 23:15,20,7,13,0,0,0
2025-06-09 23:30,20,7,13,0,0,0
2025-06-09 23:45,16,7,9,0,0,0
2025-06-10 00:00,23,10,13,0,0,0
2025-06-10 00:15,5,0,5,0,0,0
2025-06-10 00:30,12,4,8,0,0,0
2025-06-10 00:45,2,0,2,0,0,0
2025-06-10 01:00,1,0,1,0,0,0
2025-06-10 01:15,6,2,4,0,0,0
2025-06-10 01:30,3,1,2,0,0,0
2025-06-10 01:45,4,1,3,0,0,0
2025-06-10 02:00,5,2,3,0,0,0
2025-06-10 02:15,1,0,1,0,0,0
2025-06-10 02:30,0,0,0,0,0,0
2025-06-10 02:45,0,0,0,0,0,0
2025-06-10 03:00,1,0,1,0,0,0
2025-06-10 03:15,1,0,1,0,0,0
2025-06-10 03:30,3,2,1,0,0,0
2025-06-10 03:45,0,0,0,0,0,0
2025-06-10 04:00,1,1,0,0,0,0
2025-06-10 04:15,1,1,0,0,0,0
2025-06-10 04:30,11,2,9,0,0,0
2025-06-10 04:45,8,4,4,0,0,0
2025-06-10 05:00,4,2,2,0,0,0
2025-06-10 05:15,10,4,6,0,0,0
2025-06-10 05:30,21,6,15,0,0,0
2025-06-10 05:45,22,12,10,0,0,0
2025-06-10 06:00,32,12,20,0,0,0
2025-06-10 06:15,39,23,16,0,0,0
2025-06-10 06:30,55,18,37,0,0,0
2025-06-10 06:45,71,35,36,0,0,0
2025-06-10 07:00,77,42,35,0,0,0
2025-06-10 07:15,74,38,36,0,0,0
2025-06-10 07:30,104,64,40,0,0,0
2025-06-10 07:45,185,103,82,0,0,0
2025-06-10 08:00,143,73,70,0,0,0
2025-06-10 08:15,108,63,45,0,0,0
2025-06-10 08:30,133,75,58,0,0,0
2025-06-10 08:45,141,84,57,0,0,0
2025-06-10 09:00,95,50,45,0,0,0
2025-06-10 09:15,81,37,44,0,0,0
2025-06-10 09:30,77,22,55,0,0,0
2025-06-10 09:45,104,31,73,0,0,0
2025-06-10 10:00,88,32,56,0,0,0
2025-06-10 10:15,87,29,58,0,0,0
2025-06-10 10:30,96,40,56,0,0,0
2025-06-10 10:45,67,34,33,0,0,0
2025-06-10 11:00,89,36,53,0,0,0
2025-06-10 11:15,94,42,52,0,0,0
2025-06-10 11:30,73,34,39,0,0,0
2025-06-10 11:45,95,34,61,0,0,0
2025-06-10 12:00,103,62,41,0,0,0
2025-06-10 12:15,98,37,61,0,0,0
2025-06-10 12:30,114,41,73,0,0,0
2025-06-10 12:45,87,42,45,0,0,0
2025-06-10 13:00,91,43,48,0,0,0
2025-06-10 13:15,90,47,43,0,0,0
2025-06-10 13:30,96,44,52,0,0,0
2025-06-10 13:45,110,59,51,0,0,0
2025-06-10 14:00,116,53,63,0,0,0
2025-06-10 14:15,86,41,45,0,0,0
2025-06-10 14:30,83,37,46,0,0,0
2025-06-10 14:45,99,42,57,0,0,0
2025-06-10 15:00,100,47,53,0,0,0
2025-06-10 15:15,95,37,58,0,0,0
2025-06-10 15:30,112,53,59,0,0,0
2025-06-10 15:45,103,50,53,0,0,0
2025-06-10 16:00,146,68,78,0,0,0
2025-06-10 16:15,139,55,84,0,0,0
2025-06-10 16:30,152,72,80,0,0,0
2025-06-10 16:45,135,54,81,0,0,0
2025-06-10 17:00,184,78,106,0,0,0
2025-06-10 17:15,168,56,112,0,0,0
2025-06-10 17:30,173,71,102,0,0,0
2025-06-10 17:45,147,66,81,0,0,0
2025-06-10 18:00,131,53,78,0,0,0
2025-06-10 18:15,143,74,69,0,0,0
2025-06-10 18:30,128,60,68,0,0,0
2025-06-10 18:45,91,50,41,0,0,0
2025-06-10 19:00,137,82,55,0,0,0
2025-06-10 19:15,125,67,58,0,0,0
2025-06-10 19:30,113,52,61,0,0,0
2025-06-10 19:45,91,49,42,0,0,0
2025-06-10 20:00,97,42,55,0,0,0
2025-06-10 20:15,84,40,44,0,0,0
2025-06-10 20:30,59,17,42,0,0,0
2025-06-10 20:45,54,28,26,0,0,0
2025-06-10 21:00,60,22,38,0,0,0
2025-06-10 21:15,43,18,25,0,0,0
2025-06-10 21:30,48,21,27,0,0,0
2025-06-10 21:45,50,29,21,0,0,0
2025-06-10 22:00,59,26,33,0,0,0
2025-06-10 22:15,54,26,28,0,0,0
2025-06-10 22:30,89,12,77,0,0,0
2025-06-10 22:45,78,15,63,0,0,0
2025-06-10 23:00,51,9,42,0,0,0
2025-06-10 23:15,41,12,29,0,0,0
2025-06-10 23:30,12,3,9,0,0,0
2025-06-10 23:45,15,5,10,0,0,0
2025-06-11 00:00,12,5,7,0,0,0
2025-06-11 00:15,9,3,6,0,0,0
2025-06-11 00:30,4,3,1,0,0,0
2025-06-11 00:45,2,0,2,0,0,0
2025-06-11 01:00,4,0,4,0,0,0
2025-06-11 01:15,5,2,3,0,0,0
2025-06-11 01:30,7,5,2,0,0,0
2025-06-11 01:45,5,2,3,0,0,0
2025-06-11 02:00,6,2,4,0,0,0
2025-06-11 02:15,0,0,0,0,0,0
2025-06-11 02:30,0,0,0,0,0,0
2025-06-11 02:45,0,0,0,0,0,0
2025-06-11 03:00,3,3,0,0,0,0
2025-06-11 03:15,2,1,1,0,0,0
2025-06-11 03:30,5,4,1,0,0,0
2025-06-11 03:45,3,3,0,0,0,0
2025-06-11 04:00,1,0,1,0,0,0
2025-06-11 04:15,3,1,2,0,0,0
2025-06-11 04:30,11,2,9,0,0,0
2025-06-11 04:45,12,6,6,0,0,0
2025-06-11 05:00,5,3,2,0,0,0
2025-06-11 05:15,10,4,6,0,0,0
2025-06-11 05:30,20,9,11,0,0,0
2025-06-11 05:45,19,10,9,0,0,0
2025-06-11 06:00,33,13,20,0,0,0
2025-06-11 06:15,42,16,26,0,0,0
2025-06-11 06:30,49,23,26,0,0,0
2025-06-11 06:45,79,41,38,0,0,0
2025-06-11 07:00,87,51,36,0,0,0
2025-06-11 07:15,112,48,64,0,0,0
2025-06-11 07:30,149,69,80,0,0,0
2025-06-11 07:45,181,104,77,0,0,0
2025-06-11 08:00,152,88,64,0,0,0
2025-06-11 08:15,166,91,75,0,0,0
2025-06-11 08:30,146,82,64,0,0,0
2025-06-11 08:45,164,80,84,0,0,0
2025-06-11 09:00,114,49,65,0,0,0
2025-06-11 09:15,90,43,47,0,0,0
2025-06-11 09:30,90,39,51,0,0,0
2025-06-11 09:45,131,45,86,0,0,0
2025-06-11 10:00,101,49,52,0,0,0
2025-06-11 10:15,92,43,49,0,0,0
2025-06-11 10:30,94,34,60,0,0,0
2025-06-11 10:45,114,55,59,0,0,0
2025-06-11 11:00,121,47,74,0,0,0
2025-06-11 11:15,97,48,49,0,0,0
2025-06-11 11:30,91,37,54,0,0,0
2025-06-11 11:45,97,42,55,0,0,0
2025-06-11 12:00,89,37,52,0,0,0
2025-06-11 12:15,108,38,70,0,0,0
2025-06-11 12:30,134,70,64,0,0,0
2025-06-11 12:45,133,61,72,0,0,0
2025-06-11 13:00,135,67,68,0,0,0
2025-06-11 13:15,121,69,52,0,0,0
2025-06-11 13:30,132,56,76,0,0,0
2025-06-11 13:45,144,76,68,0,0,0
2025-06-11 14:00,125,63,62,0,0,0
2025-06-11 14:15,120,65,55,0,0,0
2025-06-11 14:30,137,76,61,0,0,0
2025-06-11 14:45,144,72,72,0,0,0
2025-06-11 15:00,163,103,60,0,0,0
2025-06-11 15:15,134,63,71,0,0,0
2025-06-11 15:30,150,76,74,0,0,0
2025-06-11 15:45,167,92,75,0,0,0
2025-06-11 16:00,136,86,50,0,0,0
2025-06-11 16:15,183,103,80,0,0,0
2025-06-11 16:30,160,89,71,0,0,0
2025-06-11 16:45,196,101,95,0,0,0
2025-06-11 17:00,189,91,98,0,0,0
2025-06-11 17:15,176,70,106,0,0,0
2025-06-11 17:30,235,136,99,0,0,0
2025-06-11 17:45,225,100,125,0,0,0
2025-06-11 18:00,180,91,89,0,0,0
2025-06-11 18:15,166,88,78,0,0,0
2025-06-11 18:30,151,76,75,0,0,0
2025-06-11 18:45,143,79,64,0,0,0
2025-06-11 19:00,157,85,72,0,0,0
2025-06-11 19:15,111,68,43,0,0,0
2025-06-11 19:30,97,43,54,0,0,0
2025-06-11 19:45,130,64,66,0,0,0
2025-06-11 20:00,87,43,44,0,0,0
2025-06-11 20:15,92,62,30,0,0,0
2025-06-11 20:30,94,47,47,0,0,0
2025-06-11 20:45,80,25,55,0,0,0
2025-06-11 21:00,101,49,52,0,0,0
2025-06-11 21:15,83,41,42,0,0,0
2025-06-11 21:30,74,37,37,0,0,0
2025-06-11 21:45,87,42,45,0,0,0
2025-06-11 22:00,63,20,43,0,0,0
2025-06-11 22:15,66,28,38,0,0,0
2025-06-11 22:30,36,14,22,0,0,0
2025-06-11 22:45,51,27,24,0,0,0
2025-06-11 23:00,71,36,35,0,0,0
2025-06-11 23:15,42,20,22,0,0,0
2025-06-11 23:30,45,23,22,0,0,0
2025-06-11 23:45,43,25,18,0,0,0
2025-06-12 00:00,43,25,18,0,0,0
2025-06-12 00:15,43,28,15,0,0,0
2025-06-12 00:30,36,18,18,0,0,0
2025-06-12 00:45,30,19,11,0,0,0
2025-06-12 01:00,27,15,12,0,0,0
2025-06-12 01:15,18,6,12,0,0,0
2025-06-12 01:30,17,0,17,0,0,0
2025-06-12 01:45,6,2,4,0,0,0
2025-06-12 02:00,26,6,20,0,0,0
2025-06-12 02:15,33,4,29,0,0,0
2025-06-12 02:30,17,4,13,0,0,0
2025-06-12 02:45,22,7,15,0,0,0
2025-06-12 03:00,19,2,17,0,0,0
2025-06-12 03:15,9,2,7,0,0,0
2025-06-12 03:30,15,3,12,0,0,0
2025-06-12 03:45,11,2,9,0,0,0
2025-06-12 04:00,6,0,6,0,0,0
2025-06-12 04:15,15,1,14,0,0,0
2025-06-12 04:30,13,2,11,0,0,0
2025-06-12 04:45,25,3,22,0,0,0
2025-06-12 05:00,10,5,5,0,0,0
2025-06-12 05:15,24,5,19,0,0,0
2025-06-12 05:30,25,10,15,0,0,0
2025-06-12 05:45,25,11,14,0,0,0
2025-06-12 06:00,34,16,18,0,0,0
2025-06-12 06:15,45,21,24,0,0,0
2025-06-12 06:30,44,20,24,0,0,0
2025-06-12 06:45,83,49,34,0,0,0
2025-06-12 07:00,82,47,35,0,0,0
2025-06-12 07:15,110,46,64,0,0,0
2025-06-12 07:30,190,70,120,0,0,0
2025-06-12 07:45,173,109,64,0,0,0
2025-06-12 08:00,147,85,62,0,0,0
2025-06-12 08:15,167,89,78,0,0,0
2025-06-12 08:30,156,84,72,0,0,0
2025-06-12 08:45,155,85,70,0,0,0
2025-06-12 09:00,104,40,64,0,0,0
2025-06-12 09:15,106,46,60,0,0,0
2025-06-12 09:30,97,36,61,0,0,0
2025-06-12 09:45,123,41,82,0,0,0
2025-06-12 10:00,68,30,38,0,0,0
2025-06-12 10:15,77,29,48,0,0,0
2025-06-12 10:30,94,45,49,0,0,0
2025-06-12 10:45,88,44,44,0,0,0
2025-06-12 11:00,92,47,45,0,0,0
2025-06-12 11:15,80,40,40,0,0,0
2025-06-12 11:30,76,42,34,0,0,0
2025-06-12 11:45,110,56,54,0,0,0
2025-06-12 12:00,93,41,52,0,0,0
2025-06-12 12:15,94,47,47,0,0,0
2025-06-12 12:30,116,55,61,0,0,0
2025-06-12 12:45,127,60,67,0,0,0
2025-06-12 13:00,139,73,66,0,0,0
2025-06-12 13:15,130,74,56,0,0,0
2025-06-12 13:30,123,64,59,0,0,0
2025-06-12 13:45,127,64,63,0,0,0
2025-06-12 14:00,149,81,68,0,0,0
2025-06-12 14:15,150,76,74,0,0,0
2025-06-12 14:30,143,79,64,0,0,0
2025-06-12 14:45,145,79,66,0,0,0
2025-06-12 15:00,161,86,75,0,0,0
2025-06-12 15:15,165,79,86,0,0,0
2025-06-12 15:30,163,87,76,0,0,0
2025-06-12 15:45,173,96,77,0,0,0
2025-06-12 16:00,180,98,82,0,0,0
2025-06-12 16:15,197,105,92,0,0,0
2025-06-12 16:30,149,79,70,0,0,0
2025-06-12 16:45,183,97,86,0,0,0
2025-06-12 17:00,192,97,95,0,0,0
2025-06-12 17:15,225,109,116,0,0,0
2025-06-12 17:30,191,90,101,0,0,0
2025-06-12 17:45,210,118,92,0,0,0
2025-06-12 18:00,186,97,89,0,0,0
2025-06-12 18:15,168,90,78,0,0,0
2025-06-12 18:30,156,77,79,0,0,0
2025-06-12 18:45,155,97,58,0,0,0
2025-06-12 19:00,126,71,55,0,0,0
2025-06-12 19:15,111,56,55,0,0,0
2025-06-12 19:30,141,69,72,0,0,0
2025-06-12 19:45,141,77,64,0,0,0
2025-06-12 20:00,116,54,62,0,0,0
2025-06-12 20:15,114,49,65,0,0,0
2025-06-12 20:30,97,56,41,0,0,0
2025-06-12 20:45,94,46,48,0,0,0
2025-06-12 21:00,82,31,51,0,0,0
2025-06-12 21:15,101,34,67,0,0,0
2025-06-12 21:30,70,26,44,0,0,0
2025-06-12 21:45,62,28,34,0,0,0
2025-06-12 22:00,67,26,41,0,0,0
2025-06-12 22:15,67,27,40,0,0,0
2025-06-12 22:30,61,12,49,0,0,0
2025-06-12 22:45,56,15,41,0,0,0
2025-06-12 23:00,71,18,53,0,0,0
2025-06-12 23:15,34,10,24,0,0,0
2025-06-12 23:30,39,13,26,0,0,0
2025-06-12 23:45,14,6,8,0,0,0
2025-06-13 00:00,16,8,8,0,0,0
2025-06-13 00:15,14,3,11,0,0,0
2025-06-13 00:30,14,2,12,0,0,0
2025-06-13 00:45,14,6,8,0,0,0
2025-06-13 01:00,7,2,5,0,0,0
2025-06-13 01:15,13,4,9,0,0,0
2025-06-13 01:30,4,2,2,0,0,0
2025-06-13 01:45,2,1,1,0,0,0
2025-06-13 02:00,5,2,3,0,0,0
2025-06-13 02:15,4,3,1,0,0,0
2025-06-13 02:30,1,0,1,0,0,0
2025-06-13 02:45,0,0,0,0,0,0
2025-06-13 03:00,3,2,1,0,0,0
2025-06-13 03:15,3,1,2,0,0,0
2025-06-13 03:30,4,3,1,0,0,0
2025-06-13 03:45,1,0,1,0,0,0
2025-06-13 04:00,2,1,1,0,0,0
2025-06-13 04:15,1,1,0,0,0,0
2025-06-13 04:30,5,2,3,0,0,0
2025-06-13 04:45,3,0,3,0,0,0
2025-06-13 05:00,3,2,1,0,0,0
2025-06-13 05:15,15,3,12,0,0,0
2025-06-13 05:30,20,10,10,0,0,0
2025-06-13 05:45,32,10,22,0,0,0
2025-06-13 06:00,33,10,23,0,0,0
2025-06-13 06:15,35,13,22,0,0,0
2025-06-13 06:30,38,17,21,0,0,0
2025-06-13 06:45,67,37,30,0,0,0
2025-06-13 07:00,66,34,32,0,0,0
2025-06-13 07:15,106,41,65,0,0,0
2025-06-13 07:30,171,58,113,0,0,0
2025-06-13 07:45,180,100,80,0,0,0
2025-06-13 08:00,131,70,61,0,0,0
2025-06-13 08:15,114,68,46,0,0,0
2025-06-13 08:30,107,53,54,0,0,0
2025-06-13 08:45,133,56,77,0,0,0
2025-06-13 09:00,108,54,54,0,0,0
2025-06-13 09:15,77,42,35,0,0,0
2025-06-13 09:30,101,31,70,0,0,0
2025-06-13 09:45,102,38,64,0,0,0
2025-06-13 10:00,81,34,47,0,0,0
2025-06-13 10:15,79,38,41,0,0,0
2025-06-13 10:30,84,35,49,0,0,0
2025-06-13 10:45,109,51,58,0,0,0
2025-06-13 11:00,94,39,55,0,0,0
2025-06-13 11:15,86,35,51,0,0,0
2025-06-13 11:30,110,57,53,0,0,0
2025-06-13 11:45,119,62,57,0,0,0
2025-06-13 12:00,112,49,63,0,0,0
2025-06-13 12:15,113,46,67,0,0,0
2025-06-13 12:30,131,79,52,0,0,0
2025-06-13 12:45,144,71,73,0,0,0
2025-06-13 13:00,141,84,57,0,0,0
2025-06-13 13:15,143,72,71,0,0,0
2025-06-13 13:30,120,56,64,0,0,0
2025-06-13 13:45,148,81,67,0,0,0
2025-06-13 14:00,153,80,73,0,0,0
2025-06-13 14:15,166,67,99,0,0,0
2025-06-13 14:30,137,81,56,0,0,0
2025-06-13 14:45,170,91,79,0,0,0
2025-06-13 15:00,128,70,58,0,0,0
2025-06-13 15:15,176,91,85,0,0,0
2025-06-13 15:30,145,75,70,0,0,0
2025-06-13 15:45,159,86,73,0,0,0
2025-06-13 16:00,159,88,71,0,0,0
2025-06-13 16:15,142,82,60,0,0,0
2025-06-13 16:30,154,87,67,0,0,0
2025-06-13 16:45,156,95,61,0,0,0
2025-06-13 17:00,121,48,73,0,0,0
2025-06-13 17:15,133,69,64,0,0,0
2025-06-13 17:30,152,79,73,0,0,0
2025-06-13 17:45,175,98,77,0,0,0
2025-06-13 18:00,124,67,57,0,0,0
2025-06-13 18:15,132,68,64,0,0,0
2025-06-13 18:30,122,65,57,0,0,0
2025-06-13 18:45,133,71,62,0,0,0
2025-06-13 19:00,133,85,48,0,0,0
2025-06-13 19:15,144,62,82,0,0,0
2025-06-13 19:30,123,65,58,0,0,0
2025-06-13 19:45,170,80,90,0,0,0
2025-06-13 20:00,147,86,61,0,0,0
2025-06-13 20:15,113,51,62,0,0,0
2025-06-13 20:30,101,44,57,0,0,0
2025-06-13 20:45,95,33,62,0,0,0
2025-06-13 21:00,102,47,55,0,0,0
2025-06-13 21:15,77,31,46,0,0,0
2025-06-13 21:30,100,49,51,0,0,0
2025-06-13 21:45,122,54,68,0,0,0
2025-06-13 22:00,54,25,29,0,0,0
2025-06-13 22:15,120,49,71,0,0,0
2025-06-13 22:30,96,34,62,0,0,0
2025-06-13 22:45,94,36,58,0,0,0
2025-06-13 23:00,64,26,38,0,0,0
2025-06-13 23:15,72,32,40,0,0,0
2025-06-13 23:30,80,32,48,0,0,0
2025-06-13 23:45,78,31,47,0,0,0
2025-06-14 00:00,91,47,44,0,0,0
2025-06-14 00:15,78,25,53,0,0,0
2025-06-14 00:30,74,36,38,0,0,0
2025-06-14 00:45,55,17,38,0,0,0
2025-06-14 01:00,55,16,39,0,0,0
2025-06-14 01:15,47,13,34,0,0,0
2025-06-14 01:30,33,11,22,0,0,0
2025-06-14 01:45,43,12,31,0,0,0
2025-06-14 02:00,30,13,17,0,0,0
2025-06-14 02:15,18,8,10,0,0,0
2025-06-14 02:30,30,6,24,0,0,0
2025-06-14 02:45,27,6,21,0,0,0
2025-06-14 03:00,18,5,13,0,0,0
2025-06-14 03:15,21,7,14,0,0,0
2025-06-14 03:30,18,5,13,0,0,0
2025-06-14 03:45,14,5,9,0,0,0
2025-06-14 04:00,13,7,6,0,0,0
2025-06-14 04:15,13,2,11,0,0,0
2025-06-14 04:30,7,1,6,0,0,0
2025-06-14 04:45,6,2,4,0,0,0
2025-06-14 05:00,6,3,3,0,0,0
2025-06-14 05:15,7,3,4,0,0,0
2025-06-14 05:30,8,4,4,0,0,0
2025-06-14 05:45,12,4,8,0,0,0
2025-06-14 06:00,3,1,2,0,0,0
2025-06-14 06:15,7,2,5,0,0,0
2025-06-14 06:30,14,5,9,0,0,0
2025-06-14 06:45,15,9,6,0,0,0
2025-06-14 07:00,20,13,7,0,0,0
2025-06-14 07:15,13,9,4,0,0,0
2025-06-14 07:30,16,6,10,0,0,0
2025-06-14 07:45,18,7,11,0,0,0
2025-06-14 08:00,23,12,11,0,0,0
2025-06-14 08:15,28,10,18,0,0,0
2025-06-14 08:30,42,21,21,0,0,0
2025-06-14 08:45,48,23,25,0,0,0
2025-06-14 09:00,30,11,19,0,0,0
2025-06-14 09:15,49,19,30,0,0,0
2025-06-14 09:30,45,19,26,0,0,0
2025-06-14 09:45,72,36,36,0,0,0
2025-06-14 10:00,69,29,40,0,0,0
2025-06-14 10:15,81,30,51,0,0,0
2025-06-14 10:30,89,29,60,0,0,0
2025-06-14 10:45,79,39,40,0,0,0
2025-06-14 11:00,93,51,42,0,0,0
2025-06-14 11:15,76,34,42,0,0,0
2025-06-14 11:30,76,41,35,0,0,0
2025-06-14 11:45,109,57,52,0,0,0
2025-06-14 12:00,93,43,50,0,0,0
2025-06-14 12:15,99,47,52,0,0,0
2025-06-14 12:30,78,44,34,0,0,0
2025-06-14 12:45,86,46,40,0,0,0
2025-06-14 13:00,94,57,37,0,0,0
2025-06-14 13:15,76,41,35,0,0,0
2025-06-14 13:30,94,58,36,0,0,0
2025-06-14 13:45,105,65,40,0,0,0
2025-06-14 14:00,111,64,47,0,0,0
2025-06-14 14:15,101,57,44,0,0,0
2025-06-14 14:30,90,39,51,0,0,0
2025-06-14 14:45,102,61,41,0,0,0
2025-06-14 15:00,102,67,35,0,0,0
2025-06-14 15:15,89,54,35,0,0,0
2025-06-14 15:30,80,54,26,0,0,0
2025-06-14 15:45,103,54,49,0,0,0
2025-06-14 16:00,89,44,45,0,0,0
2025-06-14 16:15,95,49,46,0,0,0
2025-06-14 16:30,117,47,70,0,0,0
2025-06-14 16:45,125,59,66,0,0,0
2025-06-14 17:00,103,45,58,0,0,0
2025-06-14 17:15,103,40,63,0,0,0
2025-06-14 17:30,93,40,53,0,0,0
2025-06-14 17:45,121,58,63,0,0,0
2025-06-14 18:00,112,52,60,0,0,0
2025-06-14 18:15,111,45,66,0,0,0
2025-06-14 18:30,112,41,71,0,0,0
2025-06-14 18:45,85,39,46,0,0,0
2025-06-14 19:00,93,51,42,0,0,0
2025-06-14 19:15,93,40,53,0,0,0
2025-06-14 19:30,67,29,38,0,0,0
2025-06-14 19:45,75,36,39,0,0,0
2025-06-14 20:00,92,37,55,0,0,0
2025-06-14 20:15,79,37,42,0,0,0
2025-06-14 20:30,65,26,39,0,0,0
2025-06-14 20:45,58,25,33,0,0,0
2025-06-14 21:00,63,28,35,0,0,0
2025-06-14 21:15,60,23,37,0,0,0
2025-06-14 21:30,46,18,28,0,0,0
2025-06-14 21:45,45,24,21,0,0,0
2025-06-14 22:00,60,27,33,0,0,0
2025-06-14 22:15,68,29,39,0,0,0
2025-06-14 22:30,54,37,17,0,0,0
2025-06-14 22:45,61,21,40,0,0,0
2025-06-14 23:00,41,17,24,0,0,0
2025-06-14 23:15,72,21,51,0,0,0
2025-06-14 23:30,49,25,24,0,0,0
2025-06-14 23:45,60,23,37,0,0,0
2025-06-15 00:00,33,14,19,0,0,0
2025-06-15 00:15,57,19,38,0,0,0
2025-06-15 00:30,46,21,25,0,0,0
2025-06-15 00:45,50,17,33,0,0,0
2025-06-15 01:00,43,15,28,0,0,0
2025-06-15 01:15,36,15,21,0,0,0
2025-06-15 01:30,29,6,23,0,0,0
2025-06-15 01:45,30,13,17,0,0,0
2025-06-15 02:00,43,15,28,0,0,0
2025-06-15 02:15,24,8,16,0,0,0
2025-06-15 02:30,16,5,11,0,0,0
2025-06-15 02:45,23,5,18,0,0,0
2025-06-15 03:00,21,6,15,0,0,0
2025-06-15 03:15,21,3,18,0,0,0
2025-06-15 03:30,20,1,19,0,0,0
2025-06-15 03:45,15,0,15,0,0,0
2025-06-15 04:00,19,1,18,0,0,0
2025-06-15 04:15,15,6,9,0,0,0
2025-06-15 04:30,23,2,21,0,0,0
2025-06-15 04:45,11,1,10,0,0,0
2025-06-15 05:00,5,0,5,0,0,0
2025-06-15 05:15,4,0,4,0,0,0
2025-06-15 05:30,13,5,8,0,0,0
2025-06-15 05:45,4,0,4,0,0,0
2025-06-15 06:00,8,0,8,0,0,0
2025-06-15 06:15,5,3,2,0,0,0
2025-06-15 06:30,5,4,1,0,0,0
2025-06-15 06:45,7,3,4,0,0,0
2025-06-15 07:00,5,1,4,0,0,0
2025-06-15 07:15,1,0,1,0,0,0
2025-06-15 07:30,10,1,9,0,0,0
2025-06-15 07:45,7,2,5,0,0,0
2025-06-15 08:00,6,3,3,0,0,0
2025-06-15 08:15,8,3,5,0,0,0
2025-06-15 08:30,13,3,10,0,0,0
2025-06-15 08:45,17,5,12,0,0,0
2025-06-15 09:00,15,5,10,0,0,0
2025-06-15 09:15,21,6,15,0,0,0
2025-06-15 09:30,18,11,7,0,0,0
2025-06-15 09:45,33,13,20,0,0,0
2025-06-15 10:00,27,12,15,0,0,0
2025-06-15 10:15,29,12,17,0,0,0
2025-06-15 10:30,54,11,43,0,0,0
2025-06-15 10:45,66,34,32,0,0,0
2025-06-15 11:00,40,18,22,0,0,0
2025-06-15 11:15,39,20,19,0,0,0
2025-06-15 11:30,42,15,27,0,0,0
2025-06-15 11:45,52,27,25,0,0,0
2025-06-15 12:00,50,17,33,0,0,0
2025-06-15 12:15,52,22,30,0,0,0
2025-06-15 12:30,56,22,34,0,0,0
2025-06-15 12:45,52,21,31,0,0,0
2025-06-15 13:00,66,21,45,0,0,0
2025-06-15 13:15,79,35,44,0,0,0
2025-06-15 13:30,73,34,39,0,0,0
2025-06-15 13:45,81,32,49,0,0,0
2025-06-15 14:00,89,43,46,0,0,0
2025-06-15 14:15,73,31,42,0,0,0
2025-06-15 14:30,63,24,39,0,0,0
2025-06-15 14:45,80,48,32,0,0,0
2025-06-15 15:00,79,37,42,0,0,0
2025-06-15 15:15,78,39,39,0,0,0
2025-06-15 15:30,80,46,34,0,0,0
2025-06-15 15:45,84,46,38,0,0,0
2025-06-15 16:00,92,42,50,0,0,0
2025-06-15 16:15,97,43,54,0,0,0
2025-06-15 16:30,83,41,42,0,0,0
2025-06-15 16:45,75,34,41,0,0,0
2025-06-15 17:00,89,39,50,0,0,0
2025-06-15 17:15,92,42,50,0,0,0
2025-06-15 17:30,124,63,61,0,0,0
2025-06-15 17:45,89,41,48,0,0,0
2025-06-15 18:00,85,41,44,0,0,0
2025-06-15 18:15,86,34,52,0,0,0
2025-06-15 18:30,79,42,37,0,0,0
2025-06-15 18:45,75,36,39,0,0,0
2025-06-15 19:00,80,39,41,0,0,0
2025-06-15 19:15,65,33,32,0,0,0
2025-06-15 19:30,65,26,39,0,0,0
2025-06-15 19:45,65,21,44,0,0,0
2025-06-15 20:00,84,29,55,0,0,0
2025-06-15 20:15,67,21,46,0,0,0
2025-06-15 20:30,53,22,31,0,0,0
2025-06-15 20:45,51,22,29,0,0,0
2025-06-15 21:00,55,20,35,0,0,0
2025-06-15 21:15,37,15,22,0,0,0
2025-06-15 21:30,60,22,38,0,0,0
2025-06-15 21:45,39,13,26,0,0,0
2025-06-15 22:00,33,11,22,0,0,0
2025-06-15 22:15,25,13,12,0,0,0
2025-06-15 22:30,37,8,29,0,0,0
2025-06-15 22:45,15,4,11,0,0,0
2025-06-15 23:00,28,10,18,0,0,0
2025-06-15 23:15,36,12,24,0,0,0
2025-06-15 23:30,11,3,8,0,0,0
2025-06-15 23:45,13,3,10,0,0,0
2025-06-16 00:00,7,7,0,0,0,0
2025-06-16 00:15,6,1,5,0,0,0
2025-06-16 00:30,9,1,8,0,0,0
2025-06-16 00:45,8,4,4,0,0,0
2025-06-16 01:00,6,2,4,0,0,0
2025-06-16 01:15,5,0,5,0,0,0
2025-06-16 01:30,2,2,0,0,0,0
2025-06-16 01:45,5,0,5,0,0,0
2025-06-16 02:00,4,1,3,0,0,0
2025-06-16 02:15,1,0,1,0,0,0
2025-06-16 02:30,0,0,0,0,0,0
2025-06-16 02:45,1,0,1,0,0,0
2025-06-16 03:00,0,0,0,0,0,0
2025-06-16 03:15,1,1,0,0,0,0
2025-06-16 03:30,4,0,4,0,0,0
2025-06-16 03:45,2,0,2,0,0,0
2025-06-16 04:00,1,0,1,0,0,0
2025-06-16 04:15,1,0,1,0,0,0
2025-06-16 04:30,5,1,4,0,0,0
2025-06-16 04:45,7,3,4,0,0,0
2025-06-16 05:00,4,3,1,0,0,0
2025-06-16 05:15,22,12,10,0,0,0
2025-06-16 05:30,11,5,6,0,0,0
2025-06-16 05:45,32,14,18,0,0,0
2025-06-16 06:00,26,16,10,0,0,0
2025-06-16 06:15,45,22,23,0,0,0
2025-06-16 06:30,59,31,28,0,0,0
2025-06-16 06:45,73,46,27,0,0,0
2025-06-16 07:00,82,44,38,0,0,0
2025-06-16 07:15,123,65,58,0,0,0
2025-06-16 07:30,173,87,86,0,0,0
2025-06-16 07:45,193,107,86,0,0,0
2025-06-16 08:00,181,85,96,0,0,0
2025-06-16 08:15,154,80,74,0,0,0
2025-06-16 08:30,150,73,77,0,0,0
2025-06-16 08:45,148,86,62,0,0,0
2025-06-16 09:00,87,40,47,0,0,0
2025-06-16 09:15,103,44,59,0,0,0
2025-06-16 09:30,92,36,56,0,0,0
2025-06-16 09:45,123,48,75,0,0,0
2025-06-16 10:00,89,36,53,0,0,0
2025-06-16 10:15,81,37,44,0,0,0
2025-06-16 10:30,87,33,54,0,0,0
2025-06-16 10:45,86,35,51,0,0,0
2025-06-16 11:00,91,34,57,0,0,0
2025-06-16 11:15,115,52,63,0,0,0
2025-06-16 11:30,109,50,59,0,0,0
2025-06-16 11:45,133,59,74,0,0,0
2025-06-16 12:00,141,53,88,0,0,0
2025-06-16 12:15,97,44,53,0,0,0
2025-06-16 12:30,122,65,57,0,0,0
2025-06-16 12:45,148,71,77,0,0,0
2025-06-16 13:00,149,79,70,0,0,0
2025-06-16 13:15,157,86,71,0,0,0
2025-06-16 13:30,109,45,64,0,0,0
2025-06-16 13:45,146,60,86,0,0,0
2025-06-16 14:00,150,83,67,0,0,0
2025-06-16 14:15,147,79,68,0,0,0
2025-06-16 14:30,138,74,64,0,0,0
2025-06-16 14:45,118,63,55,0,0,0
2025-06-16 15:00,169,74,95,0,0,0
2025-06-16 15:15,128,64,64,0,0,0
2025-06-16 15:30,161,84,77,0,0,0
2025-06-16 15:45,173,85,88,0,0,0
2025-06-16 16:00,186,89,97,0,0,0
2025-06-16 16:15,187,103,84,0,0,0
2025-06-16 16:30,196,94,102,0,0,0
2025-06-16 16:45,234,137,97,0,0,0
2025-06-16 17:00,228,113,115,0,0,0
2025-06-16 17:15,181,90,91,0,0,0
2025-06-16 17:30,185,97,88,0,0,0
2025-06-16 17:45,293,189,104,0,0,0
2025-06-16 18:00,219,109,110,0,0,0
2025-06-16 18:15,164,96,68,0,0,0
2025-06-16 18:30,163,82,81,0,0,0
2025-06-16 18:45,159,93,66,0,0,0
2025-06-16 19:00,139,78,61,0,0,0
2025-06-16 19:15,117,55,62,0,0,0
2025-06-16 19:30,130,66,64,0,0,0
2025-06-16 19:45,110,59,51,0,0,0
2025-06-16 20:00,107,58,49,0,0,0
2025-06-16 20:15,132,62,70,0,0,0
2025-06-16 20:30,62,29,33,0,0,0
2025-06-16 20:45,70,40,30,0,0,0
2025-06-16 21:00,84,34,50,0,0,0
2025-06-16 21:15,76,39,37,0,0,0
2025-06-16 21:30,56,23,33,0,0,0
2025-06-16 21:45,53,30,23,0,0,0
2025-06-16 22:00,92,39,53,0,0,0
2025-06-16 22:15,51,29,22,0,0,0
2025-06-16 22:30,47,24,23,0,0,0
2025-06-16 22:45,60,16,44,0,0,0
2025-06-16 23:00,38,16,22,0,0,0
2025-06-16 23:15,33,17,16,0,0,0
2025-06-16 23:30,23,8,15,0,0,0
2025-06-16 23:45,13,7,6,0,0,0
2025-06-17 00:00,10,1,9,0,0,0
2025-06-17 00:15,10,5,5,0,0,0
2025-06-17 00:30,11,4,7,0,0,0
2025-06-17 00:45,7,4,3,0,0,0
2025-06-17 01:00,7,2,5,0,0,0
2025-06-17 01:15,2,1,1,0,0,0
2025-06-17 01:30,3,1,2,0,0,0
2025-06-17 01:45,0,0,0,0,0,0
2025-06-17 02:00,4,0,4,0,0,0
2025-06-17 02:15,3,2,1,0,0,0
2025-06-17 02:30,4,4,0,0,0,0
2025-06-17 02:45,1,0,1,0,0,0
2025-06-17 03:00,6,5,1,0,0,0
2025-06-17 03:15,0,0,0,0,0,0
2025-06-17 03:30,2,1,1,0,0,0
2025-06-17 03:45,2,2,0,0,0,0
2025-06-17 04:00,2,0,2,0,0,0
2025-06-17 04:15,2,0,2,0,0,0
2025-06-17 04:30,11,2,9,0,0,0
2025-06-17 04:45,7,4,3,0,0,0
2025-06-17 05:00,5,2,3,0,0,0
2025-06-17 05:15,14,6,8,0,0,0
2025-06-17 05:30,24,9,15,0,0,0
2025-06-17 05:45,34,16,18,0,0,0
2025-06-17 06:00,33,19,14,0,0,0
2025-06-17 06:15,50,22,28,0,0,0
2025-06-17 06:30,56,23,33,0,0,0
2025-06-17 06:45,68,42,26,0,0,0
2025-06-17 07:00,86,43,43,0,0,0
2025-06-17 07:15,127,63,64,0,0,0
2025-06-17 07:30,166,79,87,0,0,0
2025-06-17 07:45,234,141,93,0,0,0
2025-06-17 08:00,178,87,91,0,0,0
2025-06-17 08:15,142,68,74,0,0,0
2025-06-17 08:30,140,83,57,0,0,0
2025-06-17 08:45,147,87,60,0,0,0
2025-06-17 09:00,123,57,66,0,0,0
2025-06-17 09:15,89,43,46,0,0,0
2025-06-17 09:30,100,46,54,0,0,0
2025-06-17 09:45,135,48,87,0,0,0
2025-06-17 10:00,117,28,89,0,0,0
2025-06-17 10:15,97,44,53,0,0,0
2025-06-17 10:30,87,39,48,0,0,0
2025-06-17 10:45,110,41,69,0,0,0
2025-06-17 11:00,85,38,47,0,0,0
2025-06-17 11:15,92,38,54,0,0,0
2025-06-17 11:30,93,42,51,0,0,0
2025-06-17 11:45,157,63,94,0,0,0
2025-06-17 12:00,165,77,88,0,0,0
2025-06-17 12:15,131,63,68,0,0,0
2025-06-17 12:30,136,74,62,0,0,0
2025-06-17 12:45,123,53,70,0,0,0
2025-06-17 13:00,113,63,50,0,0,0
2025-06-17 13:15,150,85,65,0,0,0
2025-06-17 13:30,142,62,80,0,0,0
2025-06-17 13:45,145,78,67,0,0,0
2025-06-17 14:00,137,70,67,0,0,0
2025-06-17 14:15,133,83,50,0,0,0
2025-06-17 14:30,123,56,67,0,0,0
2025-06-17 14:45,128,65,63,0,0,0
2025-06-17 15:00,144,76,68,0,0,0
2025-06-17 15:15,155,76,79,0,0,0
2025-06-17 15:30,153,73,80,0,0,0
2025-06-17 15:45,179,101,78,0,0,0
2025-06-17 16:00,206,106,100,0,0,0
2025-06-17 16:15,189,100,89,0,0,0
2025-06-17 16:30,213,103,110,0,0,0
2025-06-17 16:45,232,133,99,0,0,0
2025-06-17 17:00,216,104,112,0,0,0
2025-06-17 17:15,228,108,120,0,0,0
2025-06-17 17:30,231,107,124,0,0,0
2025-06-17 17:45,246,141,105,0,0,0
2025-06-17 18:00,229,124,105,0,0,0
2025-06-17 18:15,193,104,89,0,0,0
2025-06-17 18:30,170,86,84,0,0,0
2025-06-17 18:45,175,82,93,0,0,0
2025-06-17 19:00,150,79,71,0,0,0
2025-06-17 19:15,122,65,57,0,0,0
2025-06-17 19:30,126,62,64,0,0,0
2025-06-17 19:45,142,73,69,0,0,0
2025-06-17 20:00,138,66,72,0,0,0
2025-06-17 20:15,127,61,66,0,0,0
2025-06-17 20:30,116,47,69,0,0,0
2025-06-17 20:45,90,32,58,0,0,0
2025-06-17 21:00,102,53,49,0,0,0
2025-06-17 21:15,100,41,59,0,0,0
2025-06-17 21:30,77,33,44,0,0,0
2025-06-17 21:45,89,49,40,0,0,0
2025-06-17 22:00,62,31,31,0,0,0
2025-06-17 22:15,76,33,43,0,0,0
2025-06-17 22:30,63,18,45,0,0,0
2025-06-17 22:45,57,13,44,0,0,0
2025-06-17 23:00,76,22,54,0,0,0
2025-06-17 23:15,53,16,37,0,0,0
2025-06-17 23:30,39,15,24,0,0,0
2025-06-17 23:45,33,11,22,0,0,0
2025-06-18 00:00,16,7,9,0,0,0
2025-06-18 00:15,29,8,21,0,0,0
2025-06-18 00:30,15,4,11,0,0,0
2025-06-18 00:45,12,3,9,0,0,0
2025-06-18 01:00,6,0,6,0,0,0
2025-06-18 01:15,8,3,5,0,0,0
2025-06-18 01:30,5,4,1,0,0,0
2025-06-18 01:45,9,3,6,0,0,0
2025-06-18 02:00,9,0,9,0,0,0
2025-06-18 02:15,0,0,0,0,0,0
2025-06-18 02:30,1,0,1,0,0,0
2025-06-18 02:45,4,1,3,0,0,0
2025-06-18 03:00,3,3,0,0,0,0
2025-06-18 03:15,1,0,1,0,0,0
2025-06-18 03:30,3,2,1,0,0,0
2025-06-18 03:45,5,1,4,0,0,0
2025-06-18 04:00,4,1,3,0,0,0
2025-06-18 04:15,1,1,0,0,0,0
2025-06-18 04:30,10,3,7,0,0,0
2025-06-18 04:45,11,4,7,0,0,0
2025-06-18 05:00,5,1,4,0,0,0
2025-06-18 05:15,21,7,14,0,0,0
2025-06-18 05:30,17,4,13,0,0,0
2025-06-18 05:45,32,13,19,0,0,0
2025-06-18 06:00,31,16,15,0,0,0
2025-06-18 06:15,45,19,26,0,0,0
2025-06-18 06:30,52,30,22,0,0,0
2025-06-18 06:45,81,47,34,0,0,0
2025-06-18 07:00,94,50,44,0,0,0
2025-06-18 07:15,108,50,58,0,0,0
2025-06-18 07:30,196,73,123,0,0,0
2025-06-18 07:45,206,111,95,0,0,0
2025-06-18 08:00,180,86,94,0,0,0
2025-06-18 08:15,172,99,73,0,0,0
2025-06-18 08:30,154,90,64,0,0,0
2025-06-18 08:45,170,90,80,0,0,0
2025-06-18 09:00,113,53,60,0,0,0
2025-06-18 09:15,130,59,71,0,0,0
2025-06-18 09:30,105,46,59,0,0,0
2025-06-18 09:45,150,67,83,0,0,0
2025-06-18 10:00,128,52,76,0,0,0
2025-06-18 10:15,110,48,62,0,0,0
2025-06-18 10:30,103,43,60,0,0,0
2025-06-18 10:45,119,65,54,0,0,0
2025-06-18 11:00,94,42,52,0,0,0
2025-06-18 11:15,84,40,44,0,0,0
2025-06-18 11:30,89,43,46,0,0,0
2025-06-18 11:45,162,71,91,0,0,0
2025-06-18 12:00,150,70,80,0,0,0
2025-06-18 12:15,140,66,74,0,0,0
2025-06-18 12:30,149,78,71,0,0,0
2025-06-18 12:45,132,71,61,0,0,0
2025-06-18 13:00,154,75,79,0,0,0
2025-06-18 13:15,129,67,62,0,0,0
2025-06-18 13:30,129,63,66,0,0,0
2025-06-18 13:45,171,87,84,0,0,0
2025-06-18 14:00,168,89,79,0,0,0
2025-06-18 14:15,125,64,61,0,0,0
2025-06-18 14:30,134,74,60,0,0,0
2025-06-18 14:45,133,75,58,0,0,0
2025-06-18 15:00,130,69,61,0,0,0
2025-06-18 15:15,168,91,77,0,0,0
2025-06-18 15:30,141,73,68,0,0,0
2025-06-18 15:45,186,86,100,0,0,0
2025-06-18 16:00,190,97,93,0,0,0
2025-06-18 16:15,178,104,74,0,0,0
2025-06-18 16:30,210,104,106,0,0,0
2025-06-18 16:45,230,122,108,0,0,0
2025-06-18 17:00,199,86,113,0,0,0
2025-06-18 17:15,186,99,87,0,0,0
2025-06-18 17:30,194,118,76,0,0,0
2025-06-18 17:45,227,115,112,0,0,0
2025-06-18 18:00,184,85,99,0,0,0
2025-06-18 18:15,194,107,87,0,0,0
2025-06-18 18:30,182,95,87,0,0,0
2025-06-18 18:45,165,98,67,0,0,0
2025-06-18 19:00,169,87,82,0,0,0
2025-06-18 19:15,141,82,59,0,0,0
2025-06-18 19:30,166,100,66,0,0,0
2025-06-18 19:45,180,98,82,0,0,0
2025-06-18 20:00,157,79,78,0,0,0
2025-06-18 20:15,121,68,53,0,0,0
2025-06-18 20:30,121,60,61,0,0,0
2025-06-18 20:45,101,47,54,0,0,0
2025-06-18 21:00,103,64,39,0,0,0
2025-06-18 21:15,72,38,34,0,0,0
2025-06-18 21:30,89,46,43,0,0,0
2025-06-18 21:45,75,35,40,0,0,0
2025-06-18 22:00,95,44,51,0,0,0
2025-06-18 22:15,116,55,61,0,0,0
2025-06-18 22:30,81,41,40,0,0,0
2025-06-18 22:45,80,41,39,0,0,0
2025-06-18 23:00,74,29,45,0,0,0
2025-06-18 23:15,64,24,40,0,0,0
2025-06-18 23:30,56,23,33,0,0,0
2025-06-18 23:45,63,29,34,0,0,0
2025-06-19 00:00,68,20,48,0,0,0
2025-06-19 00:15,58,18,40,0,0,0
2025-06-19 00:30,52,13,39,0,0,0
2025-06-19 00:45,50,19,31,0,0,0
2025-06-19 01:00,37,17,20,0,0,0
2025-06-19 01:15,38,12,26,0,0,0
2025-06-19 01:30,44,14,30,0,0,0
2025-06-19 01:45,33,13,20,0,0,0
2025-06-19 02:00,46,10,36,0,0,0
2025-06-19 02:15,28,10,18,0,0,0
2025-06-19 02:30,43,13,30,0,0,0
2025-06-19 02:45,26,5,21,0,0,0
2025-06-19 03:00,20,8,12,0,0,0
2025-06-19 03:15,22,8,14,0,0,0
2025-06-19 03:30,21,9,12,0,0,0
2025-06-19 03:45,23,3,20,0,0,0
2025-06-19 04:00,9,2,7,0,0,0
2025-06-19 04:15,12,2,10,0,0,0
2025-06-19 04:30,17,3,14,0,0,0
2025-06-19 04:45,8,2,6,0,0,0
2025-06-19 05:00,4,1,3,0,0,0
2025-06-19 05:15,6,1,5,0,0,0
2025-06-19 05:30,8,2,6,0,0,0
2025-06-19 05:45,9,2,7,0,0,0
2025-06-19 06:00,6,2,4,0,0,0
2025-06-19 06:15,5,0,5,0,0,0
2025-06-19 06:30,8,5,3,0,0,0
2025-06-19 06:45,8,5,3,0,0,0
2025-06-19 07:00,7,3,4,0,0,0
2025-06-19 07:15,11,5,6,0,0,0
2025-06-19 07:30,11,6,5,0,0,0
2025-06-19 07:45,24,14,10,0,0,0
2025-06-19 08:00,18,9,9,0,0,0
2025-06-19 08:15,10,2,8,0,0,0
2025-06-19 08:30,21,9,12,0,0,0
2025-06-19 08:45,32,18,14,0,0,0
2025-06-19 09:00,21,10,11,0,0,0
2025-06-19 09:15,22,10,12,0,0,0
2025-06-19 09:30,35,10,25,0,0,0
2025-06-19 09:45,62,24,38,0,0,0
2025-06-19 10:00,64,39,25,0,0,0
2025-06-19 10:15,43,25,18,0,0,0
2025-06-19 10:30,69,44,25,0,0,0
2025-06-19 10:45,66,32,34,0,0,0
2025-06-19 11:00,85,47,38,0,0,0
2025-06-19 11:15,72,42,30,0,0,0
2025-06-19 11:30,68,43,25,0,0,0
2025-06-19 11:45,89,37,52,0,0,0
2025-06-19 12:00,79,48,31,0,0,0
2025-06-19 12:15,81,33,48,0,0,0
2025-06-19 12:30,68,35,33,0,0,0
2025-06-19 12:45,85,56,29,0,0,0
2025-06-19 13:00,69,42,27,0,0,0
2025-06-19 13:15,98,50,48,0,0,0
2025-06-19 13:30,93,45,48,0,0,0
2025-06-19 13:45,96,53,43,0,0,0
2025-06-19 14:00,106,52,54,0,0,0
2025-06-19 14:15,102,51,51,0,0,0
2025-06-19 14:30,114,40,74,0,0,0
2025-06-19 14:45,106,44,62,0,0,0
2025-06-19 15:00,89,52,37,0,0,0
2025-06-19 15:15,102,51,51,0,0,0
2025-06-19 15:30,102,59,43,0,0,0
2025-06-19 15:45,122,63,59,0,0,0
2025-06-19 16:00,139,61,78,0,0,0
2025-06-19 16:15,124,69,55,0,0,0
2025-06-19 16:30,135,76,59,0,0,0
2025-06-19 16:45,120,77,43,0,0,0
2025-06-19 17:00,166,105,61,0,0,0
2025-06-19 17:15,162,109,53,0,0,0
2025-06-19 17:30,148,97,51,0,0,0
2025-06-19 17:45,133,78,55,0,0,0
2025-06-19 18:00,127,68,59,0,0,0
2025-06-19 18:15,102,59,43,0,0,0
2025-06-19 18:30,99,54,45,0,0,0
2025-06-19 18:45,102,60,42,0,0,0
2025-06-19 19:00,95,49,46,0,0,0
2025-06-19 19:15,101,54,47,0,0,0
2025-06-19 19:30,89,40,49,0,0,0
2025-06-19 19:45,94,50,44,0,0,0
2025-06-19 20:00,86,49,37,0,0,0
2025-06-19 20:15,88,44,44,0,0,0
2025-06-19 20:30,95,35,60,0,0,0
2025-06-19 20:45,120,46,74,0,0,0
2025-06-19 21:00,72,27,45,0,0,0
2025-06-19 21:15,82,24,58,0,0,0
2025-06-19 21:30,61,21,40,0,0,0
2025-06-19 21:45,96,27,69,0,0,0
2025-06-19 22:00,75,15,60,0,0,0
2025-06-19 22:15,76,15,61,0,0,0
2025-06-19 22:30,96,20,76,0,0,0
2025-06-19 22:45,138,15,123,0,0,0
2025-06-19 23:00,105,19,86,0,0,0
2025-06-19 23:15,77,12,65,0,0,0
2025-06-19 23:30,35,13,22,0,0,0
2025-06-19 23:45,37,7,30,0,0,0
2025-06-20 00:00,25,3,22,0,0,0
2025-06-20 00:15,13,3,10,0,0,0
2025-06-20 00:30,22,9,13,0,0,0
2025-06-20 00:45,20,5,15,0,0,0
2025-06-20 01:00,10,1,9,0,0,0
2025-06-20 01:15,10,1,9,0,0,0
2025-06-20 01:30,9,1,8,0,0,0
2025-06-20 01:45,7,4,3,0,0,0
2025-06-20 02:00,6,1,5,0,0,0
2025-06-20 02:15,3,2,1,0,0,0
2025-06-20 02:30,5,1,4,0,0,0
2025-06-20 02:45,4,1,3,0,0,0
2025-06-20 03:00,7,4,3,0,0,0
2025-06-20 03:15,5,5,0,0,0,0
2025-06-20 03:30,5,1,4,0,0,0
2025-06-20 03:45,1,0,1,0,0,0
2025-06-20 04:00,1,1,0,0,0,0
2025-06-20 04:15,8,6,2,0,0,0
2025-06-20 04:30,6,2,4,0,0,0
2025-06-20 04:45,4,3,1,0,0,0
2025-06-20 05:00,5,1,4,0,0,0
2025-06-20 05:15,11,5,6,0,0,0
2025-06-20 05:30,13,5,8,0,0,0
2025-06-20 05:45,14,4,10,0,0,0
2025-06-20 06:00,31,6,25,0,0,0
2025-06-20 06:15,24,16,8,0,0,0
2025-06-20 06:30,44,19,25,0,0,0
2025-06-20 06:45,36,22,14,0,0,0
2025-06-20 07:00,53,26,27,0,0,0
2025-06-20 07:15,51,22,29,0,0,0
2025-06-20 07:30,81,38,43,0,0,0
2025-06-20 07:45,117,62,55,0,0,0
2025-06-20 08:00,96,50,46,0,0,0
2025-06-20 08:15,82,35,47,0,0,0
2025-06-20 08:30,81,35,46,0,0,0
2025-06-20 08:45,109,55,54,0,0,0
2025-06-20 09:00,89,43,46,0,0,0
2025-06-20 09:15,88,38,50,0,0,0
2025-06-20 09:30,85,34,51,0,0,0
2025-06-20 09:45,143,65,78,0,0,0
2025-06-20 10:00,106,46,60,0,0,0
2025-06-20 10:15,107,44,63,0,0,0
2025-06-20 10:30,106,43,63,0,0,0
2025-06-20 10:45,124,59,65,0,0,0
2025-06-20 11:00,99,47,52,0,0,0
2025-06-20 11:15,103,53,50,0,0,0
2025-06-20 11:30,119,63,56,0,0,0
2025-06-20 11:45,122,54,68,0,0,0
2025-06-20 12:00,119,55,64,0,0,0
2025-06-20 12:15,118,56,62,0,0,0
2025-06-20 12:30,150,63,87,0,0,0
2025-06-20 12:45,139,55,84,0,0,0
2025-06-20 13:00,157,69,88,0,0,0
2025-06-20 13:15,110,38,72,0,0,0
2025-06-20 13:30,134,57,77,0,0,0
2025-06-20 13:45,124,69,55,0,0,0
2025-06-20 14:00,144,72,72,0,0,0
2025-06-20 14:15,139,74,65,0,0,0
2025-06-20 14:30,149,83,66,0,0,0
2025-06-20 14:45,133,67,66,0,0,0
2025-06-20 15:00,140,73,67,0,0,0
2025-06-20 15:15,114,60,54,0,0,0
2025-06-20 15:30,160,77,83,0,0,0
2025-06-20 15:45,150,73,77,0,0,0
2025-06-20 16:00,121,69,52,0,0,0
2025-06-20 16:15,125,65,60,0,0,0
2025-06-20 16:30,124,61,63,0,0,0
2025-06-20 16:45,133,66,67,0,0,0
2025-06-20 17:00,144,58,86,0,0,0
2025-06-20 17:15,147,76,71,0,0,0
2025-06-20 17:30,133,58,75,0,0,0
2025-06-20 17:45,142,78,64,0,0,0
2025-06-20 18:00,166,85,81,0,0,0
2025-06-20 18:15,137,67,70,0,0,0
2025-06-20 18:30,172,63,109,0,0,0
2025-06-20 18:45,159,82,77,0,0,0
2025-06-20 19:00,122,65,57,0,0,0
2025-06-20 19:15,157,71,86,0,0,0
2025-06-20 19:30,101,41,60,0,0,0
2025-06-20 19:45,151,57,94,0,0,0
2025-06-20 20:00,143,61,82,0,0,0
2025-06-20 20:15,127,59,68,0,0,0
2025-06-20 20:30,142,43,99,0,0,0
2025-06-20 20:45,103,34,69,0,0,0
2025-06-20 21:00,98,36,62,0,0,0
2025-06-20 21:15,108,53,55,0,0,0
2025-06-20 21:30,101,47,54,0,0,0
2025-06-20 21:45,99,45,54,0,0,0
2025-06-20 22:00,95,58,37,0,0,0
2025-06-20 22:15,99,46,53,0,0,0
2025-06-20 22:30,115,69,46,0,0,0
2025-06-20 22:45,68,37,31,0,0,0
2025-06-20 23:00,102,52,50,0,0,0
2025-06-20 23:15,102,58,44,0,0,0
2025-06-20 23:30,75,46,29,0,0,0
2025-06-20 23:45,85,46,39,0,0,0
2025-06-21 00:00,84,44,40,0,0,0
2025-06-21 00:15,72,49,23,0,0,0
2025-06-21 00:30,48,32,16,0,0,0
2025-06-21 00:45,49,22,27,0,0,0
2025-06-21 01:00,46,25,21,0,0,0
2025-06-21 01:15,34,22,12,0,0,0
2025-06-21 01:30,32,11,21,0,0,0
2025-06-21 01:45,17,9,8,0,0,0
2025-06-21 02:00,22,12,10,0,0,0
2025-06-21 02:15,15,7,8,0,0,0
2025-06-21 02:30,14,6,8,0,0,0
2025-06-21 02:45,23,5,18,0,0,0
2025-06-21 03:00,9,0,9,0,0,0
2025-06-21 03:15,4,3,1,0,0,0
2025-06-21 03:30,14,3,11,0,0,0
2025-06-21 03:45,9,4,5,0,0,0
2025-06-21 04:00,9,2,7,0,0,0
2025-06-21 04:15,13,2,11,0,0,0
2025-06-21 04:30,11,0,11,0,0,0
2025-06-21 04:45,3,0,3,0,0,0
2025-06-21 05:00,4,1,3,0,0,0
2025-06-21 05:15,10,5,5,0,0,0
2025-06-21 05:30,11,3,8,0,0,0
2025-06-21 05:45,20,6,14,0,0,0
2025-06-21 06:00,10,5,5,0,0,0
2025-06-21 06:15,11,3,8,0,0,0
2025-06-21 06:30,5,1,4,0,0,0
2025-06-21 06:45,13,9,4,0,0,0
2025-06-21 07:00,13,3,10,0,0,0
2025-06-21 07:15,22,10,12,0,0,0
2025-06-21 07:30,20,6,14,0,0,0
2025-06-21 07:45,28,11,17,0,0,0
2025-06-21 08:00,16,6,10,0,0,0
2025-06-21 08:15,25,9,16,0,0,0
2025-06-21 08:30,23,10,13,0,0,0
2025-06-21 08:45,48,19,29,0,0,0
2025-06-21 09:00,29,6,23,0,0,0
2025-06-21 09:15,40,17,23,0,0,0
2025-06-21 09:30,59,22,37,0,0,0
2025-06-21 09:45,65,26,39,0,0,0
2025-06-21 10:00,79,26,53,0,0,0
2025-06-21 10:15,93,26,67,0,0,0
2025-06-21 10:30,83,24,59,0,0,0
2025-06-21 10:45,85,41,44,0,0,0
2025-06-21 11:00,88,46,42,0,0,0
2025-06-21 11:15,75,38,37,0,0,0
2025-06-21 11:30,112,47,65,0,0,0
2025-06-21 11:45,122,52,70,0,0,0
2025-06-21 12:00,115,67,48,0,0,0
2025-06-21 12:15,144,93,51,0,0,0
2025-06-21 12:30,112,60,52,0,0,0
2025-06-21 12:45,127,61,66,0,0,0
2025-06-21 13:00,123,59,64,0,0,0
2025-06-21 13:15,140,67,73,0,0,0
2025-06-21 13:30,139,65,74,0,0,0
2025-06-21 13:45,122,64,58,0,0,0
2025-06-21 14:00,132,63,69,0,0,0
2025-06-21 14:15,126,70,56,0,0,0
2025-06-21 14:30,141,65,76,0,0,0
2025-06-21 14:45,147,89,58,0,0,0
2025-06-21 15:00,131,78,53,0,0,0
2025-06-21 15:15,116,70,46,0,0,0
2025-06-21 15:30,114,72,42,0,0,0
2025-06-21 15:45,143,84,59,0,0,0
2025-06-21 16:00,143,81,62,0,0,0
2025-06-21 16:15,137,74,63,0,0,0
2025-06-21 16:30,159,74,85,0,0,0
2025-06-21 16:45,141,66,75,0,0,0
2025-06-21 17:00,131,78,53,0,0,0
2025-06-21 17:15,149,102,47,0,0,0
2025-06-21 17:30,125,76,49,0,0,0
2025-06-21 17:45,136,83,53,0,0,0
2025-06-21 18:00,125,75,50,0,0,0
2025-06-21 18:15,118,67,51,0,0,0
2025-06-21 18:30,111,58,53,0,0,0
2025-06-21 18:45,130,66,64,0,0,0
2025-06-21 19:00,97,55,42,0,0,0
2025-06-21 19:15,128,75,53,0,0,0
2025-06-21 19:30,114,56,58,0,0,0
2025-06-21 19:45,90,51,39,0,0,0
2025-06-21 20:00,124,70,54,0,0,0
2025-06-21 20:15,104,54,50,0,0,0
2025-06-21 20:30,76,44,32,0,0,0
2025-06-21 20:45,102,55,47,0,0,0
2025-06-21 21:00,110,63,47,0,0,0
2025-06-21 21:15,83,42,41,0,0,0
2025-06-21 21:30,105,54,51,0,0,0
2025-06-21 21:45,67,38,29,0,0,0
2025-06-21 22:00,76,27,49,0,0,0
2025-06-21 22:15,83,19,64,0,0,0
2025-06-21 22:30,89,25,64,0,0,0
2025-06-21 22:45,71,24,47,0,0,0
2025-06-21 23:00,100,27,73,0,0,0
2025-06-21 23:15,84,24,60,0,0,0
2025-06-21 23:30,56,21,35,0,0,0
2025-06-21 23:45,71,23,48,0,0,0
2025-06-22 00:00,79,16,63,0,0,0
2025-06-22 00:15,75,24,51,0,0,0
2025-06-22 00:30,44,10,34,0,0,0
2025-06-22 00:45,68,20,48,0,0,0
2025-06-22 01:00,55,15,40,0,0,0
2025-06-22 01:15,46,18,28,0,0,0
2025-06-22 01:30,31,6,25,0,0,0
2025-06-22 01:45,29,8,21,0,0,0
2025-06-22 02:00,29,3,26,0,0,0
2025-06-22 02:15,31,2,29,0,0,0
2025-06-22 02:30,26,4,22,0,0,0
2025-06-22 02:45,20,6,14,0,0,0
2025-06-22 03:00,18,4,14,0,0,0
2025-06-22 03:15,16,4,12,0,0,0
2025-06-22 03:30,15,4,11,0,0,0
2025-06-22 03:45,22,2,20,0,0,0
2025-06-22 04:00,17,2,15,0,0,0
2025-06-22 04:15,20,3,17,0,0,0
2025-06-22 04:30,10,1,9,0,0,0
2025-06-22 04:45,22,2,20,0,0,0
2025-06-22 05:00,7,2,5,0,0,0
2025-06-22 05:15,26,4,22,0,0,0
2025-06-22 05:30,12,2,10,0,0,0
2025-06-22 05:45,12,7,5,0,0,0
2025-06-22 06:00,12,4,8,0,0,0
2025-06-22 06:15,10,4,6,0,0,0
2025-06-22 06:30,10,2,8,0,0,0
2025-06-22 06:45,7,4,3,0,0,0
2025-06-22 07:00,22,17,5,0,0,0
2025-06-22 07:15,15,9,6,0,0,0
2025-06-22 07:30,23,10,13,0,0,0
2025-06-22 07:45,23,18,5,0,0,0
2025-06-22 08:00,30,19,11,0,0,0
2025-06-22 08:15,47,31,16,0,0,0
2025-06-22 08:30,69,48,21,0,0,0
2025-06-22 08:45,73,56,17,0,0,0
2025-06-22 09:00,77,55,22,0,0,0
2025-06-22 09:15,99,78,21,0,0,0
2025-06-22 09:30,104,69,35,0,0,0
2025-06-22 09:45,97,68,29,0,0,0
2025-06-22 10:00,116,69,47,0,0,0
2025-06-22 10:15,119,76,43,0,0,0
2025-06-22 10:30,106,82,24,0,0,0
2025-06-22 10:45,120,83,37,0,0,0
2025-06-22 11:00,125,87,38,0,0,0
2025-06-22 11:15,132,93,39,0,0,0
2025-06-22 11:30,145,99,46,0,0,0
2025-06-22 11:45,177,115,62,0,0,0
2025-06-22 12:00,135,91,44,0,0,0
2025-06-22 12:15,171,113,58,0,0,0
2025-06-22 12:30,146,90,56,0,0,0
2025-06-22 12:45,125,69,56,0,0,0
2025-06-22 13:00,191,116,75,0,0,0
2025-06-22 13:15,142,59,83,0,0,0
2025-06-22 13:30,137,54,83,0,0,0
2025-06-22 13:45,124,61,63,0,0,0
2025-06-22 14:00,166,66,100,0,0,0
2025-06-22 14:15,174,57,117,0,0,0
2025-06-22 14:30,190,42,148,0,0,0
2025-06-22 14:45,201,60,141,0,0,0
2025-06-22 15:00,205,39,166,0,0,0
2025-06-22 15:15,166,31,135,0,0,0
2025-06-22 15:30,200,46,154,0,0,0
2025-06-22 15:45,149,39,110,0,0,0
2025-06-22 16:00,161,47,114,0,0,0
2025-06-22 16:15,153,44,109,0,0,0
2025-06-22 16:30,131,59,72,0,0,0
2025-06-22 16:45,118,48,70,0,0,0
2025-06-22 17:00,130,46,84,0,0,0
2025-06-22 17:15,114,44,70,0,0,0
2025-06-22 17:30,137,51,86,0,0,0
2025-06-22 17:45,104,31,73,0,0,0
2025-06-22 18:00,84,25,59,0,0,0
2025-06-22 18:15,69,28,41,0,0,0
2025-06-22 18:30,75,23,52,0,0,0
2025-06-22 18:45,82,30,52,0,0,0
2025-06-22 19:00,97,43,54,0,0,0
2025-06-22 19:15,112,45,67,0,0,0
2025-06-22 19:30,106,35,71,0,0,0
2025-06-22 19:45,54,10,44,0,0,0
2025-06-22 20:00,70,27,43,0,0,0
2025-06-22 20:15,84,36,48,0,0,0
2025-06-22 20:30,62,20,42,0,0,0
2025-06-22 20:45,52,25,27,0,0,0
2025-06-22 21:00,48,15,33,0,0,0
2025-06-22 21:15,53,18,35,0,0,0
2025-06-22 21:30,50,17,33,0,0,0
2025-06-22 21:45,41,11,30,0,0,0
2025-06-22 22:00,49,15,34,0,0,0
2025-06-22 22:15,44,11,33,0,0,0
2025-06-22 22:30,33,7,26,0,0,0
2025-06-22 22:45,28,4,24,0,0,0
2025-06-22 23:00,15,4,11,0,0,0
2025-06-22 23:15,13,4,9,0,0,0
2025-06-22 23:30,22,7,15,0,0,0
2025-06-22 23:45,4,2,2,0,0,0
2025-06-23 00:00,9,4,5,0,0,0
2025-06-23 00:15,8,4,4,0,0,0
2025-06-23 00:30,5,1,4,0,0,0
2025-06-23 00:45,5,0,5,0,0,0
2025-06-23 01:00,0,0,0,0,0,0
2025-06-23 01:15,3,1,2,0,0,0
2025-06-23 01:30,0,0,0,0,0,0
2025-06-23 01:45,5,1,4,0,0,0
2025-06-23 02:00,4,2,2,0,0,0
2025-06-23 02:15,1,0,1,0,0,0
2025-06-23 02:30,2,1,1,0,0,0
2025-06-23 02:45,2,2,0,0,0,0
2025-06-23 03:00,1,1,0,0,0,0
2025-06-23 03:15,0,0,0,0,0,0
2025-06-23 03:30,2,1,1,0,0,0
2025-06-23 03:45,2,1,1,0,0,0
2025-06-23 04:00,0,0,0,0,0,0
2025-06-23 04:15,0,0,0,0,0,0
2025-06-23 04:30,5,1,4,0,0,0
2025-06-23 04:45,6,3,3,0,0,0
2025-06-23 05:00,3,2,1,0,0,0
2025-06-23 05:15,17,6,11,0,0,0
2025-06-23 05:30,25,9,16,0,0,0
2025-06-23 05:45,32,15,17,0,0,0
2025-06-23 06:00,29,14,15,0,0,0
2025-06-23 06:15,43,21,22,0,0,0
2025-06-23 06:30,48,22,26,0,0,0
2025-06-23 06:45,76,45,31,0,0,0
2025-06-23 07:00,94,52,42,0,0,0
2025-06-23 07:15,119,62,57,0,0,0
2025-06-23 07:30,172,81,91,0,0,0
2025-06-23 07:45,188,112,76,0,0,0
2025-06-23 08:00,159,77,82,0,0,0
2025-06-23 08:15,142,74,68,0,0,0
2025-06-23 08:30,137,71,66,0,0,0
2025-06-23 08:45,163,96,67,0,0,0
2025-06-23 09:00,111,39,72,0,0,0
2025-06-23 09:15,98,49,49,0,0,0
2025-06-23 09:30,110,44,66,0,0,0
2025-06-23 09:45,116,31,85,0,0,0
2025-06-23 10:00,114,51,63,0,0,0
2025-06-23 10:15,85,36,49,0,0,0
2025-06-23 10:30,103,47,56,0,0,0
2025-06-23 10:45,102,41,61,0,0,0
2025-06-23 11:00,85,33,52,0,0,0
2025-06-23 11:15,66,24,42,0,0,0
2025-06-23 11:30,101,46,55,0,0,0
2025-06-23 11:45,136,56,80,0,0,0
2025-06-23 12:00,113,52,61,0,0,0
2025-06-23 12:15,93,44,49,0,0,0
2025-06-23 12:30,99,34,65,0,0,0
2025-06-23 12:45,139,67,72,0,0,0
2025-06-23 13:00,122,49,73,0,0,0
2025-06-23 13:15,140,62,78,0,0,0
2025-06-23 13:30,108,47,61,0,0,0
2025-06-23 13:45,145,69,76,0,0,0
2025-06-23 14:00,139,66,73,0,0,0
2025-06-23 14:15,120,67,53,0,0,0
2025-06-23 14:30,129,71,58,0,0,0
2025-06-23 14:45,143,73,70,0,0,0
2025-06-23 15:00,119,52,67,0,0,0
2025-06-23 15:15,137,66,71,0,0,0
2025-06-23 15:30,112,55,57,0,0,0
2025-06-23 15:45,163,84,79,0,0,0
2025-06-23 16:00,179,92,87,0,0,0
2025-06-23 16:15,167,76,91,0,0,0
2025-06-23 16:30,161,80,81,0,0,0
2025-06-23 16:45,181,90,91,0,0,0
2025-06-23 17:00,182,88,94,0,0,0
2025-06-23 17:15,182,84,98,0,0,0
2025-06-23 17:30,229,118,111,0,0,0
2025-06-23 17:45,226,117,109,0,0,0
2025-06-23 18:00,208,125,83,0,0,0
2025-06-23 18:15,167,91,76,0,0,0
2025-06-23 18:30,150,89,61,0,0,0
2025-06-23 18:45,161,79,82,0,0,0
2025-06-23 19:00,110,54,56,0,0,0
2025-06-23 19:15,140,59,81,0,0,0
2025-06-23 19:30,129,67,62,0,0,0
2025-06-23 19:45,138,86,52,0,0,0
2025-06-23 20:00,119,52,67,0,0,0
2025-06-23 20:15,83,34,49,0,0,0
2025-06-23 20:30,66,36,30,0,0,0
2025-06-23 20:45,74,37,37,0,0,0
2025-06-23 21:00,68,31,37,0,0,0
2025-06-23 21:15,82,45,37,0,0,0
2025-06-23 21:30,88,45,43,0,0,0
2025-06-23 21:45,63,27,36,0,0,0
2025-06-23 22:00,67,29,38,0,0,0
2025-06-23 22:15,55,22,33,0,0,0
2025-06-23 22:30,56,28,28,0,0,0
2025-06-23 22:45,58,25,33,0,0,0
2025-06-23 23:00,31,6,25,0,0,0
2025-06-23 23:15,32,11,21,0,0,0
2025-06-23 23:30,29,5,24,0,0,0
2025-06-23 23:45,23,10,13,0,0,0
2025-06-24 00:00,19,8,11,0,0,0
2025-06-24 00:15,13,4,9,0,0,0
2025-06-24 00:30,14,4,10,0,0,0
2025-06-24 00:45,20,7,13,0,0,0
2025-06-24 01:00,14,0,14,0,0,0
2025-06-24 01:15,8,1,7,0,0,0
2025-06-24 01:30,8,0,8,0,0,0
2025-06-24 01:45,1,0,1,0,0,0
2025-06-24 02:00,3,0,3,0,0,0
2025-06-24 02:15,1,0,1,0,0,0
2025-06-24 02:30,1,0,1,0,0,0
2025-06-24 02:45,2,1,1,0,0,0
2025-06-24 03:00,2,2,0,0,0,0
2025-06-24 03:15,3,3,0,0,0,0
2025-06-24 03:30,4,3,1,0,0,0
2025-06-24 03:45,1,0,1,0,0,0
2025-06-24 04:00,0,0,0,0,0,0
2025-06-24 04:15,2,0,2,0,0,0
2025-06-24 04:30,8,3,5,0,0,0
2025-06-24 04:45,6,4,2,0,0,0
2025-06-24 05:00,9,4,5,0,0,0
2025-06-24 05:15,18,6,12,0,0,0
2025-06-24 05:30,18,5,13,0,0,0
2025-06-24 05:45,26,13,13,0,0,0
2025-06-24 06:00,30,12,18,0,0,0
2025-06-24 06:15,46,27,19,0,0,0
2025-06-24 06:30,54,23,31,0,0,0
2025-06-24 06:45,84,40,44,0,0,0
2025-06-24 07:00,95,49,46,0,0,0
2025-06-24 07:15,119,52,67,0,0,0
2025-06-24 07:30,183,87,96,0,0,0
2025-06-24 07:45,229,116,113,0,0,0
2025-06-24 08:00,198,94,104,0,0,0
2025-06-24 08:15,191,103,88,0,0,0
2025-06-24 08:30,169,101,68,0,0,0
2025-06-24 08:45,157,81,76,0,0,0
2025-06-24 09:00,149,72,77,0,0,0
2025-06-24 09:15,98,40,58,0,0,0
2025-06-24 09:30,98,34,64,0,0,0
2025-06-24 09:45,140,55,85,0,0,0
2025-06-24 10:00,116,24,92,0,0,0
2025-06-24 10:15,87,42,45,0,0,0
2025-06-24 10:30,100,38,62,0,0,0
2025-06-24 10:45,110,48,62,0,0,0
2025-06-24 11:00,90,48,42,0,0,0
2025-06-24 11:15,117,61,56,0,0,0
2025-06-24 11:30,99,46,53,0,0,0
2025-06-24 11:45,141,50,91,0,0,0
2025-06-24 12:00,144,52,92,0,0,0
2025-06-24 12:15,127,65,62,0,0,0
2025-06-24 12:30,103,49,54,0,0,0
2025-06-24 12:45,124,54,70,0,0,0
2025-06-24 13:00,149,69,80,0,0,0
2025-06-24 13:15,137,73,64,0,0,0
2025-06-24 13:30,120,51,69,0,0,0
2025-06-24 13:45,147,72,75,0,0,0
2025-06-24 14:00,156,78,78,0,0,0
2025-06-24 14:15,149,70,79,0,0,0
2025-06-24 14:30,139,83,56,0,0,0
2025-06-24 14:45,144,70,74,0,0,0
2025-06-24 15:00,120,62,58,0,0,0
2025-06-24 15:15,119,67,52,0,0,0
2025-06-24 15:30,159,91,68,0,0,0
2025-06-24 15:45,178,87,91,0,0,0
2025-06-24 16:00,177,88,89,0,0,0
2025-06-24 16:15,207,112,95,0,0,0
2025-06-24 16:30,187,87,100,0,0,0
2025-06-24 16:45,178,85,93,0,0,0
2025-06-24 17:00,203,78,125,0,0,0
2025-06-24 17:15,207,94,113,0,0,0
2025-06-24 17:30,190,83,107,0,0,0
2025-06-24 17:45,261,132,129,0,0,0
2025-06-24 18:00,224,125,99,0,0,0
2025-06-24 18:15,168,90,78,0,0,0
2025-06-24 18:30,153,83,70,0,0,0
2025-06-24 18:45,153,94,59,0,0,0
2025-06-24 19:00,131,76,55,0,0,0
2025-06-24 19:15,141,84,57,0,0,0
2025-06-24 19:30,114,61,53,0,0,0
2025-06-24 19:45,122,57,65,0,0,0
2025-06-24 20:00,124,68,56,0,0,0
2025-06-24 20:15,99,51,48,0,0,0
2025-06-24 20:30,101,42,59,0,0,0
2025-06-24 20:45,76,40,36,0,0,0
2025-06-24 21:00,66,32,34,0,0,0
2025-06-24 21:15,65,35,30,0,0,0
2025-06-24 21:30,64,29,35,0,0,0
2025-06-24 21:45,50,21,29,0,0,0
2025-06-24 22:00,75,23,52,0,0,0
2025-06-24 22:15,85,36,49,0,0,0
2025-06-24 22:30,58,20,38,0,0,0
2025-06-24 22:45,32,19,13,0,0,0
2025-06-24 23:00,38,21,17,0,0,0
2025-06-24 23:15,14,6,8,0,0,0
2025-06-24 23:30,22,7,15,0,0,0
2025-06-24 23:45,32,12,20,0,0,0
2025-06-25 00:00,16,8,8,0,0,0
2025-06-25 00:15,11,2,9,0,0,0
2025-06-25 00:30,12,3,9,0,0,0
2025-06-25 00:45,5,1,4,0,0,0
2025-06-25 01:00,12,3,9,0,0,0
2025-06-25 01:15,10,2,8,0,0,0
2025-06-25 01:30,7,0,7,0,0,0
2025-06-25 01:45,2,1,1,0,0,0
2025-06-25 02:00,3,2,1,0,0,0
2025-06-25 02:15,2,0,2,0,0,0
2025-06-25 02:30,0,0,0,0,0,0
2025-06-25 02:45,1,1,0,0,0,0
2025-06-25 03:00,2,1,1,0,0,0
2025-06-25 03:15,4,2,2,0,0,0
2025-06-25 03:30,1,0,1,0,0,0
2025-06-25 03:45,4,4,0,0,0,0
2025-06-25 04:00,1,0,1,0,0,0
2025-06-25 04:15,1,1,0,0,0,0
2025-06-25 04:30,6,0,6,0,0,0
2025-06-25 04:45,8,2,6,0,0,0
2025-06-25 05:00,8,5,3,0,0,0
2025-06-25 05:15,18,6,12,0,0,0
2025-06-25 05:30,15,9,6,0,0,0
2025-06-25 05:45,33,18,15,0,0,0
2025-06-25 06:00,39,16,23,0,0,0
2025-06-25 06:15,55,29,26,0,0,0
2025-06-25 06:30,61,38,23,0,0,0
2025-06-25 06:45,85,51,34,0,0,0
2025-06-25 07:00,86,46,40,0,0,0
2025-06-25 07:15,113,42,71,0,0,0
2025-06-25 07:30,197,81,116,0,0,0
2025-06-25 07:45,198,115,83,0,0,0
2025-06-25 08:00,140,79,61,0,0,0
2025-06-25 08:15,204,102,102,0,0,0
2025-06-25 08:30,177,88,89,0,0,0
2025-06-25 08:45,184,96,88,0,0,0
2025-06-25 09:00,103,49,54,0,0,0
2025-06-25 09:15,116,54,62,0,0,0
2025-06-25 09:30,105,42,63,0,0,0
2025-06-25 09:45,120,43,77,0,0,0
2025-06-25 10:00,130,41,89,0,0,0
2025-06-25 10:15,93,40,53,0,0,0
2025-06-25 10:30,98,47,51,0,0,0
2025-06-25 10:45,114,43,71,0,0,0
2025-06-25 11:00,108,48,60,0,0,0
2025-06-25 11:15,94,35,59,0,0,0
2025-06-25 11:30,102,45,57,0,0,0
2025-06-25 11:45,134,49,85,0,0,0
2025-06-25 12:00,164,66,98,0,0,0
2025-06-25 12:15,116,58,58,0,0,0
2025-06-25 12:30,155,71,84,0,0,0
2025-06-25 12:45,137,75,62,0,0,0
2025-06-25 13:00,159,71,88,0,0,0
2025-06-25 13:15,171,96,75,0,0,0
2025-06-25 13:30,152,88,64,0,0,0
2025-06-25 13:45,148,73,75,0,0,0
2025-06-25 14:00,159,93,66,0,0,0
2025-06-25 14:15,120,62,58,0,0,0
2025-06-25 14:30,149,76,73,0,0,0
2025-06-25 14:45,133,75,58,0,0,0
2025-06-25 15:00,140,72,68,0,0,0
2025-06-25 15:15,150,80,70,0,0,0
2025-06-25 15:30,171,89,82,0,0,0
2025-06-25 15:45,191,101,90,0,0,0
2025-06-25 16:00,187,106,81,0,0,0
2025-06-25 16:15,194,114,80,0,0,0
2025-06-25 16:30,201,92,109,0,0,0
2025-06-25 16:45,210,114,96,0,0,0
2025-06-25 17:00,195,96,99,0,0,0
2025-06-25 17:15,183,88,95,0,0,0
2025-06-25 17:30,190,92,98,0,0,0
2025-06-25 17:45,247,111,136,0,0,0
2025-06-25 18:00,240,128,112,0,0,0
2025-06-25 18:15,200,125,75,0,0,0
2025-06-25 18:30,153,79,74,0,0,0
2025-06-25 18:45,153,93,60,0,0,0
2025-06-25 19:00,188,96,92,0,0,0
2025-06-25 19:15,155,95,60,0,0,0
2025-06-25 19:30,152,88,64,0,0,0
2025-06-25 19:45,158,104,54,0,0,0
2025-06-25 20:00,167,93,74,0,0,0
2025-06-25 20:15,139,67,72,0,0,0
2025-06-25 20:30,114,50,64,0,0,0
2025-06-25 20:45,98,47,51,0,0,0
2025-06-25 21:00,105,42,63,0,0,0
2025-06-25 21:15,86,49,37,0,0,0
2025-06-25 21:30,96,46,50,0,0,0
2025-06-25 21:45,90,52,38,0,0,0
2025-06-25 22:00,101,53,48,0,0,0
2025-06-25 22:15,89,42,47,0,0,0
2025-06-25 22:30,112,52,60,0,0,0
2025-06-25 22:45,57,29,28,0,0,0
2025-06-25 23:00,102,45,57,0,0,0
2025-06-25 23:15,87,39,48,0,0,0
2025-06-25 23:30,61,34,27,0,0,0
2025-06-25 23:45,35,10,25,0,0,0
2025-06-26 00:00,34,16,18,0,0,0
2025-06-26 00:15,54,34,20,0,0,0
2025-06-26 00:30,45,24,21,0,0,0
2025-06-26 00:45,25,8,17,0,0,0
2025-06-26 01:00,27,5,22,0,0,0
2025-06-26 01:15,20,2,18,0,0,0
2025-06-26 01:30,20,6,14,0,0,0
2025-06-26 01:45,24,2,22,0,0,0
2025-06-26 02:00,30,5,25,0,0,0
2025-06-26 02:15,17,3,14,0,0,0
2025-06-26 02:30,29,5,24,0,0,0
2025-06-26 02:45,18,3,15,0,0,0
2025-06-26 03:00,23,4,19,0,0,0
2025-06-26 03:15,9,3,6,0,0,0
2025-06-26 03:30,9,4,5,0,0,0
2025-06-26 03:45,11,2,9,0,0,0
2025-06-26 04:00,5,1,4,0,0,0
2025-06-26 04:15,11,4,7,0,0,0
2025-06-26 04:30,4,2,2,0,0,0
2025-06-26 04:45,5,2,3,0,0,0
