Datetime,100031300 (Hafenstraße),101031300 (Hafenstraße Fahrräder IN),102031300 (Hafenstraße Fahrräder OUT),100031300-status,101031300-status,102031300-status
2025-09-01 00:00,8,1,7,0,0,0
2025-09-01 00:15,10,2,8,0,0,0
2025-09-01 00:30,4,1,3,0,0,0
2025-09-01 00:45,4,1,3,0,0,0
2025-09-01 01:00,6,4,2,0,0,0
2025-09-01 01:15,1,0,1,0,0,0
2025-09-01 01:30,5,5,0,0,0,0
2025-09-01 01:45,2,0,2,0,0,0
2025-09-01 02:00,4,1,3,0,0,0
2025-09-01 02:15,4,3,1,0,0,0
2025-09-01 02:30,2,0,2,0,0,0
2025-09-01 02:45,1,0,1,0,0,0
2025-09-01 03:00,0,0,0,0,0,0
2025-09-01 03:15,0,0,0,0,0,0
2025-09-01 03:30,1,0,1,0,0,0
2025-09-01 03:45,1,1,0,0,0,0
2025-09-01 04:00,2,0,2,0,0,0
2025-09-01 04:15,0,0,0,0,0,0
2025-09-01 04:30,5,1,4,0,0,0
2025-09-01 04:45,9,2,7,0,0,0
2025-09-01 05:00,6,3,3,0,0,0
2025-09-01 05:15,4,2,2,0,0,0
2025-09-01 05:30,12,1,11,0,0,0
2025-09-01 05:45,15,7,8,0,0,0
2025-09-01 06:00,24,8,16,0,0,0
2025-09-01 06:15,37,17,20,0,0,0
2025-09-01 06:30,37,16,21,0,0,0
2025-09-01 06:45,62,37,25,0,0,0
2025-09-01 07:00,72,29,43,0,0,0
2025-09-01 07:15,91,40,51,0,0,0
2025-09-01 07:30,158,75,83,0,0,0
2025-09-01 07:45,139,86,53,0,0,0
2025-09-01 08:00,132,70,62,0,0,0
2025-09-01 08:15,107,58,49,0,0,0
2025-09-01 08:30,124,69,55,0,0,0
2025-09-01 08:45,134,70,64,0,0,0
2025-09-01 09:00,68,33,35,0,0,0
2025-09-01 09:15,83,36,47,0,0,0
2025-09-01 09:30,83,37,46,0,0,0
2025-09-01 09:45,80,26,54,0,0,0
2025-09-01 10:00,50,24,26,0,0,0
2025-09-01 10:15,73,31,42,0,0,0
2025-09-01 10:30,82,18,64,0,0,0
2025-09-01 10:45,72,25,47,0,0,0
2025-09-01 11:00,70,32,38,0,0,0
2025-09-01 11:15,81,31,50,0,0,0
2025-09-01 11:30,86,32,54,0,0,0
2025-09-01 11:45,96,33,63,0,0,0
2025-09-01 12:00,94,45,49,0,0,0
2025-09-01 12:15,88,45,43,0,0,0
2025-09-01 12:30,101,55,46,0,0,0
2025-09-01 12:45,95,35,60,0,0,0
2025-09-01 13:00,100,41,59,0,0,0
2025-09-01 13:15,96,41,55,0,0,0
2025-09-01 13:30,101,46,55,0,0,0
2025-09-01 13:45,82,40,42,0,0,0
2025-09-01 14:00,109,62,47,0,0,0
2025-09-01 14:15,102,44,58,0,0,0
2025-09-01 14:30,120,52,68,0,0,0
2025-09-01 14:45,118,65,53,0,0,0
2025-09-01 15:00,118,60,58,0,0,0
2025-09-01 15:15,112,54,58,0,0,0
2025-09-01 15:30,125,63,62,0,0,0
2025-09-01 15:45,149,87,62,0,0,0
2025-09-01 16:00,142,73,69,0,0,0
2025-09-01 16:15,131,70,61,0,0,0
2025-09-01 16:30,142,60,82,0,0,0
2025-09-01 16:45,145,49,96,0,0,0
2025-09-01 17:00,172,90,82,0,0,0
2025-09-01 17:15,150,81,69,0,0,0
2025-09-01 17:30,191,97,94,0,0,0
2025-09-01 17:45,197,99,98,0,0,0
2025-09-01 18:00,165,85,80,0,0,0
2025-09-01 18:15,134,73,61,0,0,0
2025-09-01 18:30,145,75,70,0,0,0
2025-09-01 18:45,125,68,57,0,0,0
2025-09-01 19:00,128,63,65,0,0,0
2025-09-01 19:15,126,64,62,0,0,0
2025-09-01 19:30,105,40,65,0,0,0
2025-09-01 19:45,130,65,65,0,0,0
2025-09-01 20:00,115,43,72,0,0,0
2025-09-01 20:15,98,51,47,0,0,0
2025-09-01 20:30,70,34,36,0,0,0
2025-09-01 20:45,75,29,46,0,0,0
2025-09-01 21:00,54,22,32,0,0,0
2025-09-01 21:15,70,33,37,0,0,0
2025-09-01 21:30,46,20,26,0,0,0
2025-09-01 21:45,44,10,34,0,0,0
2025-09-01 22:00,47,25,22,0,0,0
2025-09-01 22:15,65,24,41,0,0,0
2025-09-01 22:30,44,16,28,0,0,0
2025-09-01 22:45,23,12,11,0,0,0
2025-09-01 23:00,17,4,13,0,0,0
2025-09-01 23:15,21,8,13,0,0,0
2025-09-01 23:30,8,3,5,0,0,0
2025-09-01 23:45,8,5,3,0,0,0
2025-09-02 00:00,7,2,5,0,0,0
2025-09-02 00:15,8,2,6,0,0,0
2025-09-02 00:30,7,5,2,0,0,0
2025-09-02 00:45,9,4,5,0,0,0
2025-09-02 01:00,2,0,2,0,0,0
2025-09-02 01:15,2,1,1,0,0,0
2025-09-02 01:30,0,0,0,0,0,0
2025-09-02 01:45,3,0,3,0,0,0
2025-09-02 02:00,3,1,2,0,0,0
2025-09-02 02:15,4,1,3,0,0,0
2025-09-02 02:30,1,0,1,0,0,0
2025-09-02 02:45,3,3,0,0,0,0
2025-09-02 03:00,1,0,1,0,0,0
2025-09-02 03:15,2,1,1,0,0,0
2025-09-02 03:30,1,1,0,0,0,0
2025-09-02 03:45,0,0,0,0,0,0
2025-09-02 04:00,0,0,0,0,0,0
2025-09-02 04:15,0,0,0,0,0,0
2025-09-02 04:30,4,2,2,0,0,0
2025-09-02 04:45,5,2,3,0,0,0
2025-09-02 05:00,2,2,0,0,0,0
2025-09-02 05:15,14,4,10,0,0,0
2025-09-02 05:30,17,10,7,0,0,0
2025-09-02 05:45,28,13,15,0,0,0
2025-09-02 06:00,27,15,12,0,0,0
2025-09-02 06:15,51,24,27,0,0,0
2025-09-02 06:30,45,25,20,0,0,0
2025-09-02 06:45,62,43,19,0,0,0
2025-09-02 07:00,86,46,40,0,0,0
2025-09-02 07:15,125,63,62,0,0,0
2025-09-02 07:30,165,72,93,0,0,0
2025-09-02 07:45,185,107,78,0,0,0
2025-09-02 08:00,153,94,59,0,0,0
2025-09-02 08:15,140,81,59,0,0,0
2025-09-02 08:30,141,73,68,0,0,0
2025-09-02 08:45,152,84,68,0,0,0
2025-09-02 09:00,88,37,51,0,0,0
2025-09-02 09:15,88,39,49,0,0,0
2025-09-02 09:30,75,35,40,0,0,0
2025-09-02 09:45,86,37,49,0,0,0
2025-09-02 10:00,83,27,56,0,0,0
2025-09-02 10:15,78,30,48,0,0,0
2025-09-02 10:30,75,27,48,0,0,0
2025-09-02 10:45,113,54,59,0,0,0
2025-09-02 11:00,80,36,44,0,0,0
2025-09-02 11:15,85,30,55,0,0,0
2025-09-02 11:30,106,31,75,0,0,0
2025-09-02 11:45,100,42,58,0,0,0
2025-09-02 12:00,112,55,57,0,0,0
2025-09-02 12:15,108,46,62,0,0,0
2025-09-02 12:30,129,73,56,0,0,0
2025-09-02 12:45,116,50,66,0,0,0
2025-09-02 13:00,125,66,59,0,0,0
2025-09-02 13:15,132,67,65,0,0,0
2025-09-02 13:30,112,51,61,0,0,0
2025-09-02 13:45,134,76,58,0,0,0
2025-09-02 14:00,100,53,47,0,0,0
2025-09-02 14:15,135,71,64,0,0,0
2025-09-02 14:30,119,47,72,0,0,0
2025-09-02 14:45,124,60,64,0,0,0
2025-09-02 15:00,134,72,62,0,0,0
2025-09-02 15:15,136,56,80,0,0,0
2025-09-02 15:30,152,66,86,0,0,0
2025-09-02 15:45,169,76,93,0,0,0
2025-09-02 16:00,165,77,88,0,0,0
2025-09-02 16:15,143,71,72,0,0,0
2025-09-02 16:30,189,79,110,0,0,0
2025-09-02 16:45,185,78,107,0,0,0
2025-09-02 17:00,190,79,111,0,0,0
2025-09-02 17:15,212,92,120,0,0,0
2025-09-02 17:30,188,84,104,0,0,0
2025-09-02 17:45,198,94,104,0,0,0
2025-09-02 18:00,155,90,65,0,0,0
2025-09-02 18:15,178,92,86,0,0,0
2025-09-02 18:30,163,77,86,0,0,0
2025-09-02 18:45,135,79,56,0,0,0
2025-09-02 19:00,114,66,48,0,0,0
2025-09-02 19:15,136,79,57,0,0,0
2025-09-02 19:30,110,53,57,0,0,0
2025-09-02 19:45,102,48,54,0,0,0
2025-09-02 20:00,109,44,65,0,0,0
2025-09-02 20:15,103,42,61,0,0,0
2025-09-02 20:30,88,41,47,0,0,0
2025-09-02 20:45,79,32,47,0,0,0
2025-09-02 21:00,63,33,30,0,0,0
2025-09-02 21:15,72,31,41,0,0,0
2025-09-02 21:30,66,27,39,0,0,0
2025-09-02 21:45,54,20,34,0,0,0
2025-09-02 22:00,80,31,49,0,0,0
2025-09-02 22:15,69,20,49,0,0,0
2025-09-02 22:30,47,23,24,0,0,0
2025-09-02 22:45,29,15,14,0,0,0
2025-09-02 23:00,33,4,29,0,0,0
2025-09-02 23:15,26,12,14,0,0,0
2025-09-02 23:30,20,10,10,0,0,0
2025-09-02 23:45,13,7,6,0,0,0
2025-09-03 00:00,22,7,15,0,0,0
2025-09-03 00:15,9,2,7,0,0,0
2025-09-03 00:30,9,4,5,0,0,0
2025-09-03 00:45,16,3,13,0,0,0
2025-09-03 01:00,20,12,8,0,0,0
2025-09-03 01:15,3,0,3,0,0,0
2025-09-03 01:30,7,2,5,0,0,0
2025-09-03 01:45,5,3,2,0,0,0
2025-09-03 02:00,9,2,7,0,0,0
2025-09-03 02:15,0,0,0,0,0,0
2025-09-03 02:30,1,0,1,0,0,0
2025-09-03 02:45,1,1,0,0,0,0
2025-09-03 03:00,3,2,1,0,0,0
2025-09-03 03:15,0,0,0,0,0,0
2025-09-03 03:30,0,0,0,0,0,0
2025-09-03 03:45,1,1,0,0,0,0
2025-09-03 04:00,1,1,0,0,0,0
2025-09-03 04:15,1,1,0,0,0,0
2025-09-03 04:30,6,2,4,0,0,0
2025-09-03 04:45,10,5,5,0,0,0
2025-09-03 05:00,4,4,0,0,0,0
2025-09-03 05:15,14,4,10,0,0,0
2025-09-03 05:30,11,4,7,0,0,0
2025-09-03 05:45,22,9,13,0,0,0
2025-09-03 06:00,31,7,24,0,0,0
2025-09-03 06:15,44,21,23,0,0,0
2025-09-03 06:30,58,37,21,0,0,0
2025-09-03 06:45,88,47,41,0,0,0
2025-09-03 07:00,95,44,51,0,0,0
2025-09-03 07:15,123,55,68,0,0,0
2025-09-03 07:30,169,77,92,0,0,0
2025-09-03 07:45,184,118,66,0,0,0
2025-09-03 08:00,147,88,59,0,0,0
2025-09-03 08:15,162,91,71,0,0,0
2025-09-03 08:30,190,104,86,0,0,0
2025-09-03 08:45,169,87,82,0,0,0
2025-09-03 09:00,107,46,61,0,0,0
2025-09-03 09:15,98,39,59,0,0,0
2025-09-03 09:30,83,30,53,0,0,0
2025-09-03 09:45,77,33,44,0,0,0
2025-09-03 10:00,85,28,57,0,0,0
2025-09-03 10:15,87,36,51,0,0,0
2025-09-03 10:30,83,29,54,0,0,0
2025-09-03 10:45,99,46,53,0,0,0
2025-09-03 11:00,88,32,56,0,0,0
2025-09-03 11:15,95,43,52,0,0,0
2025-09-03 11:30,94,38,56,0,0,0
2025-09-03 11:45,121,48,73,0,0,0
2025-09-03 12:00,115,44,71,0,0,0
2025-09-03 12:15,144,58,86,0,0,0
2025-09-03 12:30,136,75,61,0,0,0
2025-09-03 12:45,137,72,65,0,0,0
2025-09-03 13:00,112,61,51,0,0,0
2025-09-03 13:15,113,61,52,0,0,0
2025-09-03 13:30,127,53,74,0,0,0
2025-09-03 13:45,126,63,63,0,0,0
2025-09-03 14:00,126,65,61,0,0,0
2025-09-03 14:15,122,58,64,0,0,0
2025-09-03 14:30,100,49,51,0,0,0
2025-09-03 14:45,134,71,63,0,0,0
2025-09-03 15:00,131,69,62,0,0,0
2025-09-03 15:15,135,62,73,0,0,0
2025-09-03 15:30,139,72,67,0,0,0
2025-09-03 15:45,169,74,95,0,0,0
2025-09-03 16:00,162,87,75,0,0,0
2025-09-03 16:15,154,85,69,0,0,0
2025-09-03 16:30,180,77,103,0,0,0
2025-09-03 16:45,187,101,86,0,0,0
2025-09-03 17:00,173,77,96,0,0,0
2025-09-03 17:15,167,86,81,0,0,0
2025-09-03 17:30,180,73,107,0,0,0
2025-09-03 17:45,180,90,90,0,0,0
2025-09-03 18:00,170,80,90,0,0,0
2025-09-03 18:15,167,78,89,0,0,0
2025-09-03 18:30,132,58,74,0,0,0
2025-09-03 18:45,170,92,78,0,0,0
2025-09-03 19:00,115,59,56,0,0,0
2025-09-03 19:15,99,62,37,0,0,0
2025-09-03 19:30,121,67,54,0,0,0
2025-09-03 19:45,95,51,44,0,0,0
2025-09-03 20:00,112,58,54,0,0,0
2025-09-03 20:15,75,36,39,0,0,0
2025-09-03 20:30,71,29,42,0,0,0
2025-09-03 20:45,82,47,35,0,0,0
2025-09-03 21:00,67,32,35,0,0,0
2025-09-03 21:15,70,34,36,0,0,0
2025-09-03 21:30,63,28,35,0,0,0
2025-09-03 21:45,53,23,30,0,0,0
2025-09-03 22:00,85,32,53,0,0,0
2025-09-03 22:15,67,21,46,0,0,0
2025-09-03 22:30,50,20,30,0,0,0
2025-09-03 22:45,45,22,23,0,0,0
2025-09-03 23:00,27,11,16,0,0,0
2025-09-03 23:15,29,11,18,0,0,0
2025-09-03 23:30,11,5,6,0,0,0
2025-09-03 23:45,19,7,12,0,0,0
2025-09-04 00:00,13,3,10,0,0,0
2025-09-04 00:15,17,7,10,0,0,0
2025-09-04 00:30,9,3,6,0,0,0
2025-09-04 00:45,15,3,12,0,0,0
2025-09-04 01:00,12,1,11,0,0,0
2025-09-04 01:15,11,2,9,0,0,0
2025-09-04 01:30,9,3,6,0,0,0
2025-09-04 01:45,4,0,4,0,0,0
2025-09-04 02:00,10,3,7,0,0,0
2025-09-04 02:15,3,2,1,0,0,0
2025-09-04 02:30,2,1,1,0,0,0
2025-09-04 02:45,1,1,0,0,0,0
2025-09-04 03:00,1,1,0,0,0,0
2025-09-04 03:15,3,1,2,0,0,0
2025-09-04 03:30,1,1,0,0,0,0
2025-09-04 03:45,1,0,1,0,0,0
2025-09-04 04:00,1,0,1,0,0,0
2025-09-04 04:15,3,1,2,0,0,0
2025-09-04 04:30,5,3,2,0,0,0
2025-09-04 04:45,6,3,3,0,0,0
2025-09-04 05:00,3,1,2,0,0,0
2025-09-04 05:15,15,10,5,0,0,0
2025-09-04 05:30,13,3,10,0,0,0
2025-09-04 05:45,20,12,8,0,0,0
2025-09-04 06:00,20,9,11,0,0,0
2025-09-04 06:15,46,22,24,0,0,0
2025-09-04 06:30,48,20,28,0,0,0
2025-09-04 06:45,69,38,31,0,0,0
2025-09-04 07:00,81,39,42,0,0,0
2025-09-04 07:15,129,52,77,0,0,0
2025-09-04 07:30,181,81,100,0,0,0
2025-09-04 07:45,174,107,67,0,0,0
2025-09-04 08:00,138,83,55,0,0,0
2025-09-04 08:15,143,80,63,0,0,0
2025-09-04 08:30,145,86,59,0,0,0
2025-09-04 08:45,161,81,80,0,0,0
2025-09-04 09:00,102,39,63,0,0,0
2025-09-04 09:15,78,36,42,0,0,0
2025-09-04 09:30,82,38,44,0,0,0
2025-09-04 09:45,103,50,53,0,0,0
2025-09-04 10:00,80,28,52,0,0,0
2025-09-04 10:15,72,29,43,0,0,0
2025-09-04 10:30,68,27,41,0,0,0
2025-09-04 10:45,76,32,44,0,0,0
2025-09-04 11:00,85,33,52,0,0,0
2025-09-04 11:15,94,38,56,0,0,0
2025-09-04 11:30,81,38,43,0,0,0
2025-09-04 11:45,107,44,63,0,0,0
2025-09-04 12:00,109,41,68,0,0,0
2025-09-04 12:15,102,44,58,0,0,0
2025-09-04 12:30,116,57,59,0,0,0
2025-09-04 12:45,122,52,70,0,0,0
2025-09-04 13:00,134,71,63,0,0,0
2025-09-04 13:15,126,76,50,0,0,0
2025-09-04 13:30,143,60,83,0,0,0
2025-09-04 13:45,153,84,69,0,0,0
2025-09-04 14:00,127,68,59,0,0,0
2025-09-04 14:15,110,51,59,0,0,0
2025-09-04 14:30,130,76,54,0,0,0
2025-09-04 14:45,129,61,68,0,0,0
2025-09-04 15:00,112,52,60,0,0,0
2025-09-04 15:15,173,95,78,0,0,0
2025-09-04 15:30,122,57,65,0,0,0
2025-09-04 15:45,152,74,78,0,0,0
2025-09-04 16:00,171,89,82,0,0,0
2025-09-04 16:15,162,72,90,0,0,0
2025-09-04 16:30,192,90,102,0,0,0
2025-09-04 16:45,196,71,125,0,0,0
2025-09-04 17:00,162,64,98,0,0,0
2025-09-04 17:15,168,79,89,0,0,0
2025-09-04 17:30,190,85,105,0,0,0
2025-09-04 17:45,160,71,89,0,0,0
2025-09-04 18:00,135,67,68,0,0,0
2025-09-04 18:15,138,76,62,0,0,0
2025-09-04 18:30,141,64,77,0,0,0
2025-09-04 18:45,156,84,72,0,0,0
2025-09-04 19:00,130,60,70,0,0,0
2025-09-04 19:15,104,56,48,0,0,0
2025-09-04 19:30,141,78,63,0,0,0
2025-09-04 19:45,149,90,59,0,0,0
2025-09-04 20:00,109,58,51,0,0,0
2025-09-04 20:15,90,54,36,0,0,0
2025-09-04 20:30,89,48,41,0,0,0
2025-09-04 20:45,81,37,44,0,0,0
2025-09-04 21:00,67,31,36,0,0,0
2025-09-04 21:15,75,24,51,0,0,0
2025-09-04 21:30,56,18,38,0,0,0
2025-09-04 21:45,63,22,41,0,0,0
2025-09-04 22:00,62,22,40,0,0,0
2025-09-04 22:15,86,23,63,0,0,0
2025-09-04 22:30,59,14,45,0,0,0
2025-09-04 22:45,35,11,24,0,0,0
2025-09-04 23:00,46,17,29,0,0,0
2025-09-04 23:15,41,7,34,0,0,0
2025-09-04 23:30,25,8,17,0,0,0
2025-09-04 23:45,13,6,7,0,0,0
2025-09-05 00:00,18,4,14,0,0,0
2025-09-05 00:15,8,3,5,0,0,0
2025-09-05 00:30,11,5,6,0,0,0
2025-09-05 00:45,6,3,3,0,0,0
2025-09-05 01:00,8,1,7,0,0,0
2025-09-05 01:15,9,1,8,0,0,0
2025-09-05 01:30,3,1,2,0,0,0
2025-09-05 01:45,5,4,1,0,0,0
2025-09-05 02:00,4,0,4,0,0,0
2025-09-05 02:15,4,2,2,0,0,0
2025-09-05 02:30,0,0,0,0,0,0
2025-09-05 02:45,0,0,0,0,0,0
2025-09-05 03:00,0,0,0,0,0,0
2025-09-05 03:15,0,0,0,0,0,0
2025-09-05 03:30,0,0,0,0,0,0
2025-09-05 03:45,1,1,0,0,0,0
2025-09-05 04:00,1,0,1,0,0,0
2025-09-05 04:15,7,1,6,0,0,0
2025-09-05 04:30,5,1,4,0,0,0
2025-09-05 04:45,7,3,4,0,0,0
2025-09-05 05:00,3,2,1,0,0,0
2025-09-05 05:15,14,5,9,0,0,0
2025-09-05 05:30,13,4,9,0,0,0
2025-09-05 05:45,26,12,14,0,0,0
2025-09-05 06:00,22,5,17,0,0,0
2025-09-05 06:15,37,18,19,0,0,0
2025-09-05 06:30,33,18,15,0,0,0
2025-09-05 06:45,70,39,31,0,0,0
2025-09-05 07:00,71,32,39,0,0,0
2025-09-05 07:15,99,42,57,0,0,0
2025-09-05 07:30,147,78,69,0,0,0
2025-09-05 07:45,131,82,49,0,0,0
2025-09-05 08:00,100,68,32,0,0,0
2025-09-05 08:15,126,73,53,0,0,0
2025-09-05 08:30,112,61,51,0,0,0
2025-09-05 08:45,132,52,80,0,0,0
2025-09-05 09:00,90,38,52,0,0,0
2025-09-05 09:15,84,39,45,0,0,0
2025-09-05 09:30,80,40,40,0,0,0
2025-09-05 09:45,101,37,64,0,0,0
2025-09-05 10:00,81,31,50,0,0,0
2025-09-05 10:15,70,36,34,0,0,0
2025-09-05 10:30,84,40,44,0,0,0
2025-09-05 10:45,95,49,46,0,0,0
2025-09-05 11:00,76,33,43,0,0,0
2025-09-05 11:15,80,29,51,0,0,0
2025-09-05 11:30,104,48,56,0,0,0
2025-09-05 11:45,97,43,54,0,0,0
2025-09-05 12:00,93,34,59,0,0,0
2025-09-05 12:15,112,47,65,0,0,0
2025-09-05 12:30,122,56,66,0,0,0
2025-09-05 12:45,123,56,67,0,0,0
2025-09-05 13:00,135,63,72,0,0,0
2025-09-05 13:15,112,53,59,0,0,0
2025-09-05 13:30,138,74,64,0,0,0
2025-09-05 13:45,160,74,86,0,0,0
2025-09-05 14:00,161,82,79,0,0,0
2025-09-05 14:15,149,77,72,0,0,0
2025-09-05 14:30,131,40,91,0,0,0
2025-09-05 14:45,148,86,62,0,0,0
2025-09-05 15:00,141,60,81,0,0,0
2025-09-05 15:15,123,64,59,0,0,0
2025-09-05 15:30,141,75,66,0,0,0
2025-09-05 15:45,118,66,52,0,0,0
2025-09-05 16:00,102,47,55,0,0,0
2025-09-05 16:15,79,37,42,0,0,0
2025-09-05 16:30,120,57,63,0,0,0
2025-09-05 16:45,114,64,50,0,0,0
2025-09-05 17:00,133,75,58,0,0,0
2025-09-05 17:15,132,55,77,0,0,0
2025-09-05 17:30,90,44,46,0,0,0
2025-09-05 17:45,117,67,50,0,0,0
2025-09-05 18:00,108,64,44,0,0,0
2025-09-05 18:15,114,71,43,0,0,0
2025-09-05 18:30,120,56,64,0,0,0
2025-09-05 18:45,92,53,39,0,0,0
2025-09-05 19:00,98,48,50,0,0,0
2025-09-05 19:15,95,65,30,0,0,0
2025-09-05 19:30,95,41,54,0,0,0
2025-09-05 19:45,98,46,52,0,0,0
2025-09-05 20:00,95,54,41,0,0,0
2025-09-05 20:15,73,32,41,0,0,0
2025-09-05 20:30,75,44,31,0,0,0
2025-09-05 20:45,60,36,24,0,0,0
2025-09-05 21:00,59,28,31,0,0,0
2025-09-05 21:15,76,36,40,0,0,0
2025-09-05 21:30,72,33,39,0,0,0
2025-09-05 21:45,59,21,38,0,0,0
2025-09-05 22:00,64,31,33,0,0,0
2025-09-05 22:15,56,24,32,0,0,0
2025-09-05 22:30,38,14,24,0,0,0
2025-09-05 22:45,69,30,39,0,0,0
2025-09-05 23:00,39,17,22,0,0,0
2025-09-05 23:15,47,15,32,0,0,0
2025-09-05 23:30,45,16,29,0,0,0
2025-09-05 23:45,40,14,26,0,0,0
2025-09-06 00:00,40,20,20,0,0,0
2025-09-06 00:15,48,18,30,0,0,0
2025-09-06 00:30,45,14,31,0,0,0
2025-09-06 00:45,40,11,29,0,0,0
2025-09-06 01:00,34,12,22,0,0,0
2025-09-06 01:15,31,4,27,0,0,0
2025-09-06 01:30,22,7,15,0,0,0
2025-09-06 01:45,25,4,21,0,0,0
2025-09-06 02:00,29,14,15,0,0,0
2025-09-06 02:15,22,10,12,0,0,0
2025-09-06 02:30,17,7,10,0,0,0
2025-09-06 02:45,14,4,10,0,0,0
2025-09-06 03:00,10,4,6,0,0,0
2025-09-06 03:15,13,5,8,0,0,0
2025-09-06 03:30,8,3,5,0,0,0
2025-09-06 03:45,8,0,8,0,0,0
2025-09-06 04:00,5,1,4,0,0,0
2025-09-06 04:15,6,0,6,0,0,0
2025-09-06 04:30,13,0,13,0,0,0
2025-09-06 04:45,6,2,4,0,0,0
2025-09-06 05:00,2,0,2,0,0,0
2025-09-06 05:15,10,3,7,0,0,0
2025-09-06 05:30,9,3,6,0,0,0
2025-09-06 05:45,3,2,1,0,0,0
2025-09-06 06:00,4,1,3,0,0,0
2025-09-06 06:15,8,3,5,0,0,0
2025-09-06 06:30,11,4,7,0,0,0
2025-09-06 06:45,16,9,7,0,0,0
2025-09-06 07:00,7,7,0,0,0,0
2025-09-06 07:15,10,1,9,0,0,0
2025-09-06 07:30,17,6,11,0,0,0
2025-09-06 07:45,17,7,10,0,0,0
2025-09-06 08:00,12,5,7,0,0,0
2025-09-06 08:15,23,12,11,0,0,0
2025-09-06 08:30,32,16,16,0,0,0
2025-09-06 08:45,56,38,18,0,0,0
2025-09-06 09:00,32,8,24,0,0,0
2025-09-06 09:15,37,16,21,0,0,0
2025-09-06 09:30,45,14,31,0,0,0
2025-09-06 09:45,65,24,41,0,0,0
2025-09-06 10:00,41,19,22,0,0,0
2025-09-06 10:15,48,19,29,0,0,0
2025-09-06 10:30,67,27,40,0,0,0
2025-09-06 10:45,64,28,36,0,0,0
2025-09-06 11:00,85,23,62,0,0,0
2025-09-06 11:15,92,33,59,0,0,0
2025-09-06 11:30,92,39,53,0,0,0
2025-09-06 11:45,95,50,45,0,0,0
2025-09-06 12:00,117,39,78,0,0,0
2025-09-06 12:15,83,42,41,0,0,0
2025-09-06 12:30,109,37,72,0,0,0
2025-09-06 12:45,74,29,45,0,0,0
2025-09-06 13:00,52,17,35,0,0,0
2025-09-06 13:15,113,41,72,0,0,0
2025-09-06 13:30,101,42,59,0,0,0
2025-09-06 13:45,115,72,43,0,0,0
2025-09-06 14:00,126,50,76,0,0,0
2025-09-06 14:15,106,53,53,0,0,0
2025-09-06 14:30,99,51,48,0,0,0
2025-09-06 14:45,126,66,60,0,0,0
2025-09-06 15:00,114,51,63,0,0,0
2025-09-06 15:15,126,75,51,0,0,0
2025-09-06 15:30,130,74,56,0,0,0
2025-09-06 15:45,107,55,52,0,0,0
2025-09-06 16:00,129,61,68,0,0,0
2025-09-06 16:15,105,52,53,0,0,0
2025-09-06 16:30,85,45,40,0,0,0
2025-09-06 16:45,133,70,63,0,0,0
2025-09-06 17:00,105,65,40,0,0,0
2025-09-06 17:15,137,68,69,0,0,0
2025-09-06 17:30,135,62,73,0,0,0
2025-09-06 17:45,164,92,72,0,0,0
2025-09-06 18:00,110,71,39,0,0,0
2025-09-06 18:15,130,74,56,0,0,0
2025-09-06 18:30,120,63,57,0,0,0
2025-09-06 18:45,111,55,56,0,0,0
2025-09-06 19:00,124,68,56,0,0,0
2025-09-06 19:15,93,40,53,0,0,0
2025-09-06 19:30,123,74,49,0,0,0
2025-09-06 19:45,138,77,61,0,0,0
2025-09-06 20:00,119,54,65,0,0,0
2025-09-06 20:15,104,45,59,0,0,0
2025-09-06 20:30,73,36,37,0,0,0
2025-09-06 20:45,84,52,32,0,0,0
2025-09-06 21:00,77,39,38,0,0,0
2025-09-06 21:15,64,31,33,0,0,0
2025-09-06 21:30,72,35,37,0,0,0
2025-09-06 21:45,72,23,49,0,0,0
2025-09-06 22:00,76,32,44,0,0,0
2025-09-06 22:15,58,24,34,0,0,0
2025-09-06 22:30,79,31,48,0,0,0
2025-09-06 22:45,60,24,36,0,0,0
2025-09-06 23:00,68,40,28,0,0,0
2025-09-06 23:15,73,31,42,0,0,0
2025-09-06 23:30,50,21,29,0,0,0
2025-09-06 23:45,66,30,36,0,0,0
2025-09-07 00:00,60,29,31,0,0,0
2025-09-07 00:15,56,17,39,0,0,0
2025-09-07 00:30,65,22,43,0,0,0
2025-09-07 00:45,43,18,25,0,0,0
2025-09-07 01:00,56,27,29,0,0,0
2025-09-07 01:15,41,10,31,0,0,0
2025-09-07 01:30,51,10,41,0,0,0
2025-09-07 01:45,43,22,21,0,0,0
2025-09-07 02:00,40,7,33,0,0,0
2025-09-07 02:15,23,9,14,0,0,0
2025-09-07 02:30,23,6,17,0,0,0
2025-09-07 02:45,23,3,20,0,0,0
2025-09-07 03:00,24,6,18,0,0,0
2025-09-07 03:15,22,3,19,0,0,0
2025-09-07 03:30,24,5,19,0,0,0
2025-09-07 03:45,24,4,20,0,0,0
2025-09-07 04:00,12,5,7,0,0,0
2025-09-07 04:15,8,0,8,0,0,0
2025-09-07 04:30,8,2,6,0,0,0
2025-09-07 04:45,13,3,10,0,0,0
2025-09-07 05:00,8,2,6,0,0,0
2025-09-07 05:15,12,0,12,0,0,0
2025-09-07 05:30,19,4,15,0,0,0
2025-09-07 05:45,8,3,5,0,0,0
2025-09-07 06:00,7,0,7,0,0,0
2025-09-07 06:15,7,2,5,0,0,0
2025-09-07 06:30,8,2,6,0,0,0
2025-09-07 06:45,15,5,10,0,0,0
2025-09-07 07:00,14,4,10,0,0,0
2025-09-07 07:15,5,2,3,0,0,0
2025-09-07 07:30,2,1,1,0,0,0
2025-09-07 07:45,8,1,7,0,0,0
2025-09-07 08:00,8,2,6,0,0,0
2025-09-07 08:15,7,1,6,0,0,0
2025-09-07 08:30,14,10,4,0,0,0
2025-09-07 08:45,24,11,13,0,0,0
2025-09-07 09:00,21,7,14,0,0,0
2025-09-07 09:15,26,12,14,0,0,0
2025-09-07 09:30,32,10,22,0,0,0
2025-09-07 09:45,44,20,24,0,0,0
2025-09-07 10:00,46,20,26,0,0,0
2025-09-07 10:15,52,26,26,0,0,0
2025-09-07 10:30,50,25,25,0,0,0
2025-09-07 10:45,56,23,33,0,0,0
2025-09-07 11:00,61,33,28,0,0,0
2025-09-07 11:15,54,22,32,0,0,0
2025-09-07 11:30,78,31,47,0,0,0
2025-09-07 11:45,70,36,34,0,0,0
2025-09-07 12:00,61,23,38,0,0,0
2025-09-07 12:15,62,20,42,0,0,0
2025-09-07 12:30,67,21,46,0,0,0
2025-09-07 12:45,82,50,32,0,0,0
2025-09-07 13:00,75,38,37,0,0,0
2025-09-07 13:15,100,54,46,0,0,0
2025-09-07 13:30,76,41,35,0,0,0
2025-09-07 13:45,83,40,43,0,0,0
2025-09-07 14:00,73,37,36,0,0,0
2025-09-07 14:15,107,45,62,0,0,0
2025-09-07 14:30,102,55,47,0,0,0
2025-09-07 14:45,94,49,45,0,0,0
2025-09-07 15:00,117,57,60,0,0,0
2025-09-07 15:15,68,37,31,0,0,0
2025-09-07 15:30,79,37,42,0,0,0
2025-09-07 15:45,108,50,58,0,0,0
2025-09-07 16:00,112,51,61,0,0,0
2025-09-07 16:15,97,48,49,0,0,0
2025-09-07 16:30,106,40,66,0,0,0
2025-09-07 16:45,94,41,53,0,0,0
2025-09-07 17:00,121,51,70,0,0,0
2025-09-07 17:15,120,62,58,0,0,0
2025-09-07 17:30,105,47,58,0,0,0
2025-09-07 17:45,101,51,50,0,0,0
2025-09-07 18:00,99,52,47,0,0,0
2025-09-07 18:15,98,39,59,0,0,0
2025-09-07 18:30,93,49,44,0,0,0
2025-09-07 18:45,90,41,49,0,0,0
2025-09-07 19:00,64,27,37,0,0,0
2025-09-07 19:15,75,27,48,0,0,0
2025-09-07 19:30,98,38,60,0,0,0
2025-09-07 19:45,94,40,54,0,0,0
2025-09-07 20:00,80,33,47,0,0,0
2025-09-07 20:15,61,23,38,0,0,0
2025-09-07 20:30,63,23,40,0,0,0
2025-09-07 20:45,52,23,29,0,0,0
2025-09-07 21:00,56,22,34,0,0,0
2025-09-07 21:15,42,18,24,0,0,0
2025-09-07 21:30,40,15,25,0,0,0
2025-09-07 21:45,40,18,22,0,0,0
2025-09-07 22:00,40,10,30,0,0,0
2025-09-07 22:15,42,22,20,0,0,0
2025-09-07 22:30,33,18,15,0,0,0
2025-09-07 22:45,24,2,22,0,0,0
2025-09-07 23:00,14,9,5,0,0,0
2025-09-07 23:15,16,6,10,0,0,0
2025-09-07 23:30,12,3,9,0,0,0
2025-09-07 23:45,10,7,3,0,0,0
2025-09-08 00:00,21,9,12,0,0,0
2025-09-08 00:15,11,3,8,0,0,0
2025-09-08 00:30,4,2,2,0,0,0
2025-09-08 00:45,2,1,1,0,0,0
2025-09-08 01:00,6,2,4,0,0,0
2025-09-08 01:15,7,1,6,0,0,0
2025-09-08 01:30,5,0,5,0,0,0
2025-09-08 01:45,4,2,2,0,0,0
2025-09-08 02:00,4,1,3,0,0,0
2025-09-08 02:15,0,0,0,0,0,0
2025-09-08 02:30,2,0,2,0,0,0
2025-09-08 02:45,4,1,3,0,0,0
2025-09-08 03:00,3,1,2,0,0,0
2025-09-08 03:15,2,2,0,0,0,0
2025-09-08 03:30,0,0,0,0,0,0
2025-09-08 03:45,1,1,0,0,0,0
2025-09-08 04:00,1,0,1,0,0,0
2025-09-08 04:15,3,1,2,0,0,0
2025-09-08 04:30,5,2,3,0,0,0
2025-09-08 04:45,7,4,3,0,0,0
2025-09-08 05:00,5,0,5,0,0,0
2025-09-08 05:15,11,5,6,0,0,0
2025-09-08 05:30,7,3,4,0,0,0
2025-09-08 05:45,19,9,10,0,0,0
2025-09-08 06:00,26,12,14,0,0,0
2025-09-08 06:15,35,13,22,0,0,0
2025-09-08 06:30,58,24,34,0,0,0
2025-09-08 06:45,65,33,32,0,0,0
2025-09-08 07:00,65,33,32,0,0,0
2025-09-08 07:15,134,60,74,0,0,0
2025-09-08 07:30,164,76,88,0,0,0
2025-09-08 07:45,170,106,64,0,0,0
2025-09-08 08:00,158,100,58,0,0,0
2025-09-08 08:15,138,70,68,0,0,0
2025-09-08 08:30,117,69,48,0,0,0
2025-09-08 08:45,134,72,62,0,0,0
2025-09-08 09:00,102,43,59,0,0,0
2025-09-08 09:15,83,38,45,0,0,0
2025-09-08 09:30,70,21,49,0,0,0
2025-09-08 09:45,97,53,44,0,0,0
2025-09-08 10:00,71,36,35,0,0,0
2025-09-08 10:15,81,33,48,0,0,0
2025-09-08 10:30,67,24,43,0,0,0
2025-09-08 10:45,102,49,53,0,0,0
2025-09-08 11:00,87,38,49,0,0,0
2025-09-08 11:15,74,28,46,0,0,0
2025-09-08 11:30,89,41,48,0,0,0
2025-09-08 11:45,97,44,53,0,0,0
2025-09-08 12:00,88,50,38,0,0,0
2025-09-08 12:15,105,48,57,0,0,0
2025-09-08 12:30,118,69,49,0,0,0
2025-09-08 12:45,118,51,67,0,0,0
2025-09-08 13:00,82,39,43,0,0,0
2025-09-08 13:15,87,38,49,0,0,0
2025-09-08 13:30,73,29,44,0,0,0
2025-09-08 13:45,97,53,44,0,0,0
2025-09-08 14:00,97,54,43,0,0,0
2025-09-08 14:15,107,44,63,0,0,0
2025-09-08 14:30,123,72,51,0,0,0
2025-09-08 14:45,119,62,57,0,0,0
2025-09-08 15:00,126,55,71,0,0,0
2025-09-08 15:15,105,56,49,0,0,0
2025-09-08 15:30,108,48,60,0,0,0
2025-09-08 15:45,116,55,61,0,0,0
2025-09-08 16:00,140,73,67,0,0,0
2025-09-08 16:15,147,70,77,0,0,0
2025-09-08 16:30,158,75,83,0,0,0
2025-09-08 16:45,146,62,84,0,0,0
2025-09-08 17:00,147,65,82,0,0,0
2025-09-08 17:15,172,84,88,0,0,0
2025-09-08 17:30,172,86,86,0,0,0
2025-09-08 17:45,175,81,94,0,0,0
2025-09-08 18:00,147,91,56,0,0,0
2025-09-08 18:15,156,71,85,0,0,0
2025-09-08 18:30,131,59,72,0,0,0
2025-09-08 18:45,115,60,55,0,0,0
2025-09-08 19:00,98,55,43,0,0,0
2025-09-08 19:15,112,58,54,0,0,0
2025-09-08 19:30,110,45,65,0,0,0
2025-09-08 19:45,80,31,49,0,0,0
2025-09-08 20:00,90,50,40,0,0,0
2025-09-08 20:15,85,57,28,0,0,0
2025-09-08 20:30,65,34,31,0,0,0
2025-09-08 20:45,64,29,35,0,0,0
2025-09-08 21:00,58,24,34,0,0,0
2025-09-08 21:15,64,33,31,0,0,0
2025-09-08 21:30,52,18,34,0,0,0
2025-09-08 21:45,48,27,21,0,0,0
2025-09-08 22:00,36,14,22,0,0,0
2025-09-08 22:15,43,14,29,0,0,0
2025-09-08 22:30,30,8,22,0,0,0
2025-09-08 22:45,53,17,36,0,0,0
2025-09-08 23:00,23,9,14,0,0,0
2025-09-08 23:15,24,5,19,0,0,0
2025-09-08 23:30,12,3,9,0,0,0
2025-09-08 23:45,13,2,11,0,0,0
2025-09-09 00:00,17,3,14,0,0,0
2025-09-09 00:15,6,5,1,0,0,0
2025-09-09 00:30,4,1,3,0,0,0
2025-09-09 00:45,8,2,6,0,0,0
2025-09-09 01:00,2,0,2,0,0,0
2025-09-09 01:15,1,0,1,0,0,0
2025-09-09 01:30,3,1,2,0,0,0
2025-09-09 01:45,4,2,2,0,0,0
2025-09-09 02:00,1,0,1,0,0,0
2025-09-09 02:15,2,1,1,0,0,0
2025-09-09 02:30,0,0,0,0,0,0
2025-09-09 02:45,1,1,0,0,0,0
2025-09-09 03:00,1,0,1,0,0,0
2025-09-09 03:15,0,0,0,0,0,0
2025-09-09 03:30,4,4,0,0,0,0
2025-09-09 03:45,2,2,0,0,0,0
2025-09-09 04:00,3,2,1,0,0,0
2025-09-09 04:15,2,1,1,0,0,0
2025-09-09 04:30,4,2,2,0,0,0
2025-09-09 04:45,9,4,5,0,0,0
2025-09-09 05:00,3,1,2,0,0,0
2025-09-09 05:15,16,6,10,0,0,0
2025-09-09 05:30,15,5,10,0,0,0
2025-09-09 05:45,19,8,11,0,0,0
2025-09-09 06:00,25,9,16,0,0,0
2025-09-09 06:15,41,20,21,0,0,0
2025-09-09 06:30,46,22,24,0,0,0
2025-09-09 06:45,63,40,23,0,0,0
2025-09-09 07:00,61,31,30,0,0,0
2025-09-09 07:15,101,48,53,0,0,0
2025-09-09 07:30,138,64,74,0,0,0
2025-09-09 07:45,135,84,51,0,0,0
2025-09-09 08:00,96,48,48,0,0,0
2025-09-09 08:15,92,43,49,0,0,0
2025-09-09 08:30,92,34,58,0,0,0
2025-09-09 08:45,110,50,60,0,0,0
2025-09-09 09:00,94,39,55,0,0,0
2025-09-09 09:15,61,28,33,0,0,0
2025-09-09 09:30,77,28,49,0,0,0
2025-09-09 09:45,51,24,27,0,0,0
2025-09-09 10:00,65,27,38,0,0,0
2025-09-09 10:15,62,23,39,0,0,0
2025-09-09 10:30,75,28,47,0,0,0
2025-09-09 10:45,67,21,46,0,0,0
2025-09-09 11:00,72,25,47,0,0,0
2025-09-09 11:15,67,28,39,0,0,0
2025-09-09 11:30,72,26,46,0,0,0
2025-09-09 11:45,88,26,62,0,0,0
2025-09-09 12:00,75,29,46,0,0,0
2025-09-09 12:15,85,34,51,0,0,0
2025-09-09 12:30,98,45,53,0,0,0
2025-09-09 12:45,93,40,53,0,0,0
2025-09-09 13:00,114,63,51,0,0,0
2025-09-09 13:15,118,44,74,0,0,0
2025-09-09 13:30,79,37,42,0,0,0
2025-09-09 13:45,82,39,43,0,0,0
2025-09-09 14:00,99,54,45,0,0,0
2025-09-09 14:15,83,41,42,0,0,0
2025-09-09 14:30,84,24,60,0,0,0
2025-09-09 14:45,59,16,43,0,0,0
2025-09-09 15:00,72,33,39,0,0,0
2025-09-09 15:15,85,39,46,0,0,0
2025-09-09 15:30,107,49,58,0,0,0
2025-09-09 15:45,112,43,69,0,0,0
2025-09-09 16:00,112,56,56,0,0,0
2025-09-09 16:15,128,55,73,0,0,0
2025-09-09 16:30,117,51,66,0,0,0
2025-09-09 16:45,131,51,80,0,0,0
2025-09-09 17:00,127,53,74,0,0,0
2025-09-09 17:15,158,62,96,0,0,0
2025-09-09 17:30,139,71,68,0,0,0
2025-09-09 17:45,124,68,56,0,0,0
2025-09-09 18:00,121,63,58,0,0,0
2025-09-09 18:15,100,37,63,0,0,0
2025-09-09 18:30,130,75,55,0,0,0
2025-09-09 18:45,117,55,62,0,0,0
2025-09-09 19:00,105,48,57,0,0,0
2025-09-09 19:15,101,60,41,0,0,0
2025-09-09 19:30,107,61,46,0,0,0
2025-09-09 19:45,86,48,38,0,0,0
2025-09-09 20:00,85,29,56,0,0,0
2025-09-09 20:15,69,30,39,0,0,0
2025-09-09 20:30,79,37,42,0,0,0
2025-09-09 20:45,68,27,41,0,0,0
2025-09-09 21:00,50,21,29,0,0,0
2025-09-09 21:15,42,21,21,0,0,0
2025-09-09 21:30,41,18,23,0,0,0
2025-09-09 21:45,38,14,24,0,0,0
2025-09-09 22:00,38,14,24,0,0,0
2025-09-09 22:15,56,17,39,0,0,0
2025-09-09 22:30,37,9,28,0,0,0
2025-09-09 22:45,70,11,59,0,0,0
2025-09-09 23:00,44,14,30,0,0,0
2025-09-09 23:15,23,8,15,0,0,0
2025-09-09 23:30,20,6,14,0,0,0
2025-09-09 23:45,9,3,6,0,0,0
2025-09-10 00:00,13,3,10,0,0,0
2025-09-10 00:15,10,0,10,0,0,0
2025-09-10 00:30,13,1,12,0,0,0
2025-09-10 00:45,7,2,5,0,0,0
2025-09-10 01:00,7,4,3,0,0,0
2025-09-10 01:15,9,2,7,0,0,0
2025-09-10 01:30,4,1,3,0,0,0
2025-09-10 01:45,2,1,1,0,0,0
2025-09-10 02:00,4,1,3,0,0,0
2025-09-10 02:15,1,0,1,0,0,0
2025-09-10 02:30,1,0,1,0,0,0
2025-09-10 02:45,0,0,0,0,0,0
2025-09-10 03:00,1,1,0,0,0,0
2025-09-10 03:15,0,0,0,0,0,0
2025-09-10 03:30,3,0,3,0,0,0
2025-09-10 03:45,1,1,0,0,0,0
2025-09-10 04:00,2,1,1,0,0,0
2025-09-10 04:15,2,2,0,0,0,0
2025-09-10 04:30,8,4,4,0,0,0
2025-09-10 04:45,10,2,8,0,0,0
2025-09-10 05:00,5,3,2,0,0,0
2025-09-10 05:15,12,6,6,0,0,0
2025-09-10 05:30,22,7,15,0,0,0
2025-09-10 05:45,33,19,14,0,0,0
2025-09-10 06:00,31,14,17,0,0,0
2025-09-10 06:15,40,22,18,0,0,0
2025-09-10 06:30,54,23,31,0,0,0
2025-09-10 06:45,78,42,36,0,0,0
2025-09-10 07:00,76,37,39,0,0,0
2025-09-10 07:15,115,55,60,0,0,0
2025-09-10 07:30,155,70,85,0,0,0
2025-09-10 07:45,180,110,70,0,0,0
2025-09-10 08:00,181,116,65,0,0,0
2025-09-10 08:15,145,80,65,0,0,0
2025-09-10 08:30,144,80,64,0,0,0
2025-09-10 08:45,161,95,66,0,0,0
2025-09-10 09:00,123,56,67,0,0,0
2025-09-10 09:15,101,51,50,0,0,0
2025-09-10 09:30,83,32,51,0,0,0
2025-09-10 09:45,102,47,55,0,0,0
2025-09-10 10:00,62,28,34,0,0,0
2025-09-10 10:15,74,37,37,0,0,0
2025-09-10 10:30,94,37,57,0,0,0
2025-09-10 10:45,85,29,56,0,0,0
2025-09-10 11:00,113,51,62,0,0,0
2025-09-10 11:15,100,46,54,0,0,0
2025-09-10 11:30,112,47,65,0,0,0
2025-09-10 11:45,117,54,63,0,0,0
2025-09-10 12:00,128,51,77,0,0,0
2025-09-10 12:15,105,53,52,0,0,0
2025-09-10 12:30,140,76,64,0,0,0
2025-09-10 12:45,106,56,50,0,0,0
2025-09-10 13:00,112,57,55,0,0,0
2025-09-10 13:15,141,79,62,0,0,0
2025-09-10 13:30,114,54,60,0,0,0
2025-09-10 13:45,143,76,67,0,0,0
2025-09-10 14:00,141,82,59,0,0,0
2025-09-10 14:15,133,72,61,0,0,0
2025-09-10 14:30,127,72,55,0,0,0
2025-09-10 14:45,123,54,69,0,0,0
2025-09-10 15:00,143,80,63,0,0,0
2025-09-10 15:15,145,82,63,0,0,0
2025-09-10 15:30,156,85,71,0,0,0
2025-09-10 15:45,160,84,76,0,0,0
2025-09-10 16:00,191,101,90,0,0,0
2025-09-10 16:15,174,111,63,0,0,0
2025-09-10 16:30,183,98,85,0,0,0
2025-09-10 16:45,222,106,116,0,0,0
2025-09-10 17:00,174,82,92,0,0,0
2025-09-10 17:15,198,88,110,0,0,0
2025-09-10 17:30,172,88,84,0,0,0
2025-09-10 17:45,181,101,80,0,0,0
2025-09-10 18:00,157,66,91,0,0,0
2025-09-10 18:15,148,75,73,0,0,0
2025-09-10 18:30,148,80,68,0,0,0
2025-09-10 18:45,167,82,85,0,0,0
2025-09-10 19:00,147,83,64,0,0,0
2025-09-10 19:15,149,83,66,0,0,0
2025-09-10 19:30,103,62,41,0,0,0
2025-09-10 19:45,118,52,66,0,0,0
2025-09-10 20:00,107,63,44,0,0,0
2025-09-10 20:15,90,49,41,0,0,0
2025-09-10 20:30,63,29,34,0,0,0
2025-09-10 20:45,84,35,49,0,0,0
2025-09-10 21:00,64,22,42,0,0,0
2025-09-10 21:15,70,34,36,0,0,0
2025-09-10 21:30,89,40,49,0,0,0
2025-09-10 21:45,58,21,37,0,0,0
2025-09-10 22:00,75,31,44,0,0,0
2025-09-10 22:15,93,22,71,0,0,0
2025-09-10 22:30,53,18,35,0,0,0
2025-09-10 22:45,43,21,22,0,0,0
2025-09-10 23:00,45,15,30,0,0,0
2025-09-10 23:15,52,24,28,0,0,0
2025-09-10 23:30,25,7,18,0,0,0
2025-09-10 23:45,21,8,13,0,0,0
2025-09-11 00:00,19,3,16,0,0,0
2025-09-11 00:15,17,6,11,0,0,0
2025-09-11 00:30,15,3,12,0,0,0
2025-09-11 00:45,11,1,10,0,0,0
2025-09-11 01:00,5,2,3,0,0,0
2025-09-11 01:15,7,0,7,0,0,0
2025-09-11 01:30,5,1,4,0,0,0
2025-09-11 01:45,1,0,1,0,0,0
2025-09-11 02:00,6,2,4,0,0,0
2025-09-11 02:15,2,2,0,0,0,0
2025-09-11 02:30,3,0,3,0,0,0
2025-09-11 02:45,3,1,2,0,0,0
2025-09-11 03:00,3,0,3,0,0,0
2025-09-11 03:15,1,1,0,0,0,0
2025-09-11 03:30,3,2,1,0,0,0
2025-09-11 03:45,1,0,1,0,0,0
2025-09-11 04:00,1,1,0,0,0,0
2025-09-11 04:15,2,1,1,0,0,0
2025-09-11 04:30,6,1,5,0,0,0
2025-09-11 04:45,5,3,2,0,0,0
2025-09-11 05:00,4,2,2,0,0,0
2025-09-11 05:15,8,4,4,0,0,0
2025-09-11 05:30,12,6,6,0,0,0
2025-09-11 05:45,22,7,15,0,0,0
2025-09-11 06:00,28,10,18,0,0,0
2025-09-11 06:15,38,14,24,0,0,0
2025-09-11 06:30,57,21,36,0,0,0
2025-09-11 06:45,85,41,44,0,0,0
2025-09-11 07:00,79,36,43,0,0,0
2025-09-11 07:15,115,51,64,0,0,0
2025-09-11 07:30,163,79,84,0,0,0
2025-09-11 07:45,151,95,56,0,0,0
2025-09-11 08:00,143,84,59,0,0,0
2025-09-11 08:15,157,90,67,0,0,0
2025-09-11 08:30,124,63,61,0,0,0
2025-09-11 08:45,156,79,77,0,0,0
2025-09-11 09:00,108,48,60,0,0,0
2025-09-11 09:15,76,34,42,0,0,0
2025-09-11 09:30,96,39,57,0,0,0
2025-09-11 09:45,92,40,52,0,0,0
2025-09-11 10:00,79,29,50,0,0,0
2025-09-11 10:15,71,29,42,0,0,0
2025-09-11 10:30,71,22,49,0,0,0
2025-09-11 10:45,84,50,34,0,0,0
2025-09-11 11:00,85,42,43,0,0,0
2025-09-11 11:15,95,29,66,0,0,0
2025-09-11 11:30,91,41,50,0,0,0
2025-09-11 11:45,103,47,56,0,0,0
2025-09-11 12:00,108,44,64,0,0,0
2025-09-11 12:15,94,50,44,0,0,0
2025-09-11 12:30,88,45,43,0,0,0
2025-09-11 12:45,115,64,51,0,0,0
2025-09-11 13:00,111,53,58,0,0,0
2025-09-11 13:15,114,56,58,0,0,0
2025-09-11 13:30,112,58,54,0,0,0
2025-09-11 13:45,108,51,57,0,0,0
2025-09-11 14:00,124,72,52,0,0,0
2025-09-11 14:15,113,63,50,0,0,0
2025-09-11 14:30,121,61,60,0,0,0
2025-09-11 14:45,123,54,69,0,0,0
2025-09-11 15:00,162,68,94,0,0,0
2025-09-11 15:15,107,53,54,0,0,0
2025-09-11 15:30,113,50,63,0,0,0
2025-09-11 15:45,136,65,71,0,0,0
2025-09-11 16:00,146,64,82,0,0,0
2025-09-11 16:15,179,76,103,0,0,0
2025-09-11 16:30,161,69,92,0,0,0
2025-09-11 16:45,162,76,86,0,0,0
2025-09-11 17:00,167,82,85,0,0,0
2025-09-11 17:15,137,57,80,0,0,0
2025-09-11 17:30,180,84,96,0,0,0
2025-09-11 17:45,178,103,75,0,0,0
2025-09-11 18:00,116,56,60,0,0,0
2025-09-11 18:15,107,50,57,0,0,0
2025-09-11 18:30,123,55,68,0,0,0
2025-09-11 18:45,102,50,52,0,0,0
2025-09-11 19:00,102,55,47,0,0,0
2025-09-11 19:15,105,59,46,0,0,0
2025-09-11 19:30,106,62,44,0,0,0
2025-09-11 19:45,106,58,48,0,0,0
2025-09-11 20:00,87,44,43,0,0,0
2025-09-11 20:15,87,40,47,0,0,0
2025-09-11 20:30,69,34,35,0,0,0
2025-09-11 20:45,69,30,39,0,0,0
2025-09-11 21:00,64,38,26,0,0,0
2025-09-11 21:15,46,18,28,0,0,0
2025-09-11 21:30,44,15,29,0,0,0
2025-09-11 21:45,60,27,33,0,0,0
2025-09-11 22:00,55,16,39,0,0,0
2025-09-11 22:15,43,7,36,0,0,0
2025-09-11 22:30,48,20,28,0,0,0
2025-09-11 22:45,47,16,31,0,0,0
2025-09-11 23:00,40,12,28,0,0,0
2025-09-11 23:15,20,5,15,0,0,0
2025-09-11 23:30,17,8,9,0,0,0
2025-09-11 23:45,17,4,13,0,0,0
2025-09-12 00:00,13,5,8,0,0,0
2025-09-12 00:15,17,4,13,0,0,0
2025-09-12 00:30,12,3,9,0,0,0
2025-09-12 00:45,9,7,2,0,0,0
2025-09-12 01:00,7,1,6,0,0,0
2025-09-12 01:15,6,6,0,0,0,0
2025-09-12 01:30,6,2,4,0,0,0
2025-09-12 01:45,4,0,4,0,0,0
2025-09-12 02:00,0,0,0,0,0,0
2025-09-12 02:15,2,1,1,0,0,0
2025-09-12 02:30,2,1,1,0,0,0
2025-09-12 02:45,3,0,3,0,0,0
2025-09-12 03:00,0,0,0,0,0,0
2025-09-12 03:15,1,0,1,0,0,0
2025-09-12 03:30,3,1,2,0,0,0
2025-09-12 03:45,1,1,0,0,0,0
2025-09-12 04:00,2,1,1,0,0,0
2025-09-12 04:15,7,2,5,0,0,0
2025-09-12 04:30,8,1,7,0,0,0
2025-09-12 04:45,4,2,2,0,0,0
2025-09-12 05:00,3,1,2,0,0,0
2025-09-12 05:15,12,5,7,0,0,0
2025-09-12 05:30,20,12,8,0,0,0
2025-09-12 05:45,21,13,8,0,0,0
2025-09-12 06:00,25,12,13,0,0,0
2025-09-12 06:15,28,14,14,0,0,0
2025-09-12 06:30,40,17,23,0,0,0
2025-09-12 06:45,58,32,26,0,0,0
2025-09-12 07:00,83,37,46,0,0,0
2025-09-12 07:15,88,38,50,0,0,0
2025-09-12 07:30,155,58,97,0,0,0
2025-09-12 07:45,136,80,56,0,0,0
2025-09-12 08:00,129,63,66,0,0,0
2025-09-12 08:15,104,58,46,0,0,0
2025-09-12 08:30,125,72,53,0,0,0
2025-09-12 08:45,117,49,68,0,0,0
2025-09-12 09:00,92,35,57,0,0,0
2025-09-12 09:15,89,39,50,0,0,0
2025-09-12 09:30,81,25,56,0,0,0
2025-09-12 09:45,69,29,40,0,0,0
2025-09-12 10:00,78,22,56,0,0,0
2025-09-12 10:15,64,19,45,0,0,0
2025-09-12 10:30,65,30,35,0,0,0
2025-09-12 10:45,82,35,47,0,0,0
2025-09-12 11:00,92,42,50,0,0,0
2025-09-12 11:15,96,33,63,0,0,0
2025-09-12 11:30,98,42,56,0,0,0
2025-09-12 11:45,108,47,61,0,0,0
2025-09-12 12:00,98,45,53,0,0,0
2025-09-12 12:15,125,51,74,0,0,0
2025-09-12 12:30,121,61,60,0,0,0
2025-09-12 12:45,100,48,52,0,0,0
2025-09-12 13:00,129,57,72,0,0,0
2025-09-12 13:15,118,46,72,0,0,0
2025-09-12 13:30,121,39,82,0,0,0
2025-09-12 13:45,126,52,74,0,0,0
2025-09-12 14:00,164,76,88,0,0,0
2025-09-12 14:15,139,54,85,0,0,0
2025-09-12 14:30,131,55,76,0,0,0
2025-09-12 14:45,136,54,82,0,0,0
2025-09-12 15:00,137,72,65,0,0,0
2025-09-12 15:15,123,54,69,0,0,0
2025-09-12 15:30,154,74,80,0,0,0
2025-09-12 15:45,127,50,77,0,0,0
2025-09-12 16:00,135,64,71,0,0,0
2025-09-12 16:15,115,54,61,0,0,0
2025-09-12 16:30,128,53,75,0,0,0
2025-09-12 16:45,121,52,69,0,0,0
2025-09-12 17:00,146,70,76,0,0,0
2025-09-12 17:15,131,53,78,0,0,0
2025-09-12 17:30,128,63,65,0,0,0
2025-09-12 17:45,150,88,62,0,0,0
2025-09-12 18:00,131,67,64,0,0,0
2025-09-12 18:15,114,59,55,0,0,0
2025-09-12 18:30,126,62,64,0,0,0
2025-09-12 18:45,116,67,49,0,0,0
2025-09-12 19:00,109,54,55,0,0,0
2025-09-12 19:15,94,49,45,0,0,0
2025-09-12 19:30,98,66,32,0,0,0
2025-09-12 19:45,94,42,52,0,0,0
2025-09-12 20:00,99,48,51,0,0,0
2025-09-12 20:15,93,50,43,0,0,0
2025-09-12 20:30,71,36,35,0,0,0
2025-09-12 20:45,68,31,37,0,0,0
2025-09-12 21:00,61,34,27,0,0,0
2025-09-12 21:15,51,26,25,0,0,0
2025-09-12 21:30,51,26,25,0,0,0
2025-09-12 21:45,72,33,39,0,0,0
2025-09-12 22:00,54,35,19,0,0,0
2025-09-12 22:15,60,26,34,0,0,0
2025-09-12 22:30,70,29,41,0,0,0
2025-09-12 22:45,67,31,36,0,0,0
2025-09-12 23:00,45,16,29,0,0,0
2025-09-12 23:15,41,18,23,0,0,0
2025-09-12 23:30,76,36,40,0,0,0
2025-09-12 23:45,45,19,26,0,0,0
2025-09-13 00:00,49,11,38,0,0,0
2025-09-13 00:15,53,25,28,0,0,0
2025-09-13 00:30,29,13,16,0,0,0
2025-09-13 00:45,42,28,14,0,0,0
2025-09-13 01:00,39,16,23,0,0,0
2025-09-13 01:15,31,6,25,0,0,0
2025-09-13 01:30,22,6,16,0,0,0
2025-09-13 01:45,22,10,12,0,0,0
2025-09-13 02:00,24,13,11,0,0,0
2025-09-13 02:15,16,6,10,0,0,0
2025-09-13 02:30,14,5,9,0,0,0
2025-09-13 02:45,13,6,7,0,0,0
2025-09-13 03:00,10,3,7,0,0,0
2025-09-13 03:15,21,10,11,0,0,0
2025-09-13 03:30,11,2,9,0,0,0
2025-09-13 03:45,8,4,4,0,0,0
2025-09-13 04:00,4,0,4,0,0,0
2025-09-13 04:15,4,1,3,0,0,0
2025-09-13 04:30,8,1,7,0,0,0
2025-09-13 04:45,4,1,3,0,0,0
2025-09-13 05:00,5,0,5,0,0,0
2025-09-13 05:15,7,3,4,0,0,0
2025-09-13 05:30,14,4,10,0,0,0
2025-09-13 05:45,5,2,3,0,0,0
2025-09-13 06:00,6,2,4,0,0,0
2025-09-13 06:15,7,5,2,0,0,0
2025-09-13 06:30,7,3,4,0,0,0
2025-09-13 06:45,10,8,2,0,0,0
2025-09-13 07:00,11,5,6,0,0,0
2025-09-13 07:15,15,6,9,0,0,0
2025-09-13 07:30,24,7,17,0,0,0
2025-09-13 07:45,17,9,8,0,0,0
2025-09-13 08:00,18,6,12,0,0,0
2025-09-13 08:15,26,8,18,0,0,0
2025-09-13 08:30,28,6,22,0,0,0
2025-09-13 08:45,46,18,28,0,0,0
2025-09-13 09:00,47,19,28,0,0,0
2025-09-13 09:15,38,18,20,0,0,0
2025-09-13 09:30,48,16,32,0,0,0
2025-09-13 09:45,56,27,29,0,0,0
2025-09-13 10:00,59,26,33,0,0,0
2025-09-13 10:15,40,17,23,0,0,0
2025-09-13 10:30,71,21,50,0,0,0
2025-09-13 10:45,71,21,50,0,0,0
2025-09-13 11:00,100,45,55,0,0,0
2025-09-13 11:15,81,24,57,0,0,0
2025-09-13 11:30,69,26,43,0,0,0
2025-09-13 11:45,92,44,48,0,0,0
2025-09-13 12:00,116,46,70,0,0,0
2025-09-13 12:15,76,27,49,0,0,0
2025-09-13 12:30,65,35,30,0,0,0
2025-09-13 12:45,100,47,53,0,0,0
2025-09-13 13:00,119,38,81,0,0,0
2025-09-13 13:15,79,42,37,0,0,0
2025-09-13 13:30,96,38,58,0,0,0
2025-09-13 13:45,111,57,54,0,0,0
2025-09-13 14:00,112,53,59,0,0,0
2025-09-13 14:15,87,37,50,0,0,0
2025-09-13 14:30,102,53,49,0,0,0
2025-09-13 14:45,103,45,58,0,0,0
2025-09-13 15:00,102,50,52,0,0,0
2025-09-13 15:15,80,39,41,0,0,0
2025-09-13 15:30,120,66,54,0,0,0
2025-09-13 15:45,119,61,58,0,0,0
2025-09-13 16:00,104,45,59,0,0,0
2025-09-13 16:15,114,50,64,0,0,0
2025-09-13 16:30,114,51,63,0,0,0
2025-09-13 16:45,111,49,62,0,0,0
2025-09-13 17:00,128,51,77,0,0,0
2025-09-13 17:15,139,56,83,0,0,0
2025-09-13 17:30,125,47,78,0,0,0
2025-09-13 17:45,132,65,67,0,0,0
2025-09-13 18:00,142,64,78,0,0,0
2025-09-13 18:15,106,34,72,0,0,0
2025-09-13 18:30,106,42,64,0,0,0
2025-09-13 18:45,84,38,46,0,0,0
2025-09-13 19:00,132,57,75,0,0,0
2025-09-13 19:15,60,22,38,0,0,0
2025-09-13 19:30,80,41,39,0,0,0
2025-09-13 19:45,101,43,58,0,0,0
2025-09-13 20:00,105,52,53,0,0,0
2025-09-13 20:15,64,31,33,0,0,0
2025-09-13 20:30,48,19,29,0,0,0
2025-09-13 20:45,50,20,30,0,0,0
2025-09-13 21:00,47,16,31,0,0,0
2025-09-13 21:15,21,6,15,0,0,0
2025-09-13 21:30,32,11,21,0,0,0
2025-09-13 21:45,19,12,7,0,0,0
2025-09-13 22:00,33,10,23,0,0,0
2025-09-13 22:15,46,11,35,0,0,0
2025-09-13 22:30,60,17,43,0,0,0
2025-09-13 22:45,47,17,30,0,0,0
2025-09-13 23:00,36,7,29,0,0,0
2025-09-13 23:15,44,14,30,0,0,0
2025-09-13 23:30,52,18,34,0,0,0
2025-09-13 23:45,25,11,14,0,0,0
2025-09-14 00:00,28,15,13,0,0,0
2025-09-14 00:15,37,5,32,0,0,0
2025-09-14 00:30,24,8,16,0,0,0
2025-09-14 00:45,26,6,20,0,0,0
2025-09-14 01:00,30,8,22,0,0,0
2025-09-14 01:15,37,11,26,0,0,0
2025-09-14 01:30,22,10,12,0,0,0
2025-09-14 01:45,17,5,12,0,0,0
2025-09-14 02:00,20,7,13,0,0,0
2025-09-14 02:15,28,11,17,0,0,0
2025-09-14 02:30,12,5,7,0,0,0
2025-09-14 02:45,10,1,9,0,0,0
2025-09-14 03:00,15,7,8,0,0,0
2025-09-14 03:15,6,0,6,0,0,0
2025-09-14 03:30,11,3,8,0,0,0
2025-09-14 03:45,6,2,4,0,0,0
2025-09-14 04:00,16,2,14,0,0,0
2025-09-14 04:15,9,1,8,0,0,0
2025-09-14 04:30,5,0,5,0,0,0
2025-09-14 04:45,7,1,6,0,0,0
2025-09-14 05:00,4,0,4,0,0,0
2025-09-14 05:15,9,0,9,0,0,0
2025-09-14 05:30,2,0,2,0,0,0
2025-09-14 05:45,9,2,7,0,0,0
2025-09-14 06:00,8,2,6,0,0,0
2025-09-14 06:15,8,4,4,0,0,0
2025-09-14 06:30,9,2,7,0,0,0
2025-09-14 06:45,4,3,1,0,0,0
2025-09-14 07:00,8,5,3,0,0,0
2025-09-14 07:15,5,3,2,0,0,0
2025-09-14 07:30,7,3,4,0,0,0
2025-09-14 07:45,10,3,7,0,0,0
2025-09-14 08:00,9,3,6,0,0,0
2025-09-14 08:15,9,4,5,0,0,0
2025-09-14 08:30,10,1,9,0,0,0
2025-09-14 08:45,21,12,9,0,0,0
2025-09-14 09:00,32,11,21,0,0,0
2025-09-14 09:15,20,9,11,0,0,0
2025-09-14 09:30,32,16,16,0,0,0
2025-09-14 09:45,39,18,21,0,0,0
2025-09-14 10:00,48,27,21,0,0,0
2025-09-14 10:15,46,24,22,0,0,0
2025-09-14 10:30,74,35,39,0,0,0
2025-09-14 10:45,62,26,36,0,0,0
2025-09-14 11:00,53,25,28,0,0,0
2025-09-14 11:15,51,20,31,0,0,0
2025-09-14 11:30,38,18,20,0,0,0
2025-09-14 11:45,55,19,36,0,0,0
2025-09-14 12:00,66,33,33,0,0,0
2025-09-14 12:15,66,32,34,0,0,0
2025-09-14 12:30,74,31,43,0,0,0
2025-09-14 12:45,71,28,43,0,0,0
2025-09-14 13:00,71,20,51,0,0,0
2025-09-14 13:15,54,28,26,0,0,0
2025-09-14 13:30,70,22,48,0,0,0
2025-09-14 13:45,66,33,33,0,0,0
2025-09-14 14:00,67,32,35,0,0,0
2025-09-14 14:15,76,32,44,0,0,0
2025-09-14 14:30,89,53,36,0,0,0
2025-09-14 14:45,93,54,39,0,0,0
2025-09-14 15:00,103,37,66,0,0,0
2025-09-14 15:15,60,20,40,0,0,0
2025-09-14 15:30,86,41,45,0,0,0
2025-09-14 15:45,73,30,43,0,0,0
2025-09-14 16:00,91,42,49,0,0,0
2025-09-14 16:15,76,36,40,0,0,0
2025-09-14 16:30,97,40,57,0,0,0
2025-09-14 16:45,106,61,45,0,0,0
2025-09-14 17:00,112,56,56,0,0,0
2025-09-14 17:15,95,39,56,0,0,0
2025-09-14 17:30,117,58,59,0,0,0
2025-09-14 17:45,95,50,45,0,0,0
2025-09-14 18:00,94,41,53,0,0,0
2025-09-14 18:15,70,28,42,0,0,0
2025-09-14 18:30,91,36,55,0,0,0
2025-09-14 18:45,64,25,39,0,0,0
2025-09-14 19:00,83,48,35,0,0,0
2025-09-14 19:15,42,16,26,0,0,0
2025-09-14 19:30,94,29,65,0,0,0
2025-09-14 19:45,86,40,46,0,0,0
2025-09-14 20:00,53,27,26,0,0,0
2025-09-14 20:15,65,31,34,0,0,0
2025-09-14 20:30,39,22,17,0,0,0
2025-09-14 20:45,41,14,27,0,0,0
2025-09-14 21:00,31,12,19,0,0,0
2025-09-14 21:15,30,13,17,0,0,0
2025-09-14 21:30,26,12,14,0,0,0
2025-09-14 21:45,19,9,10,0,0,0
2025-09-14 22:00,45,12,33,0,0,0
2025-09-14 22:15,47,17,30,0,0,0
2025-09-14 22:30,34,19,15,0,0,0
2025-09-14 22:45,25,8,17,0,0,0
2025-09-14 23:00,33,12,21,0,0,0
2025-09-14 23:15,28,6,22,0,0,0
2025-09-14 23:30,10,6,4,0,0,0
2025-09-14 23:45,4,1,3,0,0,0
2025-09-15 00:00,10,3,7,0,0,0
2025-09-15 00:15,9,5,4,0,0,0
2025-09-15 00:30,4,0,4,0,0,0
2025-09-15 00:45,7,2,5,0,0,0
2025-09-15 01:00,4,3,1,0,0,0
2025-09-15 01:15,4,2,2,0,0,0
2025-09-15 01:30,4,1,3,0,0,0
2025-09-15 01:45,2,0,2,0,0,0
2025-09-15 02:00,1,1,0,0,0,0
2025-09-15 02:15,2,1,1,0,0,0
2025-09-15 02:30,3,0,3,0,0,0
2025-09-15 02:45,0,0,0,0,0,0
2025-09-15 03:00,4,0,4,0,0,0
2025-09-15 03:15,0,0,0,0,0,0
2025-09-15 03:30,1,1,0,0,0,0
2025-09-15 03:45,2,2,0,0,0,0
2025-09-15 04:00,0,0,0,0,0,0
2025-09-15 04:15,0,0,0,0,0,0
2025-09-15 04:30,5,0,5,0,0,0
2025-09-15 04:45,8,2,6,0,0,0
2025-09-15 05:00,3,2,1,0,0,0
2025-09-15 05:15,10,4,6,0,0,0
2025-09-15 05:30,10,2,8,0,0,0
2025-09-15 05:45,24,11,13,0,0,0
2025-09-15 06:00,20,9,11,0,0,0
2025-09-15 06:15,29,12,17,0,0,0
2025-09-15 06:30,54,25,29,0,0,0
2025-09-15 06:45,41,23,18,0,0,0
2025-09-15 07:00,55,27,28,0,0,0
2025-09-15 07:15,87,37,50,0,0,0
2025-09-15 07:30,144,68,76,0,0,0
2025-09-15 07:45,143,79,64,0,0,0
2025-09-15 08:00,133,75,58,0,0,0
2025-09-15 08:15,137,78,59,0,0,0
2025-09-15 08:30,139,70,69,0,0,0
2025-09-15 08:45,133,66,67,0,0,0
2025-09-15 09:00,101,53,48,0,0,0
2025-09-15 09:15,81,39,42,0,0,0
2025-09-15 09:30,93,38,55,0,0,0
2025-09-15 09:45,83,29,54,0,0,0
2025-09-15 10:00,67,25,42,0,0,0
2025-09-15 10:15,74,29,45,0,0,0
2025-09-15 10:30,73,24,49,0,0,0
2025-09-15 10:45,74,26,48,0,0,0
2025-09-15 11:00,91,35,56,0,0,0
2025-09-15 11:15,74,36,38,0,0,0
2025-09-15 11:30,91,43,48,0,0,0
2025-09-15 11:45,106,35,71,0,0,0
2025-09-15 12:00,84,40,44,0,0,0
2025-09-15 12:15,103,51,52,0,0,0
2025-09-15 12:30,110,48,62,0,0,0
2025-09-15 12:45,98,54,44,0,0,0
2025-09-15 13:00,102,43,59,0,0,0
2025-09-15 13:15,97,46,51,0,0,0
2025-09-15 13:30,95,39,56,0,0,0
2025-09-15 13:45,94,44,50,0,0,0
2025-09-15 14:00,90,42,48,0,0,0
2025-09-15 14:15,106,58,48,0,0,0
2025-09-15 14:30,104,44,60,0,0,0
2025-09-15 14:45,114,62,52,0,0,0
2025-09-15 15:00,112,51,61,0,0,0
2025-09-15 15:15,116,52,64,0,0,0
2025-09-15 15:30,118,54,64,0,0,0
2025-09-15 15:45,120,60,60,0,0,0
2025-09-15 16:00,118,55,63,0,0,0
2025-09-15 16:15,132,74,58,0,0,0
2025-09-15 16:30,148,55,93,0,0,0
2025-09-15 16:45,165,70,95,0,0,0
2025-09-15 17:00,129,44,85,0,0,0
2025-09-15 17:15,102,38,64,0,0,0
2025-09-15 17:30,155,73,82,0,0,0
2025-09-15 17:45,180,106,74,0,0,0
2025-09-15 18:00,137,61,76,0,0,0
2025-09-15 18:15,127,61,66,0,0,0
2025-09-15 18:30,88,49,39,0,0,0
2025-09-15 18:45,126,50,76,0,0,0
2025-09-15 19:00,85,44,41,0,0,0
2025-09-15 19:15,101,49,52,0,0,0
2025-09-15 19:30,67,37,30,0,0,0
2025-09-15 19:45,96,51,45,0,0,0
2025-09-15 20:00,95,49,46,0,0,0
2025-09-15 20:15,56,20,36,0,0,0
2025-09-15 20:30,60,26,34,0,0,0
2025-09-15 20:45,54,20,34,0,0,0
2025-09-15 21:00,46,18,28,0,0,0
2025-09-15 21:15,40,17,23,0,0,0
2025-09-15 21:30,37,15,22,0,0,0
2025-09-15 21:45,30,14,16,0,0,0
2025-09-15 22:00,37,17,20,0,0,0
2025-09-15 22:15,37,14,23,0,0,0
2025-09-15 22:30,27,15,12,0,0,0
2025-09-15 22:45,22,12,10,0,0,0
2025-09-15 23:00,16,8,8,0,0,0
2025-09-15 23:15,24,6,18,0,0,0
2025-09-15 23:30,6,3,3,0,0,0
2025-09-15 23:45,14,5,9,0,0,0
2025-09-16 00:00,6,3,3,0,0,0
2025-09-16 00:15,4,1,3,0,0,0
2025-09-16 00:30,6,1,5,0,0,0
2025-09-16 00:45,5,0,5,0,0,0
2025-09-16 01:00,7,4,3,0,0,0
2025-09-16 01:15,1,0,1,0,0,0
2025-09-16 01:30,2,2,0,0,0,0
2025-09-16 01:45,4,3,1,0,0,0
2025-09-16 02:00,1,0,1,0,0,0
2025-09-16 02:15,0,0,0,0,0,0
2025-09-16 02:30,6,1,5,0,0,0
2025-09-16 02:45,0,0,0,0,0,0
2025-09-16 03:00,0,0,0,0,0,0
2025-09-16 03:15,2,2,0,0,0,0
2025-09-16 03:30,2,2,0,0,0,0
2025-09-16 03:45,2,1,1,0,0,0
2025-09-16 04:00,2,0,2,0,0,0
2025-09-16 04:15,8,1,7,0,0,0
2025-09-16 04:30,7,1,6,0,0,0
2025-09-16 04:45,11,4,7,0,0,0
2025-09-16 05:00,6,3,3,0,0,0
2025-09-16 05:15,12,5,7,0,0,0
2025-09-16 05:30,10,2,8,0,0,0
2025-09-16 05:45,17,11,6,0,0,0
2025-09-16 06:00,29,7,22,0,0,0
2025-09-16 06:15,43,20,23,0,0,0
2025-09-16 06:30,46,22,24,0,0,0
2025-09-16 06:45,75,38,37,0,0,0
2025-09-16 07:00,74,34,40,0,0,0
2025-09-16 07:15,98,47,51,0,0,0
2025-09-16 07:30,152,79,73,0,0,0
2025-09-16 07:45,134,79,55,0,0,0
2025-09-16 08:00,111,62,49,0,0,0
2025-09-16 08:15,130,74,56,0,0,0
2025-09-16 08:30,125,66,59,0,0,0
2025-09-16 08:45,131,66,65,0,0,0
2025-09-16 09:00,127,67,60,0,0,0
2025-09-16 09:15,70,23,47,0,0,0
2025-09-16 09:30,80,34,46,0,0,0
2025-09-16 09:45,96,47,49,0,0,0
2025-09-16 10:00,65,35,30,0,0,0
2025-09-16 10:15,74,35,39,0,0,0
2025-09-16 10:30,63,24,39,0,0,0
2025-09-16 10:45,81,34,47,0,0,0
2025-09-16 11:00,82,39,43,0,0,0
2025-09-16 11:15,82,26,56,0,0,0
2025-09-16 11:30,93,33,60,0,0,0
2025-09-16 11:45,89,33,56,0,0,0
2025-09-16 12:00,107,40,67,0,0,0
2025-09-16 12:15,96,41,55,0,0,0
2025-09-16 12:30,118,56,62,0,0,0
2025-09-16 12:45,106,52,54,0,0,0
2025-09-16 13:00,121,52,69,0,0,0
2025-09-16 13:15,101,48,53,0,0,0
2025-09-16 13:30,93,44,49,0,0,0
2025-09-16 13:45,116,57,59,0,0,0
2025-09-16 14:00,106,61,45,0,0,0
2025-09-16 14:15,121,46,75,0,0,0
2025-09-16 14:30,97,34,63,0,0,0
2025-09-16 14:45,124,62,62,0,0,0
2025-09-16 15:00,106,52,54,0,0,0
2025-09-16 15:15,92,40,52,0,0,0
2025-09-16 15:30,96,34,62,0,0,0
2025-09-16 15:45,126,64,62,0,0,0
2025-09-16 16:00,130,38,92,0,0,0
2025-09-16 16:15,107,53,54,0,0,0
2025-09-16 16:30,125,51,74,0,0,0
2025-09-16 16:45,149,48,101,0,0,0
2025-09-16 17:00,156,56,100,0,0,0
2025-09-16 17:15,133,47,86,0,0,0
2025-09-16 17:30,137,55,82,0,0,0
2025-09-16 17:45,148,54,94,0,0,0
2025-09-16 18:00,132,61,71,0,0,0
2025-09-16 18:15,109,44,65,0,0,0
2025-09-16 18:30,112,42,70,0,0,0
2025-09-16 18:45,116,66,50,0,0,0
2025-09-16 19:00,91,46,45,0,0,0
2025-09-16 19:15,96,54,42,0,0,0
2025-09-16 19:30,79,35,44,0,0,0
2025-09-16 19:45,89,44,45,0,0,0
2025-09-16 20:00,60,30,30,0,0,0
2025-09-16 20:15,62,31,31,0,0,0
2025-09-16 20:30,60,32,28,0,0,0
2025-09-16 20:45,46,18,28,0,0,0
2025-09-16 21:00,59,29,30,0,0,0
2025-09-16 21:15,44,13,31,0,0,0
2025-09-16 21:30,38,19,19,0,0,0
2025-09-16 21:45,33,16,17,0,0,0
2025-09-16 22:00,36,19,17,0,0,0
2025-09-16 22:15,51,17,34,0,0,0
2025-09-16 22:30,38,17,21,0,0,0
2025-09-16 22:45,26,8,18,0,0,0
2025-09-16 23:00,37,17,20,0,0,0
2025-09-16 23:15,33,19,14,0,0,0
2025-09-16 23:30,23,7,16,0,0,0
2025-09-16 23:45,13,1,12,0,0,0
2025-09-17 00:00,24,2,22,0,0,0
2025-09-17 00:15,3,1,2,0,0,0
2025-09-17 00:30,10,1,9,0,0,0
2025-09-17 00:45,12,2,10,0,0,0
2025-09-17 01:00,3,0,3,0,0,0
2025-09-17 01:15,5,1,4,0,0,0
2025-09-17 01:30,4,3,1,0,0,0
2025-09-17 01:45,5,3,2,0,0,0
2025-09-17 02:00,0,0,0,0,0,0
2025-09-17 02:15,4,1,3,0,0,0
2025-09-17 02:30,4,0,4,0,0,0
2025-09-17 02:45,2,0,2,0,0,0
2025-09-17 03:00,1,0,1,0,0,0
2025-09-17 03:15,0,0,0,0,0,0
2025-09-17 03:30,0,0,0,0,0,0
2025-09-17 03:45,2,1,1,0,0,0
2025-09-17 04:00,1,1,0,0,0,0
2025-09-17 04:15,5,2,3,0,0,0
2025-09-17 04:30,4,2,2,0,0,0
2025-09-17 04:45,5,1,4,0,0,0
2025-09-17 05:00,4,3,1,0,0,0
2025-09-17 05:15,12,3,9,0,0,0
2025-09-17 05:30,15,8,7,0,0,0
2025-09-17 05:45,26,13,13,0,0,0
2025-09-17 06:00,30,13,17,0,0,0
2025-09-17 06:15,49,24,25,0,0,0
2025-09-17 06:30,41,17,24,0,0,0
2025-09-17 06:45,87,48,39,0,0,0
2025-09-17 07:00,61,26,35,0,0,0
2025-09-17 07:15,110,48,62,0,0,0
2025-09-17 07:30,165,68,97,0,0,0
2025-09-17 07:45,158,98,60,0,0,0
2025-09-17 08:00,161,81,80,0,0,0
2025-09-17 08:15,159,88,71,0,0,0
2025-09-17 08:30,124,63,61,0,0,0
2025-09-17 08:45,159,74,85,0,0,0
2025-09-17 09:00,101,50,51,0,0,0
2025-09-17 09:15,87,37,50,0,0,0
2025-09-17 09:30,86,35,51,0,0,0
2025-09-17 09:45,97,32,65,0,0,0
2025-09-17 10:00,91,39,52,0,0,0
2025-09-17 10:15,74,32,42,0,0,0
2025-09-17 10:30,83,36,47,0,0,0
2025-09-17 10:45,83,35,48,0,0,0
2025-09-17 11:00,89,43,46,0,0,0
2025-09-17 11:15,101,49,52,0,0,0
2025-09-17 11:30,90,43,47,0,0,0
2025-09-17 11:45,108,49,59,0,0,0
2025-09-17 12:00,116,52,64,0,0,0
2025-09-17 12:15,109,48,61,0,0,0
2025-09-17 12:30,133,67,66,0,0,0
2025-09-17 12:45,118,53,65,0,0,0
2025-09-17 13:00,113,60,53,0,0,0
2025-09-17 13:15,113,45,68,0,0,0
2025-09-17 13:30,119,47,72,0,0,0
2025-09-17 13:45,101,49,52,0,0,0
2025-09-17 14:00,128,63,65,0,0,0
2025-09-17 14:15,114,45,69,0,0,0
2025-09-17 14:30,106,48,58,0,0,0
2025-09-17 14:45,124,54,70,0,0,0
2025-09-17 15:00,122,67,55,0,0,0
2025-09-17 15:15,136,66,70,0,0,0
2025-09-17 15:30,137,64,73,0,0,0
2025-09-17 15:45,151,81,70,0,0,0
2025-09-17 16:00,143,66,77,0,0,0
2025-09-17 16:15,148,71,77,0,0,0
2025-09-17 16:30,169,85,84,0,0,0
2025-09-17 16:45,159,67,92,0,0,0
2025-09-17 17:00,176,70,106,0,0,0
2025-09-17 17:15,146,69,77,0,0,0
2025-09-17 17:30,168,80,88,0,0,0
2025-09-17 17:45,152,84,68,0,0,0
2025-09-17 18:00,142,63,79,0,0,0
2025-09-17 18:15,123,54,69,0,0,0
2025-09-17 18:30,116,50,66,0,0,0
2025-09-17 18:45,108,51,57,0,0,0
2025-09-17 19:00,90,44,46,0,0,0
2025-09-17 19:15,95,41,54,0,0,0
2025-09-17 19:30,82,41,41,0,0,0
2025-09-17 19:45,78,33,45,0,0,0
2025-09-17 20:00,90,51,39,0,0,0
2025-09-17 20:15,73,30,43,0,0,0
2025-09-17 20:30,63,28,35,0,0,0
2025-09-17 20:45,52,22,30,0,0,0
2025-09-17 21:00,60,36,24,0,0,0
2025-09-17 21:15,57,25,32,0,0,0
2025-09-17 21:30,45,15,30,0,0,0
2025-09-17 21:45,43,22,21,0,0,0
2025-09-17 22:00,60,23,37,0,0,0
2025-09-17 22:15,64,14,50,0,0,0
2025-09-17 22:30,27,9,18,0,0,0
2025-09-17 22:45,28,8,20,0,0,0
2025-09-17 23:00,28,12,16,0,0,0
2025-09-17 23:15,33,14,19,0,0,0
2025-09-17 23:30,10,2,8,0,0,0
2025-09-17 23:45,21,8,13,0,0,0
2025-09-18 00:00,7,2,5,0,0,0
2025-09-18 00:15,6,5,1,0,0,0
2025-09-18 00:30,14,6,8,0,0,0
2025-09-18 00:45,7,5,2,0,0,0
2025-09-18 01:00,5,3,2,0,0,0
2025-09-18 01:15,10,2,8,0,0,0
2025-09-18 01:30,6,2,4,0,0,0
2025-09-18 01:45,6,1,5,0,0,0
2025-09-18 02:00,5,3,2,0,0,0
2025-09-18 02:15,5,3,2,0,0,0
2025-09-18 02:30,2,0,2,0,0,0
2025-09-18 02:45,2,1,1,0,0,0
2025-09-18 03:00,2,0,2,0,0,0
2025-09-18 03:15,0,0,0,0,0,0
2025-09-18 03:30,3,2,1,0,0,0
2025-09-18 03:45,1,1,0,0,0,0
2025-09-18 04:00,2,1,1,0,0,0
2025-09-18 04:15,2,2,0,0,0,0
2025-09-18 04:30,4,1,3,0,0,0
2025-09-18 04:45,7,1,6,0,0,0
2025-09-18 05:00,7,3,4,0,0,0
2025-09-18 05:15,8,3,5,0,0,0
2025-09-18 05:30,12,8,4,0,0,0
2025-09-18 05:45,17,9,8,0,0,0
2025-09-18 06:00,32,13,19,0,0,0
2025-09-18 06:15,43,21,22,0,0,0
2025-09-18 06:30,62,23,39,0,0,0
2025-09-18 06:45,61,40,21,0,0,0
2025-09-18 07:00,74,32,42,0,0,0
2025-09-18 07:15,109,46,63,0,0,0
2025-09-18 07:30,188,76,112,0,0,0
2025-09-18 07:45,193,111,82,0,0,0
2025-09-18 08:00,167,91,76,0,0,0
2025-09-18 08:15,152,86,66,0,0,0
2025-09-18 08:30,126,74,52,0,0,0
2025-09-18 08:45,170,103,67,0,0,0
2025-09-18 09:00,104,47,57,0,0,0
2025-09-18 09:15,84,29,55,0,0,0
2025-09-18 09:30,88,41,47,0,0,0
2025-09-18 09:45,95,34,61,0,0,0
2025-09-18 10:00,86,38,48,0,0,0
2025-09-18 10:15,73,27,46,0,0,0
2025-09-18 10:30,85,35,50,0,0,0
2025-09-18 10:45,105,47,58,0,0,0
2025-09-18 11:00,89,41,48,0,0,0
2025-09-18 11:15,75,31,44,0,0,0
2025-09-18 11:30,84,37,47,0,0,0
2025-09-18 11:45,108,39,69,0,0,0
2025-09-18 12:00,107,50,57,0,0,0
2025-09-18 12:15,109,53,56,0,0,0
2025-09-18 12:30,104,46,58,0,0,0
2025-09-18 12:45,138,64,74,0,0,0
2025-09-18 13:00,125,67,58,0,0,0
2025-09-18 13:15,130,67,63,0,0,0
2025-09-18 13:30,120,59,61,0,0,0
2025-09-18 13:45,134,69,65,0,0,0
2025-09-18 14:00,133,69,64,0,0,0
2025-09-18 14:15,124,55,69,0,0,0
2025-09-18 14:30,148,76,72,0,0,0
2025-09-18 14:45,125,51,74,0,0,0
2025-09-18 15:00,147,81,66,0,0,0
2025-09-18 15:15,143,73,70,0,0,0
2025-09-18 15:30,122,52,70,0,0,0
2025-09-18 15:45,120,47,73,0,0,0
2025-09-18 16:00,172,77,95,0,0,0
2025-09-18 16:15,167,92,75,0,0,0
2025-09-18 16:30,150,63,87,0,0,0
2025-09-18 16:45,163,80,83,0,0,0
2025-09-18 17:00,145,54,91,0,0,0
2025-09-18 17:15,173,67,106,0,0,0
2025-09-18 17:30,191,73,118,0,0,0
2025-09-18 17:45,171,81,90,0,0,0
2025-09-18 18:00,137,62,75,0,0,0
2025-09-18 18:15,111,60,51,0,0,0
2025-09-18 18:30,126,57,69,0,0,0
2025-09-18 18:45,160,81,79,0,0,0
2025-09-18 19:00,135,74,61,0,0,0
2025-09-18 19:15,110,54,56,0,0,0
2025-09-18 19:30,124,65,59,0,0,0
2025-09-18 19:45,107,56,51,0,0,0
2025-09-18 20:00,95,31,64,0,0,0
2025-09-18 20:15,66,27,39,0,0,0
2025-09-18 20:30,60,25,35,0,0,0
2025-09-18 20:45,81,35,46,0,0,0
2025-09-18 21:00,77,38,39,0,0,0
2025-09-18 21:15,66,26,40,0,0,0
2025-09-18 21:30,55,20,35,0,0,0
2025-09-18 21:45,58,20,38,0,0,0
2025-09-18 22:00,66,25,41,0,0,0
2025-09-18 22:15,58,21,37,0,0,0
2025-09-18 22:30,56,22,34,0,0,0
2025-09-18 22:45,45,12,33,0,0,0
2025-09-18 23:00,35,15,20,0,0,0
2025-09-18 23:15,36,11,25,0,0,0
2025-09-18 23:30,24,8,16,0,0,0
2025-09-18 23:45,19,6,13,0,0,0
2025-09-19 00:00,12,4,8,0,0,0
2025-09-19 00:15,8,2,6,0,0,0
2025-09-19 00:30,11,4,7,0,0,0
2025-09-19 00:45,13,5,8,0,0,0
2025-09-19 01:00,10,2,8,0,0,0
2025-09-19 01:15,6,2,4,0,0,0
2025-09-19 01:30,7,1,6,0,0,0
2025-09-19 01:45,3,0,3,0,0,0
2025-09-19 02:00,3,0,3,0,0,0
2025-09-19 02:15,6,0,6,0,0,0
2025-09-19 02:30,3,1,2,0,0,0
2025-09-19 02:45,2,1,1,0,0,0
2025-09-19 03:00,8,0,8,0,0,0
2025-09-19 03:15,0,0,0,0,0,0
2025-09-19 03:30,5,2,3,0,0,0
2025-09-19 03:45,8,2,6,0,0,0
2025-09-19 04:00,9,5,4,0,0,0
2025-09-19 04:15,3,0,3,0,0,0
2025-09-19 04:30,6,1,5,0,0,0
2025-09-19 04:45,9,3,6,0,0,0
2025-09-19 05:00,2,1,1,0,0,0
2025-09-19 05:15,10,5,5,0,0,0
2025-09-19 05:30,17,6,11,0,0,0
2025-09-19 05:45,23,10,13,0,0,0
2025-09-19 06:00,35,13,22,0,0,0
2025-09-19 06:15,41,23,18,0,0,0
2025-09-19 06:30,48,25,23,0,0,0
2025-09-19 06:45,71,41,30,0,0,0
2025-09-19 07:00,62,32,30,0,0,0
2025-09-19 07:15,120,46,74,0,0,0
2025-09-19 07:30,152,52,100,0,0,0
2025-09-19 07:45,163,100,63,0,0,0
2025-09-19 08:00,123,59,64,0,0,0
2025-09-19 08:15,112,64,48,0,0,0
2025-09-19 08:30,123,70,53,0,0,0
2025-09-19 08:45,118,65,53,0,0,0
2025-09-19 09:00,110,53,57,0,0,0
2025-09-19 09:15,92,39,53,0,0,0
2025-09-19 09:30,79,42,37,0,0,0
2025-09-19 09:45,89,42,47,0,0,0
2025-09-19 10:00,89,32,57,0,0,0
2025-09-19 10:15,83,41,42,0,0,0
2025-09-19 10:30,94,34,60,0,0,0
2025-09-19 10:45,105,40,65,0,0,0
2025-09-19 11:00,79,37,42,0,0,0
2025-09-19 11:15,81,38,43,0,0,0
2025-09-19 11:30,118,52,66,0,0,0
2025-09-19 11:45,97,41,56,0,0,0
2025-09-19 12:00,115,49,66,0,0,0
2025-09-19 12:15,143,60,83,0,0,0
2025-09-19 12:30,114,58,56,0,0,0
2025-09-19 12:45,115,51,64,0,0,0
2025-09-19 13:00,163,89,74,0,0,0
2025-09-19 13:15,166,83,83,0,0,0
2025-09-19 13:30,127,57,70,0,0,0
2025-09-19 13:45,138,52,86,0,0,0
2025-09-19 14:00,159,64,95,0,0,0
2025-09-19 14:15,149,58,91,0,0,0
2025-09-19 14:30,133,68,65,0,0,0
2025-09-19 14:45,152,64,88,0,0,0
2025-09-19 15:00,157,71,86,0,0,0
2025-09-19 15:15,147,63,84,0,0,0
2025-09-19 15:30,149,73,76,0,0,0
2025-09-19 15:45,141,79,62,0,0,0
2025-09-19 16:00,152,72,80,0,0,0
2025-09-19 16:15,174,102,72,0,0,0
2025-09-19 16:30,169,78,91,0,0,0
2025-09-19 16:45,195,97,98,0,0,0
2025-09-19 17:00,139,59,80,0,0,0
2025-09-19 17:15,158,84,74,0,0,0
2025-09-19 17:30,138,61,77,0,0,0
2025-09-19 17:45,167,96,71,0,0,0
2025-09-19 18:00,148,70,78,0,0,0
2025-09-19 18:15,149,79,70,0,0,0
2025-09-19 18:30,139,84,55,0,0,0
2025-09-19 18:45,164,84,80,0,0,0
2025-09-19 19:00,155,97,58,0,0,0
2025-09-19 19:15,138,69,69,0,0,0
2025-09-19 19:30,153,100,53,0,0,0
2025-09-19 19:45,142,88,54,0,0,0
2025-09-19 20:00,125,82,43,0,0,0
2025-09-19 20:15,117,79,38,0,0,0
2025-09-19 20:30,103,66,37,0,0,0
2025-09-19 20:45,110,61,49,0,0,0
2025-09-19 21:00,120,75,45,0,0,0
2025-09-19 21:15,84,35,49,0,0,0
2025-09-19 21:30,77,29,48,0,0,0
2025-09-19 21:45,91,29,62,0,0,0
2025-09-19 22:00,80,38,42,0,0,0
2025-09-19 22:15,102,32,70,0,0,0
2025-09-19 22:30,85,32,53,0,0,0
2025-09-19 22:45,68,19,49,0,0,0
2025-09-19 23:00,94,40,54,0,0,0
2025-09-19 23:15,83,26,57,0,0,0
2025-09-19 23:30,85,37,48,0,0,0
2025-09-19 23:45,75,16,59,0,0,0
2025-09-20 00:00,74,17,57,0,0,0
2025-09-20 00:15,66,14,52,0,0,0
2025-09-20 00:30,77,19,58,0,0,0
2025-09-20 00:45,53,13,40,0,0,0
2025-09-20 01:00,47,14,33,0,0,0
2025-09-20 01:15,48,19,29,0,0,0
2025-09-20 01:30,34,11,23,0,0,0
2025-09-20 01:45,39,7,32,0,0,0
2025-09-20 02:00,41,5,36,0,0,0
2025-09-20 02:15,39,13,26,0,0,0
2025-09-20 02:30,20,4,16,0,0,0
2025-09-20 02:45,20,2,18,0,0,0
2025-09-20 03:00,23,6,17,0,0,0
2025-09-20 03:15,26,5,21,0,0,0
2025-09-20 03:30,7,1,6,0,0,0
2025-09-20 03:45,6,0,6,0,0,0
2025-09-20 04:00,22,3,19,0,0,0
2025-09-20 04:15,12,5,7,0,0,0
2025-09-20 04:30,20,2,18,0,0,0
2025-09-20 04:45,15,0,15,0,0,0
2025-09-20 05:00,1,0,1,0,0,0
2025-09-20 05:15,18,1,17,0,0,0
2025-09-20 05:30,20,6,14,0,0,0
2025-09-20 05:45,15,4,11,0,0,0
2025-09-20 06:00,25,7,18,0,0,0
2025-09-20 06:15,11,2,9,0,0,0
2025-09-20 06:30,8,0,8,0,0,0
2025-09-20 06:45,23,10,13,0,0,0
2025-09-20 07:00,14,4,10,0,0,0
2025-09-20 07:15,19,4,15,0,0,0
2025-09-20 07:30,13,4,9,0,0,0
2025-09-20 07:45,34,8,26,0,0,0
2025-09-20 08:00,34,16,18,0,0,0
2025-09-20 08:15,27,8,19,0,0,0
2025-09-20 08:30,35,10,25,0,0,0
2025-09-20 08:45,47,25,22,0,0,0
2025-09-20 09:00,33,13,20,0,0,0
2025-09-20 09:15,53,21,32,0,0,0
2025-09-20 09:30,66,27,39,0,0,0
2025-09-20 09:45,78,31,47,0,0,0
2025-09-20 10:00,70,20,50,0,0,0
2025-09-20 10:15,85,35,50,0,0,0
2025-09-20 10:30,89,42,47,0,0,0
2025-09-20 10:45,121,29,92,0,0,0
2025-09-20 11:00,82,34,48,0,0,0
2025-09-20 11:15,126,38,88,0,0,0
2025-09-20 11:30,107,44,63,0,0,0
2025-09-20 11:45,111,39,72,0,0,0
2025-09-20 12:00,115,47,68,0,0,0
2025-09-20 12:15,127,60,67,0,0,0
2025-09-20 12:30,113,69,44,0,0,0
2025-09-20 12:45,115,42,73,0,0,0
2025-09-20 13:00,148,72,76,0,0,0
2025-09-20 13:15,156,88,68,0,0,0
2025-09-20 13:30,146,79,67,0,0,0
2025-09-20 13:45,124,65,59,0,0,0
2025-09-20 14:00,162,94,68,0,0,0
2025-09-20 14:15,162,97,65,0,0,0
2025-09-20 14:30,156,94,62,0,0,0
2025-09-20 14:45,139,74,65,0,0,0
2025-09-20 15:00,153,90,63,0,0,0
2025-09-20 15:15,161,106,55,0,0,0
2025-09-20 15:30,126,65,61,0,0,0
2025-09-20 15:45,139,84,55,0,0,0
2025-09-20 16:00,142,82,60,0,0,0
2025-09-20 16:15,169,106,63,0,0,0
2025-09-20 16:30,158,100,58,0,0,0
2025-09-20 16:45,149,74,75,0,0,0
2025-09-20 17:00,150,79,71,0,0,0
2025-09-20 17:15,165,98,67,0,0,0
2025-09-20 17:30,136,87,49,0,0,0
2025-09-20 17:45,146,87,59,0,0,0
2025-09-20 18:00,141,81,60,0,0,0
2025-09-20 18:15,153,97,56,0,0,0
2025-09-20 18:30,121,59,62,0,0,0
2025-09-20 18:45,125,75,50,0,0,0
2025-09-20 19:00,168,104,64,0,0,0
2025-09-20 19:15,132,75,57,0,0,0
2025-09-20 19:30,136,67,69,0,0,0
2025-09-20 19:45,130,74,56,0,0,0
2025-09-20 20:00,119,68,51,0,0,0
2025-09-20 20:15,91,37,54,0,0,0
2025-09-20 20:30,101,54,47,0,0,0
2025-09-20 20:45,84,40,44,0,0,0
2025-09-20 21:00,81,39,42,0,0,0
2025-09-20 21:15,97,50,47,0,0,0
2025-09-20 21:30,80,23,57,0,0,0
2025-09-20 21:45,92,29,63,0,0,0
2025-09-20 22:00,76,35,41,0,0,0
2025-09-20 22:15,75,21,54,0,0,0
2025-09-20 22:30,90,33,57,0,0,0
2025-09-20 22:45,73,12,61,0,0,0
2025-09-20 23:00,83,22,61,0,0,0
2025-09-20 23:15,54,14,40,0,0,0
2025-09-20 23:30,67,18,49,0,0,0
2025-09-20 23:45,64,30,34,0,0,0
2025-09-21 00:00,70,25,45,0,0,0
2025-09-21 00:15,74,22,52,0,0,0
2025-09-21 00:30,62,21,41,0,0,0
2025-09-21 00:45,54,7,47,0,0,0
2025-09-21 01:00,54,16,38,0,0,0
2025-09-21 01:15,53,10,43,0,0,0
2025-09-21 01:30,28,8,20,0,0,0
2025-09-21 01:45,42,10,32,0,0,0
2025-09-21 02:00,46,10,36,0,0,0
2025-09-21 02:15,21,6,15,0,0,0
2025-09-21 02:30,32,15,17,0,0,0
2025-09-21 02:45,26,4,22,0,0,0
2025-09-21 03:00,19,9,10,0,0,0
2025-09-21 03:15,22,6,16,0,0,0
2025-09-21 03:30,18,1,17,0,0,0
2025-09-21 03:45,25,1,24,0,0,0
2025-09-21 04:00,8,2,6,0,0,0
2025-09-21 04:15,16,3,13,0,0,0
2025-09-21 04:30,17,0,17,0,0,0
2025-09-21 04:45,9,0,9,0,0,0
2025-09-21 05:00,6,0,6,0,0,0
2025-09-21 05:15,8,4,4,0,0,0
2025-09-21 05:30,7,1,6,0,0,0
2025-09-21 05:45,11,2,9,0,0,0
2025-09-21 06:00,15,3,12,0,0,0
2025-09-21 06:15,2,0,2,0,0,0
2025-09-21 06:30,8,3,5,0,0,0
2025-09-21 06:45,10,4,6,0,0,0
2025-09-21 07:00,7,2,5,0,0,0
2025-09-21 07:15,9,3,6,0,0,0
2025-09-21 07:30,19,4,15,0,0,0
2025-09-21 07:45,29,1,28,0,0,0
2025-09-21 08:00,64,10,54,0,0,0
2025-09-21 08:15,69,5,64,0,0,0
2025-09-21 08:30,65,3,62,0,0,0
2025-09-21 08:45,47,12,35,0,0,0
2025-09-21 09:00,20,2,18,0,0,0
2025-09-21 09:15,49,26,23,0,0,0
2025-09-21 09:30,52,21,31,0,0,0
2025-09-21 09:45,71,24,47,0,0,0
2025-09-21 10:00,53,17,36,0,0,0
2025-09-21 10:15,51,26,25,0,0,0
2025-09-21 10:30,58,24,34,0,0,0
2025-09-21 10:45,63,31,32,0,0,0
2025-09-21 11:00,68,30,38,0,0,0
2025-09-21 11:15,51,18,33,0,0,0
2025-09-21 11:30,54,19,35,0,0,0
2025-09-21 11:45,71,28,43,0,0,0
2025-09-21 12:00,56,29,27,0,0,0
2025-09-21 12:15,84,31,53,0,0,0
2025-09-21 12:30,61,29,32,0,0,0
2025-09-21 12:45,63,31,32,0,0,0
2025-09-21 13:00,78,39,39,0,0,0
2025-09-21 13:15,65,32,33,0,0,0
2025-09-21 13:30,78,45,33,0,0,0
2025-09-21 13:45,88,52,36,0,0,0
2025-09-21 14:00,89,53,36,0,0,0
2025-09-21 14:15,95,57,38,0,0,0
2025-09-21 14:30,107,62,45,0,0,0
2025-09-21 14:45,116,69,47,0,0,0
2025-09-21 15:00,88,41,47,0,0,0
2025-09-21 15:15,81,55,26,0,0,0
2025-09-21 15:30,74,33,41,0,0,0
2025-09-21 15:45,99,47,52,0,0,0
2025-09-21 16:00,70,28,42,0,0,0
2025-09-21 16:15,66,27,39,0,0,0
2025-09-21 16:30,68,38,30,0,0,0
2025-09-21 16:45,76,33,43,0,0,0
2025-09-21 17:00,86,26,60,0,0,0
2025-09-21 17:15,70,23,47,0,0,0
2025-09-21 17:30,67,33,34,0,0,0
2025-09-21 17:45,104,42,62,0,0,0
2025-09-21 18:00,71,26,45,0,0,0
2025-09-21 18:15,74,34,40,0,0,0
2025-09-21 18:30,64,26,38,0,0,0
2025-09-21 18:45,74,32,42,0,0,0
2025-09-21 19:00,42,10,32,0,0,0
2025-09-21 19:15,75,38,37,0,0,0
2025-09-21 19:30,68,21,47,0,0,0
2025-09-21 19:45,72,26,46,0,0,0
2025-09-21 20:00,53,19,34,0,0,0
2025-09-21 20:15,58,28,30,0,0,0
2025-09-21 20:30,49,13,36,0,0,0
2025-09-21 20:45,57,19,38,0,0,0
2025-09-21 21:00,28,7,21,0,0,0
2025-09-21 21:15,27,17,10,0,0,0
2025-09-21 21:30,29,10,19,0,0,0
2025-09-21 21:45,28,7,21,0,0,0
2025-09-21 22:00,23,2,21,0,0,0
2025-09-21 22:15,26,7,19,0,0,0
2025-09-21 22:30,29,8,21,0,0,0
2025-09-21 22:45,16,6,10,0,0,0
2025-09-21 23:00,18,3,15,0,0,0
2025-09-21 23:15,15,7,8,0,0,0
2025-09-21 23:30,8,5,3,0,0,0
2025-09-21 23:45,5,1,4,0,0,0
2025-09-22 00:00,7,2,5,0,0,0
2025-09-22 00:15,8,2,6,0,0,0
2025-09-22 00:30,2,0,2,0,0,0
2025-09-22 00:45,6,3,3,0,0,0
2025-09-22 01:00,4,1,3,0,0,0
2025-09-22 01:15,2,0,2,0,0,0
2025-09-22 01:30,1,1,0,0,0,0
2025-09-22 01:45,2,1,1,0,0,0
2025-09-22 02:00,3,0,3,0,0,0
2025-09-22 02:15,0,0,0,0,0,0
2025-09-22 02:30,0,0,0,0,0,0
2025-09-22 02:45,0,0,0,0,0,0
2025-09-22 03:00,0,0,0,0,0,0
2025-09-22 03:15,0,0,0,0,0,0
2025-09-22 03:30,0,0,0,0,0,0
2025-09-22 03:45,2,0,2,0,0,0
2025-09-22 04:00,2,0,2,0,0,0
2025-09-22 04:15,0,0,0,0,0,0
2025-09-22 04:30,7,2,5,0,0,0
2025-09-22 04:45,8,3,5,0,0,0
2025-09-22 05:00,4,2,2,0,0,0
2025-09-22 05:15,16,9,7,0,0,0
2025-09-22 05:30,17,6,11,0,0,0
2025-09-22 05:45,25,14,11,0,0,0
2025-09-22 06:00,19,8,11,0,0,0
2025-09-22 06:15,38,20,18,0,0,0
2025-09-22 06:30,45,23,22,0,0,0
2025-09-22 06:45,66,39,27,0,0,0
2025-09-22 07:00,64,33,31,0,0,0
2025-09-22 07:15,106,48,58,0,0,0
2025-09-22 07:30,160,74,86,0,0,0
2025-09-22 07:45,178,100,78,0,0,0
2025-09-22 08:00,164,92,72,0,0,0
2025-09-22 08:15,144,75,69,0,0,0
2025-09-22 08:30,142,72,70,0,0,0
2025-09-22 08:45,142,64,78,0,0,0
2025-09-22 09:00,90,41,49,0,0,0
2025-09-22 09:15,80,38,42,0,0,0
2025-09-22 09:30,72,35,37,0,0,0
2025-09-22 09:45,80,29,51,0,0,0
2025-09-22 10:00,81,43,38,0,0,0
2025-09-22 10:15,78,37,41,0,0,0
2025-09-22 10:30,78,33,45,0,0,0
2025-09-22 10:45,100,35,65,0,0,0
2025-09-22 11:00,86,38,48,0,0,0
2025-09-22 11:15,95,38,57,0,0,0
2025-09-22 11:30,89,41,48,0,0,0
2025-09-22 11:45,99,46,53,0,0,0
2025-09-22 12:00,98,49,49,0,0,0
2025-09-22 12:15,99,42,57,0,0,0
2025-09-22 12:30,114,53,61,0,0,0
2025-09-22 12:45,101,64,37,0,0,0
2025-09-22 13:00,109,51,58,0,0,0
2025-09-22 13:15,117,62,55,0,0,0
2025-09-22 13:30,91,41,50,0,0,0
2025-09-22 13:45,109,46,63,0,0,0
2025-09-22 14:00,113,68,45,0,0,0
2025-09-22 14:15,110,63,47,0,0,0
2025-09-22 14:30,136,72,64,0,0,0
2025-09-22 14:45,119,53,66,0,0,0
2025-09-22 15:00,136,67,69,0,0,0
2025-09-22 15:15,141,71,70,0,0,0
2025-09-22 15:30,126,60,66,0,0,0
2025-09-22 15:45,145,65,80,0,0,0
2025-09-22 16:00,163,66,97,0,0,0
2025-09-22 16:15,163,72,91,0,0,0
2025-09-22 16:30,153,65,88,0,0,0
2025-09-22 16:45,198,83,115,0,0,0
2025-09-22 17:00,176,73,103,0,0,0
2025-09-22 17:15,171,84,87,0,0,0
2025-09-22 17:30,135,76,59,0,0,0
2025-09-22 17:45,173,80,93,0,0,0
2025-09-22 18:00,179,97,82,0,0,0
2025-09-22 18:15,149,72,77,0,0,0
2025-09-22 18:30,145,81,64,0,0,0
2025-09-22 18:45,118,60,58,0,0,0
2025-09-22 19:00,109,51,58,0,0,0
2025-09-22 19:15,117,69,48,0,0,0
2025-09-22 19:30,110,54,56,0,0,0
2025-09-22 19:45,119,57,62,0,0,0
2025-09-22 20:00,78,34,44,0,0,0
2025-09-22 20:15,78,36,42,0,0,0
2025-09-22 20:30,64,25,39,0,0,0
2025-09-22 20:45,44,29,15,0,0,0
2025-09-22 21:00,48,18,30,0,0,0
2025-09-22 21:15,41,21,20,0,0,0
2025-09-22 21:30,36,23,13,0,0,0
2025-09-22 21:45,42,12,30,0,0,0
2025-09-22 22:00,40,19,21,0,0,0
2025-09-22 22:15,44,11,33,0,0,0
2025-09-22 22:30,48,20,28,0,0,0
2025-09-22 22:45,36,12,24,0,0,0
2025-09-22 23:00,34,7,27,0,0,0
2025-09-22 23:15,15,3,12,0,0,0
2025-09-22 23:30,12,4,8,0,0,0
2025-09-22 23:45,11,3,8,0,0,0
2025-09-23 00:00,9,0,9,0,0,0
2025-09-23 00:15,9,1,8,0,0,0
2025-09-23 00:30,2,1,1,0,0,0
2025-09-23 00:45,16,5,11,0,0,0
2025-09-23 01:00,2,0,2,0,0,0
2025-09-23 01:15,4,0,4,0,0,0
2025-09-23 01:30,2,1,1,0,0,0
2025-09-23 01:45,3,2,1,0,0,0
2025-09-23 02:00,0,0,0,0,0,0
2025-09-23 02:15,1,0,1,0,0,0
2025-09-23 02:30,3,0,3,0,0,0
2025-09-23 02:45,0,0,0,0,0,0
2025-09-23 03:00,2,2,0,0,0,0
2025-09-23 03:15,1,1,0,0,0,0
2025-09-23 03:30,0,0,0,0,0,0
2025-09-23 03:45,3,2,1,0,0,0
2025-09-23 04:00,2,1,1,0,0,0
2025-09-23 04:15,0,0,0,0,0,0
2025-09-23 04:30,3,2,1,0,0,0
2025-09-23 04:45,10,6,4,0,0,0
2025-09-23 05:00,8,0,8,0,0,0
2025-09-23 05:15,15,5,10,0,0,0
2025-09-23 05:30,29,13,16,0,0,0
2025-09-23 05:45,16,11,5,0,0,0
2025-09-23 06:00,30,16,14,0,0,0
2025-09-23 06:15,37,19,18,0,0,0
2025-09-23 06:30,59,32,27,0,0,0
2025-09-23 06:45,66,43,23,0,0,0
2025-09-23 07:00,73,40,33,0,0,0
2025-09-23 07:15,121,61,60,0,0,0
2025-09-23 07:30,175,67,108,0,0,0
2025-09-23 07:45,184,116,68,0,0,0
2025-09-23 08:00,163,88,75,0,0,0
2025-09-23 08:15,162,96,66,0,0,0
2025-09-23 08:30,145,68,77,0,0,0
2025-09-23 08:45,169,84,85,0,0,0
2025-09-23 09:00,95,38,57,0,0,0
2025-09-23 09:15,83,42,41,0,0,0
2025-09-23 09:30,85,45,40,0,0,0
2025-09-23 09:45,106,37,69,0,0,0
2025-09-23 10:00,83,29,54,0,0,0
2025-09-23 10:15,78,38,40,0,0,0
2025-09-23 10:30,65,21,44,0,0,0
2025-09-23 10:45,89,34,55,0,0,0
2025-09-23 11:00,90,35,55,0,0,0
2025-09-23 11:15,89,50,39,0,0,0
2025-09-23 11:30,99,35,64,0,0,0
2025-09-23 11:45,98,42,56,0,0,0
2025-09-23 12:00,100,46,54,0,0,0
2025-09-23 12:15,105,46,59,0,0,0
2025-09-23 12:30,128,77,51,0,0,0
2025-09-23 12:45,117,42,75,0,0,0
2025-09-23 13:00,118,60,58,0,0,0
2025-09-23 13:15,129,57,72,0,0,0
2025-09-23 13:30,120,51,69,0,0,0
2025-09-23 13:45,115,71,44,0,0,0
2025-09-23 14:00,125,74,51,0,0,0
2025-09-23 14:15,139,73,66,0,0,0
2025-09-23 14:30,124,62,62,0,0,0
2025-09-23 14:45,129,61,68,0,0,0
2025-09-23 15:00,133,58,75,0,0,0
2025-09-23 15:15,157,78,79,0,0,0
2025-09-23 15:30,133,66,67,0,0,0
2025-09-23 15:45,148,68,80,0,0,0
2025-09-23 16:00,158,80,78,0,0,0
2025-09-23 16:15,156,76,80,0,0,0
2025-09-23 16:30,197,83,114,0,0,0
2025-09-23 16:45,174,68,106,0,0,0
2025-09-23 17:00,187,78,109,0,0,0
2025-09-23 17:15,173,80,93,0,0,0
2025-09-23 17:30,194,91,103,0,0,0
2025-09-23 17:45,181,87,94,0,0,0
2025-09-23 18:00,160,88,72,0,0,0
2025-09-23 18:15,127,62,65,0,0,0
2025-09-23 18:30,109,50,59,0,0,0
2025-09-23 18:45,133,78,55,0,0,0
2025-09-23 19:00,117,68,49,0,0,0
2025-09-23 19:15,153,78,75,0,0,0
2025-09-23 19:30,145,83,62,0,0,0
2025-09-23 19:45,102,56,46,0,0,0
2025-09-23 20:00,94,36,58,0,0,0
2025-09-23 20:15,78,34,44,0,0,0
2025-09-23 20:30,69,30,39,0,0,0
2025-09-23 20:45,69,37,32,0,0,0
2025-09-23 21:00,50,19,31,0,0,0
2025-09-23 21:15,48,19,29,0,0,0
2025-09-23 21:30,50,23,27,0,0,0
2025-09-23 21:45,40,16,24,0,0,0
2025-09-23 22:00,74,33,41,0,0,0
2025-09-23 22:15,56,17,39,0,0,0
2025-09-23 22:30,45,11,34,0,0,0
2025-09-23 22:45,37,10,27,0,0,0
2025-09-23 23:00,32,7,25,0,0,0
2025-09-23 23:15,18,7,11,0,0,0
2025-09-23 23:30,13,3,10,0,0,0
2025-09-23 23:45,20,6,14,0,0,0
2025-09-24 00:00,23,8,15,0,0,0
2025-09-24 00:15,4,0,4,0,0,0
2025-09-24 00:30,12,4,8,0,0,0
2025-09-24 00:45,19,1,18,0,0,0
2025-09-24 01:00,7,2,5,0,0,0
2025-09-24 01:15,1,0,1,0,0,0
2025-09-24 01:30,6,0,6,0,0,0
2025-09-24 01:45,3,0,3,0,0,0
2025-09-24 02:00,0,0,0,0,0,0
2025-09-24 02:15,2,0,2,0,0,0
2025-09-24 02:30,2,0,2,0,0,0
2025-09-24 02:45,1,0,1,0,0,0
2025-09-24 03:00,0,0,0,0,0,0
2025-09-24 03:15,1,1,0,0,0,0
2025-09-24 03:30,0,0,0,0,0,0
2025-09-24 03:45,1,1,0,0,0,0
2025-09-24 04:00,4,1,3,0,0,0
2025-09-24 04:15,4,1,3,0,0,0
2025-09-24 04:30,4,2,2,0,0,0
2025-09-24 04:45,5,3,2,0,0,0
2025-09-24 05:00,3,0,3,0,0,0
2025-09-24 05:15,12,6,6,0,0,0
2025-09-24 05:30,19,3,16,0,0,0
2025-09-24 05:45,25,13,12,0,0,0
2025-09-24 06:00,28,18,10,0,0,0
2025-09-24 06:15,34,14,20,0,0,0
2025-09-24 06:30,59,27,32,0,0,0
2025-09-24 06:45,85,49,36,0,0,0
2025-09-24 07:00,75,41,34,0,0,0
2025-09-24 07:15,124,53,71,0,0,0
2025-09-24 07:30,180,70,110,0,0,0
2025-09-24 07:45,213,124,89,0,0,0
2025-09-24 08:00,168,93,75,0,0,0
2025-09-24 08:15,152,91,61,0,0,0
2025-09-24 08:30,130,75,55,0,0,0
2025-09-24 08:45,154,86,68,0,0,0
2025-09-24 09:00,115,47,68,0,0,0
2025-09-24 09:15,98,42,56,0,0,0
2025-09-24 09:30,92,39,53,0,0,0
2025-09-24 09:45,108,39,69,0,0,0
2025-09-24 10:00,77,37,40,0,0,0
2025-09-24 10:15,77,30,47,0,0,0
2025-09-24 10:30,90,29,61,0,0,0
2025-09-24 10:45,121,53,68,0,0,0
2025-09-24 11:00,95,47,48,0,0,0
2025-09-24 11:15,88,43,45,0,0,0
2025-09-24 11:30,108,50,58,0,0,0
2025-09-24 11:45,113,48,65,0,0,0
2025-09-24 12:00,114,49,65,0,0,0
2025-09-24 12:15,119,52,67,0,0,0
2025-09-24 12:30,149,79,70,0,0,0
2025-09-24 12:45,136,63,73,0,0,0
2025-09-24 13:00,137,74,63,0,0,0
2025-09-24 13:15,128,61,67,0,0,0
2025-09-24 13:30,106,61,45,0,0,0
2025-09-24 13:45,143,63,80,0,0,0
2025-09-24 14:00,132,69,63,0,0,0
2025-09-24 14:15,106,51,55,0,0,0
2025-09-24 14:30,135,75,60,0,0,0
2025-09-24 14:45,144,53,91,0,0,0
2025-09-24 15:00,125,62,63,0,0,0
2025-09-24 15:15,136,62,74,0,0,0
2025-09-24 15:30,145,61,84,0,0,0
2025-09-24 15:45,134,85,49,0,0,0
2025-09-24 16:00,152,57,95,0,0,0
2025-09-24 16:15,172,89,83,0,0,0
2025-09-24 16:30,180,66,114,0,0,0
2025-09-24 16:45,176,92,84,0,0,0
2025-09-24 17:00,177,68,109,0,0,0
2025-09-24 17:15,169,75,94,0,0,0
2025-09-24 17:30,198,96,102,0,0,0
2025-09-24 17:45,173,97,76,0,0,0
2025-09-24 18:00,188,99,89,0,0,0
2025-09-24 18:15,149,78,71,0,0,0
2025-09-24 18:30,159,73,86,0,0,0
2025-09-24 18:45,114,61,53,0,0,0
2025-09-24 19:00,120,66,54,0,0,0
2025-09-24 19:15,123,72,51,0,0,0
2025-09-24 19:30,101,61,40,0,0,0
2025-09-24 19:45,105,65,40,0,0,0
2025-09-24 20:00,111,50,61,0,0,0
2025-09-24 20:15,90,50,40,0,0,0
2025-09-24 20:30,60,20,40,0,0,0
2025-09-24 20:45,71,35,36,0,0,0
2025-09-24 21:00,70,35,35,0,0,0
2025-09-24 21:15,67,32,35,0,0,0
2025-09-24 21:30,72,36,36,0,0,0
2025-09-24 21:45,51,25,26,0,0,0
2025-09-24 22:00,73,38,35,0,0,0
2025-09-24 22:15,54,20,34,0,0,0
2025-09-24 22:30,72,14,58,0,0,0
2025-09-24 22:45,55,11,44,0,0,0
2025-09-24 23:00,41,17,24,0,0,0
2025-09-24 23:15,38,17,21,0,0,0
2025-09-24 23:30,25,5,20,0,0,0
2025-09-24 23:45,38,17,21,0,0,0
2025-09-25 00:00,20,6,14,0,0,0
2025-09-25 00:15,13,5,8,0,0,0
2025-09-25 00:30,19,2,17,0,0,0
2025-09-25 00:45,22,4,18,0,0,0
2025-09-25 01:00,7,4,3,0,0,0
2025-09-25 01:15,7,2,5,0,0,0
2025-09-25 01:30,16,5,11,0,0,0
2025-09-25 01:45,6,3,3,0,0,0
2025-09-25 02:00,6,3,3,0,0,0
2025-09-25 02:15,5,0,5,0,0,0
2025-09-25 02:30,10,3,7,0,0,0
2025-09-25 02:45,6,2,4,0,0,0
2025-09-25 03:00,1,0,1,0,0,0
2025-09-25 03:15,3,1,2,0,0,0
2025-09-25 03:30,5,1,4,0,0,0
2025-09-25 03:45,4,1,3,0,0,0
2025-09-25 04:00,2,2,0,0,0,0
2025-09-25 04:15,1,1,0,0,0,0
2025-09-25 04:30,7,5,2,0,0,0
2025-09-25 04:45,9,5,4,0,0,0
2025-09-25 05:00,4,1,3,0,0,0
2025-09-25 05:15,10,3,7,0,0,0
2025-09-25 05:30,12,8,4,0,0,0
2025-09-25 05:45,20,12,8,0,0,0
2025-09-25 06:00,23,10,13,0,0,0
2025-09-25 06:15,44,17,27,0,0,0
2025-09-25 06:30,51,19,32,0,0,0
2025-09-25 06:45,81,44,37,0,0,0
2025-09-25 07:00,77,37,40,0,0,0
2025-09-25 07:15,82,36,46,0,0,0
2025-09-25 07:30,167,77,90,0,0,0
2025-09-25 07:45,162,84,78,0,0,0
2025-09-25 08:00,163,88,75,0,0,0
2025-09-25 08:15,176,96,80,0,0,0
2025-09-25 08:30,139,67,72,0,0,0
2025-09-25 08:45,151,86,65,0,0,0
2025-09-25 09:00,102,48,54,0,0,0
2025-09-25 09:15,81,36,45,0,0,0
2025-09-25 09:30,105,49,56,0,0,0
2025-09-25 09:45,103,39,64,0,0,0
2025-09-25 10:00,76,32,44,0,0,0
2025-09-25 10:15,74,24,50,0,0,0
2025-09-25 10:30,74,37,37,0,0,0
2025-09-25 10:45,92,38,54,0,0,0
2025-09-25 11:00,68,26,42,0,0,0
2025-09-25 11:15,79,31,48,0,0,0
2025-09-25 11:30,68,20,48,0,0,0
2025-09-25 11:45,92,38,54,0,0,0
2025-09-25 12:00,118,48,70,0,0,0
2025-09-25 12:15,127,57,70,0,0,0
2025-09-25 12:30,130,60,70,0,0,0
2025-09-25 12:45,137,70,67,0,0,0
2025-09-25 13:00,138,66,72,0,0,0
2025-09-25 13:15,98,49,49,0,0,0
2025-09-25 13:30,116,50,66,0,0,0
2025-09-25 13:45,143,75,68,0,0,0
2025-09-25 14:00,109,72,37,0,0,0
2025-09-25 14:15,140,79,61,0,0,0
2025-09-25 14:30,106,47,59,0,0,0
2025-09-25 14:45,137,66,71,0,0,0
2025-09-25 15:00,137,74,63,0,0,0
2025-09-25 15:15,138,52,86,0,0,0
2025-09-25 15:30,148,78,70,0,0,0
2025-09-25 15:45,125,45,80,0,0,0
2025-09-25 16:00,150,69,81,0,0,0
2025-09-25 16:15,160,77,83,0,0,0
2025-09-25 16:30,182,75,107,0,0,0
2025-09-25 16:45,170,63,107,0,0,0
2025-09-25 17:00,171,86,85,0,0,0
2025-09-25 17:15,177,69,108,0,0,0
2025-09-25 17:30,181,79,102,0,0,0
2025-09-25 17:45,166,73,93,0,0,0
2025-09-25 18:00,148,70,78,0,0,0
2025-09-25 18:15,108,62,46,0,0,0
2025-09-25 18:30,120,59,61,0,0,0
2025-09-25 18:45,115,60,55,0,0,0
2025-09-25 19:00,105,56,49,0,0,0
2025-09-25 19:15,106,51,55,0,0,0
2025-09-25 19:30,85,49,36,0,0,0
2025-09-25 19:45,97,40,57,0,0,0
2025-09-25 20:00,82,34,48,0,0,0
2025-09-25 20:15,89,44,45,0,0,0
2025-09-25 20:30,75,37,38,0,0,0
2025-09-25 20:45,62,25,37,0,0,0
2025-09-25 21:00,70,37,33,0,0,0
2025-09-25 21:15,61,30,31,0,0,0
2025-09-25 21:30,47,19,28,0,0,0
2025-09-25 21:45,49,17,32,0,0,0
2025-09-25 22:00,45,25,20,0,0,0
2025-09-25 22:15,55,21,34,0,0,0
2025-09-25 22:30,47,9,38,0,0,0
2025-09-25 22:45,40,12,28,0,0,0
2025-09-25 23:00,34,18,16,0,0,0
2025-09-25 23:15,13,7,6,0,0,0
2025-09-25 23:30,22,11,11,0,0,0
2025-09-25 23:45,18,5,13,0,0,0
2025-09-26 00:00,12,2,10,0,0,0
2025-09-26 00:15,11,6,5,0,0,0
2025-09-26 00:30,20,5,15,0,0,0
2025-09-26 00:45,19,4,15,0,0,0
2025-09-26 01:00,7,1,6,0,0,0
2025-09-26 01:15,15,1,14,0,0,0
2025-09-26 01:30,2,2,0,0,0,0
2025-09-26 01:45,2,0,2,0,0,0
2025-09-26 02:00,4,0,4,0,0,0
2025-09-26 02:15,1,1,0,0,0,0
2025-09-26 02:30,0,0,0,0,0,0
2025-09-26 02:45,3,3,0,0,0,0
2025-09-26 03:00,1,1,0,0,0,0
2025-09-26 03:15,0,0,0,0,0,0
2025-09-26 03:30,0,0,0,0,0,0
2025-09-26 03:45,1,0,1,0,0,0
2025-09-26 04:00,7,3,4,0,0,0
2025-09-26 04:15,1,0,1,0,0,0
2025-09-26 04:30,4,2,2,0,0,0
2025-09-26 04:45,5,1,4,0,0,0
2025-09-26 05:00,2,2,0,0,0,0
2025-09-26 05:15,10,4,6,0,0,0
2025-09-26 05:30,15,7,8,0,0,0
2025-09-26 05:45,19,10,9,0,0,0
2025-09-26 06:00,27,9,18,0,0,0
2025-09-26 06:15,41,17,24,0,0,0
2025-09-26 06:30,47,26,21,0,0,0
2025-09-26 06:45,57,38,19,0,0,0
2025-09-26 07:00,72,29,43,0,0,0
2025-09-26 07:15,96,44,52,0,0,0
2025-09-26 07:30,141,55,86,0,0,0
2025-09-26 07:45,137,78,59,0,0,0
2025-09-26 08:00,132,71,61,0,0,0
2025-09-26 08:15,124,70,54,0,0,0
2025-09-26 08:30,119,55,64,0,0,0
2025-09-26 08:45,143,78,65,0,0,0
2025-09-26 09:00,83,40,43,0,0,0
2025-09-26 09:15,78,33,45,0,0,0
2025-09-26 09:30,86,41,45,0,0,0
2025-09-26 09:45,88,39,49,0,0,0
2025-09-26 10:00,78,38,40,0,0,0
2025-09-26 10:15,96,40,56,0,0,0
2025-09-26 10:30,101,47,54,0,0,0
2025-09-26 10:45,87,42,45,0,0,0
2025-09-26 11:00,109,49,60,0,0,0
2025-09-26 11:15,101,52,49,0,0,0
2025-09-26 11:30,101,51,50,0,0,0
2025-09-26 11:45,114,56,58,0,0,0
2025-09-26 12:00,119,49,70,0,0,0
2025-09-26 12:15,123,44,79,0,0,0
2025-09-26 12:30,167,88,79,0,0,0
2025-09-26 12:45,118,49,69,0,0,0
2025-09-26 13:00,134,55,79,0,0,0
2025-09-26 13:15,160,66,94,0,0,0
2025-09-26 13:30,143,65,78,0,0,0
2025-09-26 13:45,127,62,65,0,0,0
2025-09-26 14:00,160,81,79,0,0,0
2025-09-26 14:15,122,61,61,0,0,0
2025-09-26 14:30,138,74,64,0,0,0
2025-09-26 14:45,125,63,62,0,0,0
2025-09-26 15:00,113,52,61,0,0,0
2025-09-26 15:15,107,47,60,0,0,0
2025-09-26 15:30,130,66,64,0,0,0
2025-09-26 15:45,135,74,61,0,0,0
2025-09-26 16:00,108,50,58,0,0,0
2025-09-26 16:15,125,58,67,0,0,0
2025-09-26 16:30,155,55,100,0,0,0
2025-09-26 16:45,165,79,86,0,0,0
2025-09-26 17:00,118,55,63,0,0,0
2025-09-26 17:15,140,79,61,0,0,0
2025-09-26 17:30,124,72,52,0,0,0
2025-09-26 17:45,118,77,41,0,0,0
2025-09-26 18:00,130,73,57,0,0,0
2025-09-26 18:15,145,84,61,0,0,0
2025-09-26 18:30,120,61,59,0,0,0
2025-09-26 18:45,128,73,55,0,0,0
2025-09-26 19:00,110,58,52,0,0,0
2025-09-26 19:15,116,71,45,0,0,0
2025-09-26 19:30,101,64,37,0,0,0
2025-09-26 19:45,102,55,47,0,0,0
2025-09-26 20:00,85,47,38,0,0,0
2025-09-26 20:15,93,58,35,0,0,0
2025-09-26 20:30,76,32,44,0,0,0
2025-09-26 20:45,78,31,47,0,0,0
2025-09-26 21:00,62,25,37,0,0,0
2025-09-26 21:15,52,19,33,0,0,0
2025-09-26 21:30,63,26,37,0,0,0
2025-09-26 21:45,66,25,41,0,0,0
2025-09-26 22:00,59,20,39,0,0,0
2025-09-26 22:15,61,13,48,0,0,0
2025-09-26 22:30,59,19,40,0,0,0
2025-09-26 22:45,56,24,32,0,0,0
2025-09-26 23:00,46,10,36,0,0,0
2025-09-26 23:15,41,15,26,0,0,0
2025-09-26 23:30,53,14,39,0,0,0
2025-09-26 23:45,54,23,31,0,0,0
2025-09-27 00:00,56,13,43,0,0,0
2025-09-27 00:15,61,19,42,0,0,0
2025-09-27 00:30,40,22,18,0,0,0
2025-09-27 00:45,27,13,14,0,0,0
2025-09-27 01:00,40,15,25,0,0,0
2025-09-27 01:15,55,28,27,0,0,0
2025-09-27 01:30,39,14,25,0,0,0
2025-09-27 01:45,22,6,16,0,0,0
2025-09-27 02:00,19,4,15,0,0,0
2025-09-27 02:15,38,16,22,0,0,0
2025-09-27 02:30,29,11,18,0,0,0
2025-09-27 02:45,18,1,17,0,0,0
2025-09-27 03:00,10,2,8,0,0,0
2025-09-27 03:15,12,5,7,0,0,0
2025-09-27 03:30,14,6,8,0,0,0
2025-09-27 03:45,18,7,11,0,0,0
2025-09-27 04:00,11,1,10,0,0,0
2025-09-27 04:15,11,2,9,0,0,0
2025-09-27 04:30,4,1,3,0,0,0
2025-09-27 04:45,19,4,15,0,0,0
2025-09-27 05:00,3,0,3,0,0,0
2025-09-27 05:15,10,1,9,0,0,0
2025-09-27 05:30,15,6,9,0,0,0
2025-09-27 05:45,13,3,10,0,0,0
2025-09-27 06:00,12,4,8,0,0,0
2025-09-27 06:15,4,1,3,0,0,0
2025-09-27 06:30,11,6,5,0,0,0
2025-09-27 06:45,9,7,2,0,0,0
2025-09-27 07:00,13,7,6,0,0,0
2025-09-27 07:15,14,7,7,0,0,0
2025-09-27 07:30,19,7,12,0,0,0
2025-09-27 07:45,10,1,9,0,0,0
2025-09-27 08:00,29,9,20,0,0,0
2025-09-27 08:15,29,12,17,0,0,0
2025-09-27 08:30,33,14,19,0,0,0
2025-09-27 08:45,35,21,14,0,0,0
2025-09-27 09:00,29,10,19,0,0,0
2025-09-27 09:15,33,13,20,0,0,0
2025-09-27 09:30,54,24,30,0,0,0
2025-09-27 09:45,76,37,39,0,0,0
2025-09-27 10:00,70,32,38,0,0,0
2025-09-27 10:15,58,23,35,0,0,0
2025-09-27 10:30,69,23,46,0,0,0
2025-09-27 10:45,74,35,39,0,0,0
2025-09-27 11:00,95,46,49,0,0,0
2025-09-27 11:15,80,38,42,0,0,0
2025-09-27 11:30,87,32,55,0,0,0
2025-09-27 11:45,92,36,56,0,0,0
2025-09-27 12:00,80,33,47,0,0,0
2025-09-27 12:15,70,28,42,0,0,0
2025-09-27 12:30,111,47,64,0,0,0
2025-09-27 12:45,83,39,44,0,0,0
2025-09-27 13:00,78,43,35,0,0,0
2025-09-27 13:15,111,51,60,0,0,0
2025-09-27 13:30,100,40,60,0,0,0
2025-09-27 13:45,95,33,62,0,0,0
2025-09-27 14:00,115,63,52,0,0,0
2025-09-27 14:15,83,42,41,0,0,0
2025-09-27 14:30,123,63,60,0,0,0
2025-09-27 14:45,127,67,60,0,0,0
2025-09-27 15:00,92,40,52,0,0,0
2025-09-27 15:15,97,54,43,0,0,0
2025-09-27 15:30,85,36,49,0,0,0
2025-09-27 15:45,93,39,54,0,0,0
2025-09-27 16:00,116,62,54,0,0,0
2025-09-27 16:15,99,38,61,0,0,0
2025-09-27 16:30,91,36,55,0,0,0
2025-09-27 16:45,107,64,43,0,0,0
2025-09-27 17:00,110,56,54,0,0,0
2025-09-27 17:15,95,45,50,0,0,0
2025-09-27 17:30,130,68,62,0,0,0
2025-09-27 17:45,122,70,52,0,0,0
2025-09-27 18:00,89,43,46,0,0,0
2025-09-27 18:15,106,54,52,0,0,0
2025-09-27 18:30,134,75,59,0,0,0
2025-09-27 18:45,101,65,36,0,0,0
2025-09-27 19:00,124,71,53,0,0,0
2025-09-27 19:15,123,87,36,0,0,0
2025-09-27 19:30,115,72,43,0,0,0
2025-09-27 19:45,97,60,37,0,0,0
2025-09-27 20:00,100,54,46,0,0,0
2025-09-27 20:15,81,36,45,0,0,0
2025-09-27 20:30,64,46,18,0,0,0
2025-09-27 20:45,61,31,30,0,0,0
2025-09-27 21:00,61,30,31,0,0,0
2025-09-27 21:15,55,23,32,0,0,0
2025-09-27 21:30,49,18,31,0,0,0
2025-09-27 21:45,45,11,34,0,0,0
2025-09-27 22:00,57,23,34,0,0,0
2025-09-27 22:15,56,18,38,0,0,0
2025-09-27 22:30,38,13,25,0,0,0
2025-09-27 22:45,63,23,40,0,0,0
2025-09-27 23:00,69,15,54,0,0,0
2025-09-27 23:15,88,14,74,0,0,0
2025-09-27 23:30,73,21,52,0,0,0
2025-09-27 23:45,66,17,49,0,0,0
2025-09-28 00:00,42,11,31,0,0,0
2025-09-28 00:15,50,16,34,0,0,0
2025-09-28 00:30,62,12,50,0,0,0
2025-09-28 00:45,42,13,29,0,0,0
2025-09-28 01:00,47,13,34,0,0,0
2025-09-28 01:15,43,12,31,0,0,0
2025-09-28 01:30,44,20,24,0,0,0
2025-09-28 01:45,31,5,26,0,0,0
2025-09-28 02:00,20,8,12,0,0,0
2025-09-28 02:15,27,12,15,0,0,0
2025-09-28 02:30,26,7,19,0,0,0
2025-09-28 02:45,24,5,19,0,0,0
2025-09-28 03:00,26,3,23,0,0,0
2025-09-28 03:15,18,2,16,0,0,0
2025-09-28 03:30,10,2,8,0,0,0
2025-09-28 03:45,17,5,12,0,0,0
2025-09-28 04:00,11,1,10,0,0,0
2025-09-28 04:15,19,3,16,0,0,0
2025-09-28 04:30,10,1,9,0,0,0
2025-09-28 04:45,9,0,9,0,0,0
