Datetime,300039331 (Grevener Straße),353425091 (Grevener Straße Formel - Fahrräder Stadteinwärts),353425097 (Grevener Straße Formel- Fahrräder Stadtauswärts),300039331-status,353425091-status,353425097-status
2025-08-01 00:00,1,0,1,0,0,0
2025-08-01 00:15,3,2,1,0,0,0
2025-08-01 00:30,4,2,2,0,0,0
2025-08-01 00:45,4,1,3,0,0,0
2025-08-01 01:00,2,2,0,0,0,0
2025-08-01 01:15,2,0,2,0,0,0
2025-08-01 01:30,4,2,2,0,0,0
2025-08-01 01:45,3,2,1,0,0,0
2025-08-01 02:00,0,0,0,0,0,0
2025-08-01 02:15,3,1,2,0,0,0
2025-08-01 02:30,0,0,0,0,0,0
2025-08-01 02:45,2,0,2,0,0,0
2025-08-01 03:00,2,0,2,0,0,0
2025-08-01 03:15,4,2,2,0,0,0
2025-08-01 03:30,1,1,0,0,0,0
2025-08-01 03:45,1,1,0,0,0,0
2025-08-01 04:00,0,0,0,0,0,0
2025-08-01 04:15,2,1,1,0,0,0
2025-08-01 04:30,0,0,0,0,0,0
2025-08-01 04:45,1,1,0,0,0,0
2025-08-01 05:00,1,0,1,0,0,0
2025-08-01 05:15,5,4,1,0,0,0
2025-08-01 05:30,7,3,4,0,0,0
2025-08-01 05:45,2,1,1,0,0,0
2025-08-01 06:00,5,3,2,0,0,0
2025-08-01 06:15,2,1,1,0,0,0
2025-08-01 06:30,4,3,1,0,0,0
2025-08-01 06:45,2,0,2,0,0,0
2025-08-01 07:00,5,5,0,0,0,0
2025-08-01 07:15,12,10,2,0,0,0
2025-08-01 07:30,12,5,7,0,0,0
2025-08-01 07:45,22,17,5,0,0,0
2025-08-01 08:00,14,7,7,0,0,0
2025-08-01 08:15,17,9,8,0,0,0
2025-08-01 08:30,14,7,7,0,0,0
2025-08-01 08:45,16,9,7,0,0,0
2025-08-01 09:00,17,8,9,0,0,0
2025-08-01 09:15,18,9,9,0,0,0
2025-08-01 09:30,19,7,12,0,0,0
2025-08-01 09:45,10,4,6,0,0,0
2025-08-01 10:00,9,4,5,0,0,0
2025-08-01 10:15,19,9,10,0,0,0
2025-08-01 10:30,16,9,7,0,0,0
2025-08-01 10:45,20,8,12,0,0,0
2025-08-01 11:00,13,5,8,0,0,0
2025-08-01 11:15,18,8,10,0,0,0
2025-08-01 11:30,11,6,5,0,0,0
2025-08-01 11:45,26,9,17,0,0,0
2025-08-01 12:00,16,12,4,0,0,0
2025-08-01 12:15,14,8,6,0,0,0
2025-08-01 12:30,7,3,4,0,0,0
2025-08-01 12:45,17,4,13,0,0,0
2025-08-01 13:00,25,7,18,0,0,0
2025-08-01 13:15,22,11,11,0,0,0
2025-08-01 13:30,23,9,14,0,0,0
2025-08-01 13:45,23,7,16,0,0,0
2025-08-01 14:00,24,12,12,0,0,0
2025-08-01 14:15,24,15,9,0,0,0
2025-08-01 14:30,39,19,20,0,0,0
2025-08-01 14:45,17,3,14,0,0,0
2025-08-01 15:00,18,13,5,0,0,0
2025-08-01 15:15,17,8,9,0,0,0
2025-08-01 15:30,18,10,8,0,0,0
2025-08-01 15:45,23,9,14,0,0,0
2025-08-01 16:00,19,8,11,0,0,0
2025-08-01 16:15,19,7,12,0,0,0
2025-08-01 16:30,17,8,9,0,0,0
2025-08-01 16:45,14,3,11,0,0,0
2025-08-01 17:00,19,6,13,0,0,0
2025-08-01 17:15,11,6,5,0,0,0
2025-08-01 17:30,16,10,6,0,0,0
2025-08-01 17:45,15,8,7,0,0,0
2025-08-01 18:00,27,13,14,0,0,0
2025-08-01 18:15,28,13,15,0,0,0
2025-08-01 18:30,24,6,18,0,0,0
2025-08-01 18:45,18,9,9,0,0,0
2025-08-01 19:00,23,10,13,0,0,0
2025-08-01 19:15,10,5,5,0,0,0
2025-08-01 19:30,4,1,3,0,0,0
2025-08-01 19:45,13,9,4,0,0,0
2025-08-01 20:00,22,8,14,0,0,0
2025-08-01 20:15,8,5,3,0,0,0
2025-08-01 20:30,11,8,3,0,0,0
2025-08-01 20:45,6,3,3,0,0,0
2025-08-01 21:00,6,4,2,0,0,0
2025-08-01 21:15,7,1,6,0,0,0
2025-08-01 21:30,12,8,4,0,0,0
2025-08-01 21:45,4,4,0,0,0,0
2025-08-01 22:00,8,3,5,0,0,0
2025-08-01 22:15,18,9,9,0,0,0
2025-08-01 22:30,8,1,7,0,0,0
2025-08-01 22:45,4,3,1,0,0,0
2025-08-01 23:00,6,2,4,0,0,0
2025-08-01 23:15,3,0,3,0,0,0
2025-08-01 23:30,4,0,4,0,0,0
2025-08-01 23:45,5,2,3,0,0,0
2025-08-02 00:00,7,2,5,0,0,0
2025-08-02 00:15,3,1,2,0,0,0
2025-08-02 00:30,2,0,2,0,0,0
2025-08-02 00:45,1,1,0,0,0,0
2025-08-02 01:00,2,1,1,0,0,0
2025-08-02 01:15,2,1,1,0,0,0
2025-08-02 01:30,5,1,4,0,0,0
2025-08-02 01:45,7,6,1,0,0,0
2025-08-02 02:00,5,2,3,0,0,0
2025-08-02 02:15,1,0,1,0,0,0
2025-08-02 02:30,5,2,3,0,0,0
2025-08-02 02:45,3,2,1,0,0,0
2025-08-02 03:00,0,0,0,0,0,0
2025-08-02 03:15,2,0,2,0,0,0
2025-08-02 03:30,1,1,0,0,0,0
2025-08-02 03:45,2,0,2,0,0,0
2025-08-02 04:00,0,0,0,0,0,0
2025-08-02 04:15,2,1,1,0,0,0
2025-08-02 04:30,0,0,0,0,0,0
2025-08-02 04:45,1,1,0,0,0,0
2025-08-02 05:00,1,0,1,0,0,0
2025-08-02 05:15,0,0,0,0,0,0
2025-08-02 05:30,1,1,0,0,0,0
2025-08-02 05:45,1,0,1,0,0,0
2025-08-02 06:00,1,1,0,0,0,0
2025-08-02 06:15,2,0,2,0,0,0
2025-08-02 06:30,3,0,3,0,0,0
2025-08-02 06:45,3,2,1,0,0,0
2025-08-02 07:00,1,1,0,0,0,0
2025-08-02 07:15,1,0,1,0,0,0
2025-08-02 07:30,4,3,1,0,0,0
2025-08-02 07:45,2,2,0,0,0,0
2025-08-02 08:00,2,0,2,0,0,0
2025-08-02 08:15,8,6,2,0,0,0
2025-08-02 08:30,7,3,4,0,0,0
2025-08-02 08:45,11,3,8,0,0,0
2025-08-02 09:00,4,1,3,0,0,0
2025-08-02 09:15,17,12,5,0,0,0
2025-08-02 09:30,8,5,3,0,0,0
2025-08-02 09:45,20,10,10,0,0,0
2025-08-02 10:00,12,8,4,0,0,0
2025-08-02 10:15,8,3,5,0,0,0
2025-08-02 10:30,15,9,6,0,0,0
2025-08-02 10:45,11,6,5,0,0,0
2025-08-02 11:00,16,10,6,0,0,0
2025-08-02 11:15,12,8,4,0,0,0
2025-08-02 11:30,14,11,3,0,0,0
2025-08-02 11:45,17,7,10,0,0,0
2025-08-02 12:00,9,6,3,0,0,0
2025-08-02 12:15,17,10,7,0,0,0
2025-08-02 12:30,22,16,6,0,0,0
2025-08-02 12:45,12,5,7,0,0,0
2025-08-02 13:00,18,14,4,0,0,0
2025-08-02 13:15,15,4,11,0,0,0
2025-08-02 13:30,9,7,2,0,0,0
2025-08-02 13:45,21,12,9,0,0,0
2025-08-02 14:00,13,7,6,0,0,0
2025-08-02 14:15,20,12,8,0,0,0
2025-08-02 14:30,20,9,11,0,0,0
2025-08-02 14:45,22,14,8,0,0,0
2025-08-02 15:00,14,8,6,0,0,0
2025-08-02 15:15,22,10,12,0,0,0
2025-08-02 15:30,16,9,7,0,0,0
2025-08-02 15:45,22,11,11,0,0,0
2025-08-02 16:00,8,4,4,0,0,0
2025-08-02 16:15,12,6,6,0,0,0
2025-08-02 16:30,8,4,4,0,0,0
2025-08-02 16:45,12,6,6,0,0,0
2025-08-02 17:00,24,15,9,0,0,0
2025-08-02 17:15,13,7,6,0,0,0
2025-08-02 17:30,22,13,9,0,0,0
2025-08-02 17:45,22,11,11,0,0,0
2025-08-02 18:00,33,25,8,0,0,0
2025-08-02 18:15,20,12,8,0,0,0
2025-08-02 18:30,22,9,13,0,0,0
2025-08-02 18:45,15,6,9,0,0,0
2025-08-02 19:00,24,12,12,0,0,0
2025-08-02 19:15,18,7,11,0,0,0
2025-08-02 19:30,12,6,6,0,0,0
2025-08-02 19:45,16,7,9,0,0,0
2025-08-02 20:00,11,3,8,0,0,0
2025-08-02 20:15,12,3,9,0,0,0
2025-08-02 20:30,13,10,3,0,0,0
2025-08-02 20:45,7,4,3,0,0,0
2025-08-02 21:00,7,2,5,0,0,0
2025-08-02 21:15,10,4,6,0,0,0
2025-08-02 21:30,10,3,7,0,0,0
2025-08-02 21:45,16,5,11,0,0,0
2025-08-02 22:00,9,7,2,0,0,0
2025-08-02 22:15,8,3,5,0,0,0
2025-08-02 22:30,10,5,5,0,0,0
2025-08-02 22:45,9,1,8,0,0,0
2025-08-02 23:00,6,3,3,0,0,0
2025-08-02 23:15,2,0,2,0,0,0
2025-08-02 23:30,8,2,6,0,0,0
2025-08-02 23:45,3,2,1,0,0,0
2025-08-03 00:00,5,0,5,0,0,0
2025-08-03 00:15,13,6,7,0,0,0
2025-08-03 00:30,2,1,1,0,0,0
2025-08-03 00:45,2,0,2,0,0,0
2025-08-03 01:00,4,3,1,0,0,0
2025-08-03 01:15,2,1,1,0,0,0
2025-08-03 01:30,3,1,2,0,0,0
2025-08-03 01:45,5,2,3,0,0,0
2025-08-03 02:00,3,1,2,0,0,0
2025-08-03 02:15,1,0,1,0,0,0
2025-08-03 02:30,6,5,1,0,0,0
2025-08-03 02:45,0,0,0,0,0,0
2025-08-03 03:00,1,0,1,0,0,0
2025-08-03 03:15,2,0,2,0,0,0
2025-08-03 03:30,2,1,1,0,0,0
2025-08-03 03:45,3,0,3,0,0,0
2025-08-03 04:00,0,0,0,0,0,0
2025-08-03 04:15,0,0,0,0,0,0
2025-08-03 04:30,0,0,0,0,0,0
2025-08-03 04:45,2,1,1,0,0,0
2025-08-03 05:00,2,0,2,0,0,0
2025-08-03 05:15,2,1,1,0,0,0
2025-08-03 05:30,0,0,0,0,0,0
2025-08-03 05:45,0,0,0,0,0,0
2025-08-03 06:00,0,0,0,0,0,0
2025-08-03 06:15,1,0,1,0,0,0
2025-08-03 06:30,1,0,1,0,0,0
2025-08-03 06:45,0,0,0,0,0,0
2025-08-03 07:00,3,3,0,0,0,0
2025-08-03 07:15,4,4,0,0,0,0
2025-08-03 07:30,1,1,0,0,0,0
2025-08-03 07:45,2,1,1,0,0,0
2025-08-03 08:00,0,0,0,0,0,0
2025-08-03 08:15,8,3,5,0,0,0
2025-08-03 08:30,6,4,2,0,0,0
2025-08-03 08:45,1,1,0,0,0,0
2025-08-03 09:00,4,1,3,0,0,0
2025-08-03 09:15,3,2,1,0,0,0
2025-08-03 09:30,9,7,2,0,0,0
2025-08-03 09:45,9,7,2,0,0,0
2025-08-03 10:00,12,3,9,0,0,0
2025-08-03 10:15,8,2,6,0,0,0
2025-08-03 10:30,5,1,4,0,0,0
2025-08-03 10:45,14,8,6,0,0,0
2025-08-03 11:00,18,9,9,0,0,0
2025-08-03 11:15,11,4,7,0,0,0
2025-08-03 11:30,7,3,4,0,0,0
2025-08-03 11:45,6,3,3,0,0,0
2025-08-03 12:00,9,4,5,0,0,0
2025-08-03 12:15,11,3,8,0,0,0
2025-08-03 12:30,17,11,6,0,0,0
2025-08-03 12:45,18,11,7,0,0,0
2025-08-03 13:00,26,14,12,0,0,0
2025-08-03 13:15,10,3,7,0,0,0
2025-08-03 13:30,19,10,9,0,0,0
2025-08-03 13:45,10,5,5,0,0,0
2025-08-03 14:00,13,6,7,0,0,0
2025-08-03 14:15,8,4,4,0,0,0
2025-08-03 14:30,22,9,13,0,0,0
2025-08-03 14:45,17,6,11,0,0,0
2025-08-03 15:00,10,6,4,0,0,0
2025-08-03 15:15,17,11,6,0,0,0
2025-08-03 15:30,16,4,12,0,0,0
2025-08-03 15:45,8,2,6,0,0,0
2025-08-03 16:00,19,7,12,0,0,0
2025-08-03 16:15,21,4,17,0,0,0
2025-08-03 16:30,10,6,4,0,0,0
2025-08-03 16:45,21,13,8,0,0,0
2025-08-03 17:00,6,3,3,0,0,0
2025-08-03 17:15,23,15,8,0,0,0
2025-08-03 17:30,18,9,9,0,0,0
2025-08-03 17:45,22,11,11,0,0,0
2025-08-03 18:00,14,6,8,0,0,0
2025-08-03 18:15,19,10,9,0,0,0
2025-08-03 18:30,14,7,7,0,0,0
2025-08-03 18:45,20,13,7,0,0,0
2025-08-03 19:00,15,8,7,0,0,0
2025-08-03 19:15,6,2,4,0,0,0
2025-08-03 19:30,14,7,7,0,0,0
2025-08-03 19:45,11,7,4,0,0,0
2025-08-03 20:00,8,1,7,0,0,0
2025-08-03 20:15,7,3,4,0,0,0
2025-08-03 20:30,7,3,4,0,0,0
2025-08-03 20:45,6,4,2,0,0,0
2025-08-03 21:00,6,5,1,0,0,0
2025-08-03 21:15,7,2,5,0,0,0
2025-08-03 21:30,8,0,8,0,0,0
2025-08-03 21:45,9,5,4,0,0,0
2025-08-03 22:00,5,3,2,0,0,0
2025-08-03 22:15,5,2,3,0,0,0
2025-08-03 22:30,5,3,2,0,0,0
2025-08-03 22:45,6,0,6,0,0,0
2025-08-03 23:00,3,0,3,0,0,0
2025-08-03 23:15,3,2,1,0,0,0
2025-08-03 23:30,1,0,1,0,0,0
2025-08-03 23:45,2,1,1,0,0,0
2025-08-04 00:00,2,0,2,0,0,0
2025-08-04 00:15,4,1,3,0,0,0
2025-08-04 00:30,1,1,0,0,0,0
2025-08-04 00:45,0,0,0,0,0,0
2025-08-04 01:00,2,1,1,0,0,0
2025-08-04 01:15,0,0,0,0,0,0
2025-08-04 01:30,3,1,2,0,0,0
2025-08-04 01:45,3,3,0,0,0,0
2025-08-04 02:00,1,1,0,0,0,0
2025-08-04 02:15,1,1,0,0,0,0
2025-08-04 02:30,0,0,0,0,0,0
2025-08-04 02:45,4,3,1,0,0,0
2025-08-04 03:00,0,0,0,0,0,0
2025-08-04 03:15,4,1,3,0,0,0
2025-08-04 03:30,1,1,0,0,0,0
2025-08-04 03:45,0,0,0,0,0,0
2025-08-04 04:00,0,0,0,0,0,0
2025-08-04 04:15,1,1,0,0,0,0
2025-08-04 04:30,0,0,0,0,0,0
2025-08-04 04:45,3,2,1,0,0,0
2025-08-04 05:00,3,1,2,0,0,0
2025-08-04 05:15,5,1,4,0,0,0
2025-08-04 05:30,4,2,2,0,0,0
2025-08-04 05:45,3,1,2,0,0,0
2025-08-04 06:00,7,6,1,0,0,0
2025-08-04 06:15,4,2,2,0,0,0
2025-08-04 06:30,6,5,1,0,0,0
2025-08-04 06:45,4,3,1,0,0,0
2025-08-04 07:00,8,3,5,0,0,0
2025-08-04 07:15,17,8,9,0,0,0
2025-08-04 07:30,16,10,6,0,0,0
2025-08-04 07:45,27,14,13,0,0,0
2025-08-04 08:00,20,11,9,0,0,0
2025-08-04 08:15,14,8,6,0,0,0
2025-08-04 08:30,19,14,5,0,0,0
2025-08-04 08:45,16,6,10,0,0,0
2025-08-04 09:00,16,9,7,0,0,0
2025-08-04 09:15,14,8,6,0,0,0
2025-08-04 09:30,15,7,8,0,0,0
2025-08-04 09:45,14,8,6,0,0,0
2025-08-04 10:00,15,9,6,0,0,0
2025-08-04 10:15,14,10,4,0,0,0
2025-08-04 10:30,24,8,16,0,0,0
2025-08-04 10:45,11,6,5,0,0,0
2025-08-04 11:00,17,6,11,0,0,0
2025-08-04 11:15,26,16,10,0,0,0
2025-08-04 11:30,27,7,20,0,0,0
2025-08-04 11:45,15,6,9,0,0,0
2025-08-04 12:00,25,18,7,0,0,0
2025-08-04 12:15,19,6,13,0,0,0
2025-08-04 12:30,31,13,18,0,0,0
2025-08-04 12:45,30,14,16,0,0,0
2025-08-04 13:00,18,9,9,0,0,0
2025-08-04 13:15,26,11,15,0,0,0
2025-08-04 13:30,15,10,5,0,0,0
2025-08-04 13:45,32,14,18,0,0,0
2025-08-04 14:00,30,16,14,0,0,0
2025-08-04 14:15,29,14,15,0,0,0
2025-08-04 14:30,19,11,8,0,0,0
2025-08-04 14:45,28,9,19,0,0,0
2025-08-04 15:00,25,12,13,0,0,0
2025-08-04 15:15,28,10,18,0,0,0
2025-08-04 15:30,41,24,17,0,0,0
2025-08-04 15:45,27,14,13,0,0,0
2025-08-04 16:00,33,17,16,0,0,0
2025-08-04 16:15,36,19,17,0,0,0
2025-08-04 16:30,30,10,20,0,0,0
2025-08-04 16:45,32,13,19,0,0,0
2025-08-04 17:00,25,8,17,0,0,0
2025-08-04 17:15,30,12,18,0,0,0
2025-08-04 17:30,24,15,9,0,0,0
2025-08-04 17:45,27,12,15,0,0,0
2025-08-04 18:00,20,7,13,0,0,0
2025-08-04 18:15,43,13,30,0,0,0
2025-08-04 18:30,28,11,17,0,0,0
2025-08-04 18:45,30,15,15,0,0,0
2025-08-04 19:00,22,12,10,0,0,0
2025-08-04 19:15,16,5,11,0,0,0
2025-08-04 19:30,17,6,11,0,0,0
2025-08-04 19:45,22,12,10,0,0,0
2025-08-04 20:00,25,12,13,0,0,0
2025-08-04 20:15,20,11,9,0,0,0
2025-08-04 20:30,19,10,9,0,0,0
2025-08-04 20:45,13,5,8,0,0,0
2025-08-04 21:00,15,6,9,0,0,0
2025-08-04 21:15,11,4,7,0,0,0
2025-08-04 21:30,10,8,2,0,0,0
2025-08-04 21:45,14,5,9,0,0,0
2025-08-04 22:00,10,2,8,0,0,0
2025-08-04 22:15,12,6,6,0,0,0
2025-08-04 22:30,9,3,6,0,0,0
2025-08-04 22:45,14,7,7,0,0,0
2025-08-04 23:00,7,5,2,0,0,0
2025-08-04 23:15,7,3,4,0,0,0
2025-08-04 23:30,5,2,3,0,0,0
2025-08-04 23:45,8,1,7,0,0,0
2025-08-05 00:00,3,1,2,0,0,0
2025-08-05 00:15,1,1,0,0,0,0
2025-08-05 00:30,3,0,3,0,0,0
2025-08-05 00:45,3,0,3,0,0,0
2025-08-05 01:00,0,0,0,0,0,0
2025-08-05 01:15,2,1,1,0,0,0
2025-08-05 01:30,2,2,0,0,0,0
2025-08-05 01:45,5,3,2,0,0,0
2025-08-05 02:00,0,0,0,0,0,0
2025-08-05 02:15,0,0,0,0,0,0
2025-08-05 02:30,2,2,0,0,0,0
2025-08-05 02:45,3,1,2,0,0,0
2025-08-05 03:00,0,0,0,0,0,0
2025-08-05 03:15,6,5,1,0,0,0
2025-08-05 03:30,1,0,1,0,0,0
2025-08-05 03:45,1,1,0,0,0,0
2025-08-05 04:00,1,1,0,0,0,0
2025-08-05 04:15,3,2,1,0,0,0
2025-08-05 04:30,0,0,0,0,0,0
2025-08-05 04:45,3,1,2,0,0,0
2025-08-05 05:00,2,2,0,0,0,0
2025-08-05 05:15,5,2,3,0,0,0
2025-08-05 05:30,5,1,4,0,0,0
2025-08-05 05:45,5,0,5,0,0,0
2025-08-05 06:00,7,7,0,0,0,0
2025-08-05 06:15,2,2,0,0,0,0
2025-08-05 06:30,2,2,0,0,0,0
2025-08-05 06:45,13,6,7,0,0,0
2025-08-05 07:00,15,12,3,0,0,0
2025-08-05 07:15,18,10,8,0,0,0
2025-08-05 07:30,15,6,9,0,0,0
2025-08-05 07:45,18,7,11,0,0,0
2025-08-05 08:00,28,18,10,0,0,0
2025-08-05 08:15,30,13,17,0,0,0
2025-08-05 08:30,27,13,14,0,0,0
2025-08-05 08:45,32,17,15,0,0,0
2025-08-05 09:00,12,5,7,0,0,0
2025-08-05 09:15,9,6,3,0,0,0
2025-08-05 09:30,23,22,1,0,0,0
2025-08-05 09:45,11,5,6,0,0,0
2025-08-05 10:00,24,11,13,0,0,0
2025-08-05 10:15,18,8,10,0,0,0
2025-08-05 10:30,11,4,7,0,0,0
2025-08-05 10:45,17,10,7,0,0,0
2025-08-05 11:00,22,12,10,0,0,0
2025-08-05 11:15,27,17,10,0,0,0
2025-08-05 11:30,19,8,11,0,0,0
2025-08-05 11:45,20,12,8,0,0,0
2025-08-05 12:00,28,17,11,0,0,0
2025-08-05 12:15,29,17,12,0,0,0
2025-08-05 12:30,22,11,11,0,0,0
2025-08-05 12:45,18,8,10,0,0,0
2025-08-05 13:00,24,7,17,0,0,0
2025-08-05 13:15,17,9,8,0,0,0
2025-08-05 13:30,22,5,17,0,0,0
2025-08-05 13:45,42,20,22,0,0,0
2025-08-05 14:00,31,9,22,0,0,0
2025-08-05 14:15,20,6,14,0,0,0
2025-08-05 14:30,35,22,13,0,0,0
2025-08-05 14:45,23,10,13,0,0,0
2025-08-05 15:00,23,16,7,0,0,0
2025-08-05 15:15,31,12,19,0,0,0
2025-08-05 15:30,32,14,18,0,0,0
2025-08-05 15:45,36,16,20,0,0,0
2025-08-05 16:00,25,8,17,0,0,0
2025-08-05 16:15,37,17,20,0,0,0
2025-08-05 16:30,26,10,16,0,0,0
2025-08-05 16:45,35,13,22,0,0,0
2025-08-05 17:00,38,13,25,0,0,0
2025-08-05 17:15,41,21,20,0,0,0
2025-08-05 17:30,32,12,20,0,0,0
2025-08-05 17:45,30,12,18,0,0,0
2025-08-05 18:00,34,17,17,0,0,0
2025-08-05 18:15,24,10,14,0,0,0
2025-08-05 18:30,33,15,18,0,0,0
2025-08-05 18:45,18,5,13,0,0,0
2025-08-05 19:00,27,10,17,0,0,0
2025-08-05 19:15,19,12,7,0,0,0
2025-08-05 19:30,29,14,15,0,0,0
2025-08-05 19:45,13,9,4,0,0,0
2025-08-05 20:00,24,11,13,0,0,0
2025-08-05 20:15,15,9,6,0,0,0
2025-08-05 20:30,13,4,9,0,0,0
2025-08-05 20:45,9,3,6,0,0,0
2025-08-05 21:00,17,7,10,0,0,0
2025-08-05 21:15,9,3,6,0,0,0
2025-08-05 21:30,10,3,7,0,0,0
2025-08-05 21:45,13,8,5,0,0,0
2025-08-05 22:00,13,10,3,0,0,0
2025-08-05 22:15,14,5,9,0,0,0
2025-08-05 22:30,6,2,4,0,0,0
2025-08-05 22:45,7,4,3,0,0,0
2025-08-05 23:00,5,2,3,0,0,0
2025-08-05 23:15,2,0,2,0,0,0
2025-08-05 23:30,0,0,0,0,0,0
2025-08-05 23:45,4,1,3,0,0,0
2025-08-06 00:00,9,1,8,0,0,0
2025-08-06 00:15,1,0,1,0,0,0
2025-08-06 00:30,2,1,1,0,0,0
2025-08-06 00:45,3,1,2,0,0,0
2025-08-06 01:00,1,0,1,0,0,0
2025-08-06 01:15,1,0,1,0,0,0
2025-08-06 01:30,3,2,1,0,0,0
2025-08-06 01:45,2,2,0,0,0,0
