Datetime,100034983 (Warendorfer Straße),101034983 (Warendorfer Straße stadteinwärts),102034983 (Warendorfer Straße stadtauswärts),100034983-status,101034983-status,102034983-status
2024-06-01 00:00,15,7,8,0,0,0
2024-06-01 00:15,22,14,8,0,0,0
2024-06-01 00:30,23,9,14,0,0,0
2024-06-01 00:45,17,11,6,0,0,0
2024-06-01 01:00,8,3,5,0,0,0
2024-06-01 01:15,16,5,11,0,0,0
2024-06-01 01:30,15,3,12,0,0,0
2024-06-01 01:45,25,10,15,0,0,0
2024-06-01 02:00,5,1,4,0,0,0
2024-06-01 02:15,8,0,8,0,0,0
2024-06-01 02:30,8,1,7,0,0,0
2024-06-01 02:45,8,6,2,0,0,0
2024-06-01 03:00,5,0,5,0,0,0
2024-06-01 03:15,7,1,6,0,0,0
2024-06-01 03:30,4,2,2,0,0,0
2024-06-01 03:45,7,5,2,0,0,0
2024-06-01 04:00,4,1,3,0,0,0
2024-06-01 04:15,2,1,1,0,0,0
2024-06-01 04:30,1,1,0,0,0,0
2024-06-01 04:45,3,2,1,0,0,0
2024-06-01 05:00,3,1,2,0,0,0
2024-06-01 05:15,5,4,1,0,0,0
2024-06-01 05:30,13,7,6,0,0,0
2024-06-01 05:45,14,4,10,0,0,0
2024-06-01 06:00,5,2,3,0,0,0
2024-06-01 06:15,7,4,3,0,0,0
2024-06-01 06:30,5,4,1,0,0,0
2024-06-01 06:45,16,13,3,0,0,0
2024-06-01 07:00,9,8,1,0,0,0
2024-06-01 07:15,16,9,7,0,0,0
2024-06-01 07:30,28,18,10,0,0,0
2024-06-01 07:45,32,22,10,0,0,0
2024-06-01 08:00,35,21,14,0,0,0
2024-06-01 08:15,35,24,11,0,0,0
2024-06-01 08:30,45,35,10,0,0,0
2024-06-01 08:45,52,32,20,0,0,0
2024-06-01 09:00,39,30,9,0,0,0
2024-06-01 09:15,69,56,13,0,0,0
2024-06-01 09:30,71,64,7,0,0,0
2024-06-01 09:45,96,81,15,0,0,0
2024-06-01 10:00,99,77,22,0,0,0
2024-06-01 10:15,131,104,27,0,0,0
2024-06-01 10:30,132,107,25,0,0,0
2024-06-01 10:45,113,76,37,0,0,0
2024-06-01 11:00,123,95,28,0,0,0
2024-06-01 11:15,116,82,34,0,0,0
2024-06-01 11:30,128,84,44,0,0,0
2024-06-01 11:45,158,103,55,0,0,0
2024-06-01 12:00,112,86,26,0,0,0
2024-06-01 12:15,144,90,54,0,0,0
2024-06-01 12:30,154,103,51,0,0,0
2024-06-01 12:45,149,89,60,0,0,0
2024-06-01 13:00,152,100,52,0,0,0
2024-06-01 13:15,134,82,52,0,0,0
2024-06-01 13:30,133,76,57,0,0,0
2024-06-01 13:45,137,81,56,0,0,0
2024-06-01 14:00,137,87,50,0,0,0
2024-06-01 14:15,97,53,44,0,0,0
2024-06-01 14:30,125,71,54,0,0,0
2024-06-01 14:45,122,67,55,0,0,0
2024-06-01 15:00,107,52,55,0,0,0
2024-06-01 15:15,113,66,47,0,0,0
2024-06-01 15:30,107,64,43,0,0,0
2024-06-01 15:45,73,39,34,0,0,0
2024-06-01 16:00,111,52,59,0,0,0
2024-06-01 16:15,89,57,32,0,0,0
2024-06-01 16:30,89,52,37,0,0,0
2024-06-01 16:45,96,57,39,0,0,0
2024-06-01 17:00,89,47,42,0,0,0
2024-06-01 17:15,88,57,31,0,0,0
2024-06-01 17:30,98,60,38,0,0,0
2024-06-01 17:45,80,42,38,0,0,0
2024-06-01 18:00,80,42,38,0,0,0
2024-06-01 18:15,66,29,37,0,0,0
2024-06-01 18:30,87,56,31,0,0,0
2024-06-01 18:45,86,55,31,0,0,0
2024-06-01 19:00,84,55,29,0,0,0
2024-06-01 19:15,86,50,36,0,0,0
2024-06-01 19:30,55,31,24,0,0,0
2024-06-01 19:45,57,29,28,0,0,0
2024-06-01 20:00,65,43,22,0,0,0
2024-06-01 20:15,62,43,19,0,0,0
2024-06-01 20:30,53,19,34,0,0,0
2024-06-01 20:45,63,32,31,0,0,0
2024-06-01 21:00,45,18,27,0,0,0
2024-06-01 21:15,18,5,13,0,0,0
2024-06-01 21:30,31,19,12,0,0,0
2024-06-01 21:45,35,23,12,0,0,0
2024-06-01 22:00,24,13,11,0,0,0
2024-06-01 22:15,13,5,8,0,0,0
2024-06-01 22:30,20,12,8,0,0,0
2024-06-01 22:45,28,16,12,0,0,0
2024-06-01 23:00,46,16,30,0,0,0
2024-06-01 23:15,49,21,28,0,0,0
2024-06-01 23:30,59,33,26,0,0,0
2024-06-01 23:45,28,12,16,0,0,0
2024-06-02 00:00,31,15,16,0,0,0
2024-06-02 00:15,35,22,13,0,0,0
2024-06-02 00:30,27,21,6,0,0,0
2024-06-02 00:45,25,13,12,0,0,0
2024-06-02 01:00,18,10,8,0,0,0
2024-06-02 01:15,10,5,5,0,0,0
2024-06-02 01:30,8,2,6,0,0,0
2024-06-02 01:45,19,9,10,0,0,0
2024-06-02 02:00,11,5,6,0,0,0
2024-06-02 02:15,19,8,11,0,0,0
2024-06-02 02:30,14,6,8,0,0,0
2024-06-02 02:45,12,5,7,0,0,0
2024-06-02 03:00,11,4,7,0,0,0
2024-06-02 03:15,11,3,8,0,0,0
2024-06-02 03:30,5,1,4,0,0,0
2024-06-02 03:45,6,1,5,0,0,0
2024-06-02 04:00,7,4,3,0,0,0
2024-06-02 04:15,4,3,1,0,0,0
2024-06-02 04:30,1,0,1,0,0,0
2024-06-02 04:45,4,1,3,0,0,0
2024-06-02 05:00,2,2,0,0,0,0
2024-06-02 05:15,4,2,2,0,0,0
2024-06-02 05:30,7,3,4,0,0,0
2024-06-02 05:45,8,5,3,0,0,0
2024-06-02 06:00,5,4,1,0,0,0
2024-06-02 06:15,11,7,4,0,0,0
2024-06-02 06:30,2,0,2,0,0,0
2024-06-02 06:45,9,8,1,0,0,0
2024-06-02 07:00,4,3,1,0,0,0
2024-06-02 07:15,6,4,2,0,0,0
2024-06-02 07:30,7,5,2,0,0,0
2024-06-02 07:45,5,3,2,0,0,0
2024-06-02 08:00,6,5,1,0,0,0
2024-06-02 08:15,6,2,4,0,0,0
2024-06-02 08:30,11,5,6,0,0,0
2024-06-02 08:45,17,8,9,0,0,0
2024-06-02 09:00,24,18,6,0,0,0
2024-06-02 09:15,15,12,3,0,0,0
2024-06-02 09:30,37,30,7,0,0,0
2024-06-02 09:45,44,30,14,0,0,0
2024-06-02 10:00,47,20,27,0,0,0
2024-06-02 10:15,23,12,11,0,0,0
2024-06-02 10:30,36,27,9,0,0,0
2024-06-02 10:45,45,38,7,0,0,0
2024-06-02 11:00,24,16,8,0,0,0
2024-06-02 11:15,43,33,10,0,0,0
2024-06-02 11:30,36,23,13,0,0,0
2024-06-02 11:45,46,22,24,0,0,0
2024-06-02 12:00,39,29,10,0,0,0
2024-06-02 12:15,53,34,19,0,0,0
2024-06-02 12:30,59,35,24,0,0,0
2024-06-02 12:45,61,40,21,0,0,0
2024-06-02 13:00,54,37,17,0,0,0
2024-06-02 13:15,56,40,16,0,0,0
2024-06-02 13:30,56,31,25,0,0,0
2024-06-02 13:45,70,40,30,0,0,0
2024-06-02 14:00,82,55,27,0,0,0
2024-06-02 14:15,74,52,22,0,0,0
2024-06-02 14:30,69,49,20,0,0,0
2024-06-02 14:45,90,58,32,0,0,0
2024-06-02 15:00,63,40,23,0,0,0
2024-06-02 15:15,84,51,33,0,0,0
2024-06-02 15:30,74,49,25,0,0,0
2024-06-02 15:45,72,45,27,0,0,0
2024-06-02 16:00,64,28,36,0,0,0
2024-06-02 16:15,69,46,23,0,0,0
2024-06-02 16:30,83,59,24,0,0,0
2024-06-02 16:45,71,48,23,0,0,0
2024-06-02 17:00,65,42,23,0,0,0
2024-06-02 17:15,58,31,27,0,0,0
2024-06-02 17:30,59,37,22,0,0,0
2024-06-02 17:45,68,42,26,0,0,0
2024-06-02 18:00,57,37,20,0,0,0
2024-06-02 18:15,66,38,28,0,0,0
2024-06-02 18:30,60,32,28,0,0,0
2024-06-02 18:45,54,32,22,0,0,0
2024-06-02 19:00,52,22,30,0,0,0
2024-06-02 19:15,53,28,25,0,0,0
2024-06-02 19:30,45,21,24,0,0,0
2024-06-02 19:45,45,21,24,0,0,0
2024-06-02 20:00,40,24,16,0,0,0
2024-06-02 20:15,31,14,17,0,0,0
2024-06-02 20:30,23,12,11,0,0,0
2024-06-02 20:45,31,13,18,0,0,0
2024-06-02 21:00,36,18,18,0,0,0
2024-06-02 21:15,20,12,8,0,0,0
2024-06-02 21:30,35,20,15,0,0,0
2024-06-02 21:45,23,14,9,0,0,0
2024-06-02 22:00,26,14,12,0,0,0
2024-06-02 22:15,26,12,14,0,0,0
2024-06-02 22:30,17,9,8,0,0,0
2024-06-02 22:45,10,7,3,0,0,0
2024-06-02 23:00,10,4,6,0,0,0
2024-06-02 23:15,4,3,1,0,0,0
2024-06-02 23:30,6,3,3,0,0,0
2024-06-02 23:45,1,1,0,0,0,0
2024-06-03 00:00,4,2,2,0,0,0
2024-06-03 00:15,7,1,6,0,0,0
2024-06-03 00:30,1,0,1,0,0,0
2024-06-03 00:45,4,4,0,0,0,0
2024-06-03 01:00,1,1,0,0,0,0
2024-06-03 01:15,3,2,1,0,0,0
2024-06-03 01:30,0,0,0,0,0,0
2024-06-03 01:45,2,1,1,0,0,0
2024-06-03 02:00,1,0,1,0,0,0
2024-06-03 02:15,0,0,0,0,0,0
2024-06-03 02:30,0,0,0,0,0,0
2024-06-03 02:45,0,0,0,0,0,0
2024-06-03 03:00,1,0,1,0,0,0
2024-06-03 03:15,2,1,1,0,0,0
2024-06-03 03:30,0,0,0,0,0,0
2024-06-03 03:45,1,1,0,0,0,0
2024-06-03 04:00,0,0,0,0,0,0
2024-06-03 04:15,4,3,1,0,0,0
2024-06-03 04:30,0,0,0,0,0,0
2024-06-03 04:45,2,2,0,0,0,0
2024-06-03 05:00,1,1,0,0,0,0
2024-06-03 05:15,7,4,3,0,0,0
2024-06-03 05:30,20,14,6,0,0,0
2024-06-03 05:45,12,9,3,0,0,0
2024-06-03 06:00,19,14,5,0,0,0
2024-06-03 06:15,42,24,18,0,0,0
2024-06-03 06:30,35,26,9,0,0,0
2024-06-03 06:45,61,38,23,0,0,0
2024-06-03 07:00,74,53,21,0,0,0
2024-06-03 07:15,152,117,35,0,0,0
2024-06-03 07:30,265,225,40,0,0,0
2024-06-03 07:45,217,167,50,0,0,0
2024-06-03 08:00,145,119,26,0,0,0
2024-06-03 08:15,152,115,37,0,0,0
2024-06-03 08:30,155,115,40,0,0,0
2024-06-03 08:45,161,129,32,0,0,0
2024-06-03 09:00,105,84,21,0,0,0
2024-06-03 09:15,38,18,20,0,0,0
2024-06-03 09:30,36,20,16,0,0,0
2024-06-03 09:45,33,0,33,0,0,0
2024-06-03 10:00,22,0,22,0,0,0
2024-06-03 10:15,19,0,19,0,0,0
2024-06-03 10:30,31,0,31,0,0,0
2024-06-03 10:45,29,0,29,0,0,0
2024-06-03 11:00,28,0,28,0,0,0
2024-06-03 11:15,22,0,22,0,0,0
2024-06-03 11:30,27,0,27,0,0,0
2024-06-03 11:45,37,0,37,0,0,0
2024-06-03 12:00,38,0,38,0,0,0
2024-06-03 12:15,39,0,39,0,0,0
2024-06-03 12:30,46,0,46,0,0,0
2024-06-03 12:45,45,0,45,0,0,0
2024-06-03 13:00,66,0,66,0,0,0
2024-06-03 13:15,47,0,47,0,0,0
2024-06-03 13:30,27,0,27,0,0,0
2024-06-03 13:45,62,0,62,0,0,0
2024-06-03 14:00,68,0,68,0,0,0
2024-06-03 14:15,50,0,50,0,0,0
2024-06-03 14:30,56,0,56,0,0,0
2024-06-03 14:45,62,0,62,0,0,0
2024-06-03 15:00,59,0,59,0,0,0
2024-06-03 15:15,49,0,49,0,0,0
2024-06-03 15:30,49,0,49,0,0,0
2024-06-03 15:45,91,0,91,0,0,0
2024-06-03 16:00,92,0,92,0,0,0
2024-06-03 16:15,80,0,80,0,0,0
2024-06-03 16:30,79,0,79,0,0,0
2024-06-03 16:45,89,0,89,0,0,0
2024-06-03 17:00,94,0,94,0,0,0
2024-06-03 17:15,80,0,80,0,0,0
2024-06-03 17:30,68,0,68,0,0,0
2024-06-03 17:45,94,0,94,0,0,0
2024-06-03 18:00,76,0,76,0,0,0
2024-06-03 18:15,72,0,72,0,0,0
2024-06-03 18:30,77,0,77,0,0,0
2024-06-03 18:45,54,0,54,0,0,0
2024-06-03 19:00,65,0,65,0,0,0
2024-06-03 19:15,32,0,32,0,0,0
2024-06-03 19:30,38,0,38,0,0,0
2024-06-03 19:45,48,0,48,0,0,0
2024-06-03 20:00,33,0,33,0,0,0
2024-06-03 20:15,31,0,31,0,0,0
2024-06-03 20:30,31,0,31,0,0,0
2024-06-03 20:45,17,0,17,0,0,0
2024-06-03 21:00,25,0,25,0,0,0
2024-06-03 21:15,25,0,25,0,0,0
2024-06-03 21:30,31,0,31,0,0,0
2024-06-03 21:45,41,0,41,0,0,0
2024-06-03 22:00,17,0,17,0,0,0
2024-06-03 22:15,20,0,20,0,0,0
2024-06-03 22:30,23,0,23,0,0,0
2024-06-03 22:45,15,0,15,0,0,0
2024-06-03 23:00,11,0,11,0,0,0
2024-06-03 23:15,10,0,10,0,0,0
2024-06-03 23:30,7,0,7,0,0,0
2024-06-03 23:45,5,0,5,0,0,0
2024-06-04 00:00,8,0,8,0,0,0
2024-06-04 00:15,3,0,3,0,0,0
2024-06-04 00:30,2,0,2,0,0,0
2024-06-04 00:45,2,0,2,0,0,0
2024-06-04 01:00,2,0,2,0,0,0
2024-06-04 01:15,1,0,1,0,0,0
2024-06-04 01:30,0,0,0,0,0,0
2024-06-04 01:45,2,0,2,0,0,0
2024-06-04 02:00,0,0,0,0,0,0
2024-06-04 02:15,0,0,0,0,0,0
2024-06-04 02:30,0,0,0,0,0,0
2024-06-04 02:45,0,0,0,0,0,0
2024-06-04 03:00,0,0,0,0,0,0
2024-06-04 03:15,0,0,0,0,0,0
2024-06-04 03:30,0,0,0,0,0,0
2024-06-04 03:45,0,0,0,0,0,0
2024-06-04 04:00,0,0,0,0,0,0
2024-06-04 04:15,2,0,2,0,0,0
2024-06-04 04:30,0,0,0,0,0,0
2024-06-04 04:45,0,0,0,0,0,0
2024-06-04 05:00,0,0,0,0,0,0
2024-06-04 05:15,2,0,2,0,0,0
2024-06-04 05:30,10,0,10,0,0,0
2024-06-04 05:45,2,0,2,0,0,0
2024-06-04 06:00,3,0,3,0,0,0
2024-06-04 06:15,10,0,10,0,0,0
2024-06-04 06:30,16,0,16,0,0,0
2024-06-04 06:45,24,1,23,0,0,0
2024-06-04 07:00,28,0,28,0,0,0
2024-06-04 07:15,27,0,27,0,0,0
2024-06-04 07:30,56,0,56,0,0,0
2024-06-04 07:45,58,0,58,0,0,0
2024-06-04 08:00,39,0,39,0,0,0
2024-06-04 08:15,41,0,41,0,0,0
2024-06-04 08:30,31,0,31,0,0,0
2024-06-04 08:45,33,0,33,0,0,0
2024-06-04 09:00,34,0,34,0,0,0
2024-06-04 09:15,29,0,29,0,0,0
2024-06-04 09:30,33,4,29,0,0,0
2024-06-04 09:45,40,3,37,0,0,0
2024-06-04 10:00,24,0,24,0,0,0
2024-06-04 10:15,23,0,23,0,0,0
2024-06-04 10:30,22,0,22,0,0,0
2024-06-04 10:45,27,0,27,0,0,0
2024-06-04 11:00,31,0,31,0,0,0
2024-06-04 11:15,43,0,43,0,0,0
2024-06-04 11:30,40,0,40,0,0,0
2024-06-04 11:45,37,0,37,0,0,0
2024-06-04 12:00,44,0,44,0,0,0
2024-06-04 12:15,52,4,48,0,0,0
2024-06-04 12:30,56,0,56,0,0,0
2024-06-04 12:45,43,0,43,0,0,0
2024-06-04 13:00,70,0,70,0,0,0
2024-06-04 13:15,54,0,54,0,0,0
2024-06-04 13:30,48,0,48,0,0,0
2024-06-04 13:45,54,0,54,0,0,0
2024-06-04 14:00,65,6,59,0,0,0
2024-06-04 14:15,49,0,49,0,0,0
2024-06-04 14:30,70,6,64,0,0,0
2024-06-04 14:45,63,6,57,0,0,0
2024-06-04 15:00,65,8,57,0,0,0
2024-06-04 15:15,76,0,76,0,0,0
2024-06-04 15:30,67,0,67,0,0,0
2024-06-04 15:45,82,4,78,0,0,0
2024-06-04 16:00,93,4,89,0,0,0
2024-06-04 16:15,92,0,92,0,0,0
2024-06-04 16:30,81,0,81,0,0,0
2024-06-04 16:45,88,6,82,0,0,0
2024-06-04 17:00,77,0,77,0,0,0
2024-06-04 17:15,83,0,83,0,0,0
2024-06-04 17:30,88,0,88,0,0,0
2024-06-04 17:45,101,0,101,0,0,0
2024-06-04 18:00,103,0,103,0,0,0
2024-06-04 18:15,81,1,80,0,0,0
2024-06-04 18:30,72,1,71,0,0,0
2024-06-04 18:45,73,1,72,0,0,0
2024-06-04 19:00,54,1,53,0,0,0
2024-06-04 19:15,61,0,61,0,0,0
2024-06-04 19:30,46,0,46,0,0,0
2024-06-04 19:45,60,0,60,0,0,0
2024-06-04 20:00,50,0,50,0,0,0
2024-06-04 20:15,44,0,44,0,0,0
2024-06-04 20:30,43,0,43,0,0,0
2024-06-04 20:45,33,0,33,0,0,0
2024-06-04 21:00,27,0,27,0,0,0
2024-06-04 21:15,21,0,21,0,0,0
2024-06-04 21:30,27,0,27,0,0,0
2024-06-04 21:45,34,0,34,0,0,0
2024-06-04 22:00,36,0,36,0,0,0
2024-06-04 22:15,41,0,41,0,0,0
2024-06-04 22:30,22,0,22,0,0,0
2024-06-04 22:45,17,0,17,0,0,0
2024-06-04 23:00,16,0,16,0,0,0
2024-06-04 23:15,14,0,14,0,0,0
2024-06-04 23:30,11,0,11,0,0,0
2024-06-04 23:45,3,0,3,0,0,0
2024-06-05 00:00,6,0,6,0,0,0
2024-06-05 00:15,5,0,5,0,0,0
2024-06-05 00:30,3,0,3,0,0,0
2024-06-05 00:45,2,0,2,0,0,0
2024-06-05 01:00,6,0,6,0,0,0
2024-06-05 01:15,2,0,2,0,0,0
2024-06-05 01:30,3,0,3,0,0,0
2024-06-05 01:45,1,0,1,0,0,0
2024-06-05 02:00,0,0,0,0,0,0
2024-06-05 02:15,0,0,0,0,0,0
2024-06-05 02:30,3,0,3,0,0,0
2024-06-05 02:45,2,0,2,0,0,0
2024-06-05 03:00,0,0,0,0,0,0
2024-06-05 03:15,2,0,2,0,0,0
2024-06-05 03:30,0,0,0,0,0,0
2024-06-05 03:45,0,0,0,0,0,0
2024-06-05 04:00,1,0,1,0,0,0
2024-06-05 04:15,0,0,0,0,0,0
2024-06-05 04:30,0,0,0,0,0,0
2024-06-05 04:45,1,0,1,0,0,0
2024-06-05 05:00,0,0,0,0,0,0
2024-06-05 05:15,5,0,5,0,0,0
2024-06-05 05:30,4,0,4,0,0,0
2024-06-05 05:45,4,0,4,0,0,0
2024-06-05 06:00,5,0,5,0,0,0
2024-06-05 06:15,7,0,7,0,0,0
2024-06-05 06:30,12,1,11,0,0,0
2024-06-05 06:45,14,0,14,0,0,0
2024-06-05 07:00,25,0,25,0,0,0
2024-06-05 07:15,31,0,31,0,0,0
2024-06-05 07:30,43,4,39,0,0,0
2024-06-05 07:45,66,0,66,0,0,0
2024-06-05 08:00,39,0,39,0,0,0
2024-06-05 08:15,41,0,41,0,0,0
2024-06-05 08:30,24,0,24,0,0,0
2024-06-05 08:45,45,0,45,0,0,0
2024-06-05 09:00,25,4,21,0,0,0
2024-06-05 09:15,24,2,22,0,0,0
2024-06-05 09:30,42,10,32,0,0,0
2024-06-05 09:45,37,4,33,0,0,0
2024-06-05 10:00,27,0,27,0,0,0
2024-06-05 10:15,38,5,33,0,0,0
2024-06-05 10:30,83,49,34,0,0,0
2024-06-05 10:45,63,17,46,0,0,0
2024-06-05 11:00,26,0,26,0,0,0
2024-06-05 11:15,30,0,30,0,0,0
2024-06-05 11:30,36,1,35,0,0,0
2024-06-05 11:45,90,37,53,0,0,0
2024-06-05 12:00,115,66,49,0,0,0
2024-06-05 12:15,137,82,55,0,0,0
2024-06-05 12:30,71,0,71,0,0,0
2024-06-05 12:45,91,17,74,0,0,0
2024-06-05 13:00,78,0,78,0,0,0
2024-06-05 13:15,82,10,72,0,0,0
2024-06-05 13:30,90,31,59,0,0,0
2024-06-05 13:45,137,62,75,0,0,0
2024-06-05 14:00,146,56,90,0,0,0
2024-06-05 14:15,64,14,50,0,0,0
2024-06-05 14:30,96,35,61,0,0,0
2024-06-05 14:45,65,0,65,0,0,0
2024-06-05 15:00,76,11,65,0,0,0
2024-06-05 15:15,64,9,55,0,0,0
2024-06-05 15:30,78,1,77,0,0,0
2024-06-05 15:45,64,0,64,0,0,0
2024-06-05 16:00,73,0,73,0,0,0
2024-06-05 16:15,75,0,75,0,0,0
2024-06-05 16:30,79,0,79,0,0,0
2024-06-05 16:45,90,0,90,0,0,0
2024-06-05 17:00,65,0,65,0,0,0
2024-06-05 17:15,74,0,74,0,0,0
2024-06-05 17:30,82,0,82,0,0,0
2024-06-05 17:45,109,0,109,0,0,0
2024-06-05 18:00,90,0,90,0,0,0
2024-06-05 18:15,86,0,86,0,0,0
2024-06-05 18:30,47,0,47,0,0,0
2024-06-05 18:45,58,0,58,0,0,0
2024-06-05 19:00,56,0,56,0,0,0
2024-06-05 19:15,70,0,70,0,0,0
2024-06-05 19:30,46,0,46,0,0,0
2024-06-05 19:45,47,0,47,0,0,0
2024-06-05 20:00,42,0,42,0,0,0
2024-06-05 20:15,39,0,39,0,0,0
2024-06-05 20:30,35,0,35,0,0,0
2024-06-05 20:45,26,0,26,0,0,0
2024-06-05 21:00,29,0,29,0,0,0
2024-06-05 21:15,28,0,28,0,0,0
2024-06-05 21:30,27,0,27,0,0,0
2024-06-05 21:45,27,0,27,0,0,0
2024-06-05 22:00,20,0,20,0,0,0
2024-06-05 22:15,32,0,32,0,0,0
2024-06-05 22:30,23,0,23,0,0,0
2024-06-05 22:45,33,0,33,0,0,0
2024-06-05 23:00,22,0,22,0,0,0
2024-06-05 23:15,8,0,8,0,0,0
2024-06-05 23:30,17,0,17,0,0,0
2024-06-05 23:45,12,0,12,0,0,0
2024-06-06 00:00,9,0,9,0,0,0
2024-06-06 00:15,10,0,10,0,0,0
2024-06-06 00:30,5,0,5,0,0,0
2024-06-06 00:45,9,0,9,0,0,0
2024-06-06 01:00,6,0,6,0,0,0
2024-06-06 01:15,3,0,3,0,0,0
2024-06-06 01:30,1,0,1,0,0,0
2024-06-06 01:45,3,0,3,0,0,0
2024-06-06 02:00,4,0,4,0,0,0
2024-06-06 02:15,3,0,3,0,0,0
2024-06-06 02:30,6,0,6,0,0,0
2024-06-06 02:45,4,0,4,0,0,0
2024-06-06 03:00,2,0,2,0,0,0
2024-06-06 03:15,3,0,3,0,0,0
2024-06-06 03:30,3,0,3,0,0,0
2024-06-06 03:45,1,0,1,0,0,0
2024-06-06 04:00,5,0,5,0,0,0
2024-06-06 04:15,0,0,0,0,0,0
2024-06-06 04:30,2,0,2,0,0,0
2024-06-06 04:45,0,0,0,0,0,0
2024-06-06 05:00,0,0,0,0,0,0
2024-06-06 05:15,3,0,3,0,0,0
2024-06-06 05:30,8,0,8,0,0,0
2024-06-06 05:45,6,0,6,0,0,0
2024-06-06 06:00,5,0,5,0,0,0
2024-06-06 06:15,15,0,15,0,0,0
2024-06-06 06:30,17,0,17,0,0,0
2024-06-06 06:45,17,0,17,0,0,0
2024-06-06 07:00,22,0,22,0,0,0
2024-06-06 07:15,36,0,36,0,0,0
2024-06-06 07:30,43,0,43,0,0,0
2024-06-06 07:45,64,0,64,0,0,0
2024-06-06 08:00,43,0,43,0,0,0
2024-06-06 08:15,36,0,36,0,0,0
2024-06-06 08:30,25,0,25,0,0,0
2024-06-06 08:45,27,0,27,0,0,0
2024-06-06 09:00,22,0,22,0,0,0
2024-06-06 09:15,32,0,32,0,0,0
2024-06-06 09:30,26,0,26,0,0,0
2024-06-06 09:45,50,9,41,0,0,0
2024-06-06 10:00,29,2,27,0,0,0
2024-06-06 10:15,40,15,25,0,0,0
2024-06-06 10:30,0,0,0,0,0,0
2024-06-06 10:45,1,1,0,0,0,0
2024-06-06 11:00,1,0,1,0,0,0
2024-06-06 11:15,23,0,23,0,0,0
2024-06-06 11:30,29,0,29,0,0,0
2024-06-06 11:45,48,0,48,0,0,0
2024-06-06 12:00,44,0,44,0,0,0
2024-06-06 12:15,40,0,40,0,0,0
2024-06-06 12:30,46,1,45,0,0,0
2024-06-06 12:45,50,0,50,0,0,0
2024-06-06 13:00,57,0,57,0,0,0
2024-06-06 13:15,62,0,62,0,0,0
2024-06-06 13:30,50,0,50,0,0,0
2024-06-06 13:45,71,0,71,0,0,0
2024-06-06 14:00,68,0,68,0,0,0
2024-06-06 14:15,57,0,57,0,0,0
2024-06-06 14:30,57,0,57,0,0,0
2024-06-06 14:45,86,0,86,0,0,0
2024-06-06 15:00,62,0,62,0,0,0
2024-06-06 15:15,60,0,60,0,0,0
2024-06-06 15:30,54,0,54,0,0,0
2024-06-06 15:45,91,0,91,0,0,0
2024-06-06 16:00,77,0,77,0,0,0
2024-06-06 16:15,78,3,75,0,0,0
2024-06-06 16:30,80,7,73,0,0,0
2024-06-06 16:45,95,12,83,0,0,0
2024-06-06 17:00,84,4,80,0,0,0
2024-06-06 17:15,81,2,79,0,0,0
2024-06-06 17:30,105,1,104,0,0,0
2024-06-06 17:45,90,0,90,0,0,0
2024-06-06 18:00,71,1,70,0,0,0
2024-06-06 18:15,91,0,91,0,0,0
2024-06-06 18:30,57,0,57,0,0,0
2024-06-06 18:45,77,1,76,0,0,0
2024-06-06 19:00,49,0,49,0,0,0
2024-06-06 19:15,56,0,56,0,0,0
2024-06-06 19:30,55,0,55,0,0,0
2024-06-06 19:45,59,0,59,0,0,0
2024-06-06 20:00,37,0,37,0,0,0
2024-06-06 20:15,41,0,41,0,0,0
2024-06-06 20:30,33,0,33,0,0,0
2024-06-06 20:45,26,0,26,0,0,0
2024-06-06 21:00,25,0,25,0,0,0
2024-06-06 21:15,28,0,28,0,0,0
2024-06-06 21:30,41,0,41,0,0,0
2024-06-06 21:45,53,0,53,0,0,0
2024-06-06 22:00,35,0,35,0,0,0
2024-06-06 22:15,21,0,21,0,0,0
2024-06-06 22:30,29,0,29,0,0,0
2024-06-06 22:45,18,0,18,0,0,0
2024-06-06 23:00,16,0,16,0,0,0
2024-06-06 23:15,24,0,24,0,0,0
2024-06-06 23:30,15,0,15,0,0,0
2024-06-06 23:45,7,0,7,0,0,0
2024-06-07 00:00,7,0,7,0,0,0
2024-06-07 00:15,5,0,5,0,0,0
2024-06-07 00:30,3,0,3,0,0,0
2024-06-07 00:45,2,0,2,0,0,0
2024-06-07 01:00,6,0,6,0,0,0
2024-06-07 01:15,4,0,4,0,0,0
2024-06-07 01:30,5,0,5,0,0,0
2024-06-07 01:45,4,0,4,0,0,0
2024-06-07 02:00,2,0,2,0,0,0
2024-06-07 02:15,0,0,0,0,0,0
2024-06-07 02:30,2,0,2,0,0,0
2024-06-07 02:45,0,0,0,0,0,0
2024-06-07 03:00,2,0,2,0,0,0
2024-06-07 03:15,0,0,0,0,0,0
2024-06-07 03:30,1,0,1,0,0,0
2024-06-07 03:45,1,0,1,0,0,0
2024-06-07 04:00,0,0,0,0,0,0
2024-06-07 04:15,0,0,0,0,0,0
2024-06-07 04:30,0,0,0,0,0,0
2024-06-07 04:45,0,0,0,0,0,0
2024-06-07 05:00,2,0,2,0,0,0
2024-06-07 05:15,3,0,3,0,0,0
2024-06-07 05:30,7,0,7,0,0,0
2024-06-07 05:45,7,0,7,0,0,0
2024-06-07 06:00,4,0,4,0,0,0
2024-06-07 06:15,8,0,8,0,0,0
2024-06-07 06:30,15,0,15,0,0,0
2024-06-07 06:45,15,0,15,0,0,0
2024-06-07 07:00,24,0,24,0,0,0
2024-06-07 07:15,26,0,26,0,0,0
2024-06-07 07:30,44,0,44,0,0,0
2024-06-07 07:45,53,0,53,0,0,0
2024-06-07 08:00,35,0,35,0,0,0
2024-06-07 08:15,30,0,30,0,0,0
2024-06-07 08:30,28,6,22,0,0,0
2024-06-07 08:45,28,0,28,0,0,0
2024-06-07 09:00,22,0,22,0,0,0
2024-06-07 09:15,27,1,26,0,0,0
2024-06-07 09:30,36,3,33,0,0,0
2024-06-07 09:45,26,1,25,0,0,0
2024-06-07 10:00,7,0,7,0,0,0
2024-06-07 10:15,17,0,17,0,0,0
2024-06-07 10:30,30,0,30,0,0,0
2024-06-07 10:45,39,0,39,0,0,0
2024-06-07 11:00,21,0,21,0,0,0
2024-06-07 11:15,40,0,40,0,0,0
2024-06-07 11:30,54,0,54,0,0,0
2024-06-07 11:45,57,0,57,0,0,0
2024-06-07 12:00,58,0,58,0,0,0
2024-06-07 12:15,41,0,41,0,0,0
2024-06-07 12:30,53,0,53,0,0,0
2024-06-07 12:45,59,0,59,0,0,0
2024-06-07 13:00,69,0,69,0,0,0
2024-06-07 13:15,74,0,74,0,0,0
2024-06-07 13:30,76,0,76,0,0,0
2024-06-07 13:45,70,0,70,0,0,0
2024-06-07 14:00,84,0,84,0,0,0
2024-06-07 14:15,78,0,78,0,0,0
2024-06-07 14:30,53,0,53,0,0,0
2024-06-07 14:45,73,0,73,0,0,0
2024-06-07 15:00,58,0,58,0,0,0
2024-06-07 15:15,64,0,64,0,0,0
2024-06-07 15:30,64,0,64,0,0,0
2024-06-07 15:45,60,0,60,0,0,0
2024-06-07 16:00,51,0,51,0,0,0
2024-06-07 16:15,68,0,68,0,0,0
2024-06-07 16:30,45,0,45,0,0,0
2024-06-07 16:45,67,0,67,0,0,0
2024-06-07 17:00,61,0,61,0,0,0
2024-06-07 17:15,66,0,66,0,0,0
2024-06-07 17:30,55,0,55,0,0,0
2024-06-07 17:45,65,0,65,0,0,0
2024-06-07 18:00,62,0,62,0,0,0
2024-06-07 18:15,76,0,76,0,0,0
2024-06-07 18:30,60,0,60,0,0,0
2024-06-07 18:45,62,0,62,0,0,0
2024-06-07 19:00,68,0,68,0,0,0
2024-06-07 19:15,55,0,55,0,0,0
2024-06-07 19:30,40,0,40,0,0,0
2024-06-07 19:45,55,0,55,0,0,0
2024-06-07 20:00,57,0,57,0,0,0
2024-06-07 20:15,37,0,37,0,0,0
2024-06-07 20:30,34,0,34,0,0,0
2024-06-07 20:45,27,0,27,0,0,0
2024-06-07 21:00,24,0,24,0,0,0
2024-06-07 21:15,21,0,21,0,0,0
2024-06-07 21:30,22,0,22,0,0,0
2024-06-07 21:45,37,0,37,0,0,0
2024-06-07 22:00,33,0,33,0,0,0
2024-06-07 22:15,28,0,28,0,0,0
2024-06-07 22:30,33,0,33,0,0,0
2024-06-07 22:45,47,0,47,0,0,0
2024-06-07 23:00,36,0,36,0,0,0
2024-06-07 23:15,32,0,32,0,0,0
2024-06-07 23:30,43,0,43,0,0,0
2024-06-07 23:45,33,0,33,0,0,0
2024-06-08 00:00,46,0,46,0,0,0
2024-06-08 00:15,35,0,35,0,0,0
2024-06-08 00:30,25,0,25,0,0,0
2024-06-08 00:45,34,0,34,0,0,0
2024-06-08 01:00,26,0,26,0,0,0
2024-06-08 01:15,25,0,25,0,0,0
2024-06-08 01:30,19,0,19,0,0,0
2024-06-08 01:45,15,0,15,0,0,0
2024-06-08 02:00,31,0,31,0,0,0
2024-06-08 02:15,19,0,19,0,0,0
2024-06-08 02:30,18,0,18,0,0,0
2024-06-08 02:45,8,1,7,0,0,0
2024-06-08 03:00,5,1,4,0,0,0
2024-06-08 03:15,2,0,2,0,0,0
2024-06-08 03:30,5,0,5,0,0,0
2024-06-08 03:45,2,0,2,0,0,0
2024-06-08 04:00,1,0,1,0,0,0
2024-06-08 04:15,3,0,3,0,0,0
2024-06-08 04:30,1,0,1,0,0,0
2024-06-08 04:45,2,0,2,0,0,0
2024-06-08 05:00,4,0,4,0,0,0
2024-06-08 05:15,2,0,2,0,0,0
2024-06-08 05:30,2,0,2,0,0,0
2024-06-08 05:45,5,0,5,0,0,0
2024-06-08 06:00,5,0,5,0,0,0
2024-06-08 06:15,2,0,2,0,0,0
2024-06-08 06:30,0,0,0,0,0,0
2024-06-08 06:45,4,0,4,0,0,0
2024-06-08 07:00,2,0,2,0,0,0
2024-06-08 07:15,2,0,2,0,0,0
2024-06-08 07:30,8,0,8,0,0,0
2024-06-08 07:45,10,0,10,0,0,0
2024-06-08 08:00,7,0,7,0,0,0
2024-06-08 08:15,9,0,9,0,0,0
2024-06-08 08:30,14,0,14,0,0,0
2024-06-08 08:45,26,1,25,0,0,0
2024-06-08 09:00,15,0,15,0,0,0
2024-06-08 09:15,17,0,17,0,0,0
2024-06-08 09:30,33,0,33,0,0,0
2024-06-08 09:45,27,0,27,0,0,0
2024-06-08 10:00,35,0,35,0,0,0
2024-06-08 10:15,44,0,44,0,0,0
2024-06-08 10:30,41,0,41,0,0,0
2024-06-08 10:45,50,0,50,0,0,0
2024-06-08 11:00,45,0,45,0,0,0
2024-06-08 11:15,53,0,53,0,0,0
2024-06-08 11:30,44,0,44,0,0,0
2024-06-08 11:45,65,0,65,0,0,0
2024-06-08 12:00,42,3,39,0,0,0
2024-06-08 12:15,46,0,46,0,0,0
2024-06-08 12:30,61,0,61,0,0,0
2024-06-08 12:45,58,1,57,0,0,0
2024-06-08 13:00,57,0,57,0,0,0
2024-06-08 13:15,57,0,57,0,0,0
2024-06-08 13:30,78,8,70,0,0,0
2024-06-08 13:45,55,0,55,0,0,0
2024-06-08 14:00,68,0,68,0,0,0
2024-06-08 14:15,53,0,53,0,0,0
2024-06-08 14:30,55,0,55,0,0,0
2024-06-08 14:45,69,0,69,0,0,0
2024-06-08 15:00,57,0,57,0,0,0
2024-06-08 15:15,61,0,61,0,0,0
2024-06-08 15:30,39,0,39,0,0,0
2024-06-08 15:45,37,0,37,0,0,0
2024-06-08 16:00,62,0,62,0,0,0
2024-06-08 16:15,47,0,47,0,0,0
2024-06-08 16:30,43,0,43,0,0,0
2024-06-08 16:45,48,0,48,0,0,0
2024-06-08 17:00,50,2,48,0,0,0
2024-06-08 17:15,46,2,44,0,0,0
2024-06-08 17:30,40,0,40,0,0,0
2024-06-08 17:45,42,0,42,0,0,0
2024-06-08 18:00,43,0,43,0,0,0
2024-06-08 18:15,51,0,51,0,0,0
2024-06-08 18:30,38,0,38,0,0,0
2024-06-08 18:45,33,0,33,0,0,0
2024-06-08 19:00,33,0,33,0,0,0
2024-06-08 19:15,40,0,40,0,0,0
2024-06-08 19:30,32,0,32,0,0,0
2024-06-08 19:45,20,0,20,0,0,0
2024-06-08 20:00,27,0,27,0,0,0
2024-06-08 20:15,23,0,23,0,0,0
2024-06-08 20:30,34,0,34,0,0,0
2024-06-08 20:45,29,0,29,0,0,0
2024-06-08 21:00,32,0,32,0,0,0
2024-06-08 21:15,15,0,15,0,0,0
2024-06-08 21:30,7,0,7,0,0,0
2024-06-08 21:45,24,0,24,0,0,0
2024-06-08 22:00,18,0,18,0,0,0
2024-06-08 22:15,19,0,19,0,0,0
2024-06-08 22:30,18,0,18,0,0,0
2024-06-08 22:45,17,0,17,0,0,0
2024-06-08 23:00,22,0,22,0,0,0
2024-06-08 23:15,22,0,22,0,0,0
2024-06-08 23:30,15,0,15,0,0,0
2024-06-08 23:45,15,0,15,0,0,0
2024-06-09 00:00,15,0,15,0,0,0
2024-06-09 00:15,6,0,6,0,0,0
2024-06-09 00:30,18,0,18,0,0,0
2024-06-09 00:45,11,0,11,0,0,0
2024-06-09 01:00,8,0,8,0,0,0
2024-06-09 01:15,5,0,5,0,0,0
2024-06-09 01:30,7,0,7,0,0,0
2024-06-09 01:45,12,0,12,0,0,0
2024-06-09 02:00,2,0,2,0,0,0
2024-06-09 02:15,4,0,4,0,0,0
2024-06-09 02:30,9,0,9,0,0,0
2024-06-09 02:45,6,0,6,0,0,0
2024-06-09 03:00,2,0,2,0,0,0
2024-06-09 03:15,6,0,6,0,0,0
2024-06-09 03:30,3,0,3,0,0,0
2024-06-09 03:45,1,0,1,0,0,0
2024-06-09 04:00,2,0,2,0,0,0
2024-06-09 04:15,0,0,0,0,0,0
2024-06-09 04:30,0,0,0,0,0,0
2024-06-09 04:45,0,0,0,0,0,0
2024-06-09 05:00,1,0,1,0,0,0
2024-06-09 05:15,2,0,2,0,0,0
2024-06-09 05:30,4,0,4,0,0,0
2024-06-09 05:45,1,0,1,0,0,0
2024-06-09 06:00,0,0,0,0,0,0
2024-06-09 06:15,1,0,1,0,0,0
2024-06-09 06:30,0,0,0,0,0,0
2024-06-09 06:45,2,0,2,0,0,0
2024-06-09 07:00,0,0,0,0,0,0
2024-06-09 07:15,2,0,2,0,0,0
2024-06-09 07:30,3,0,3,0,0,0
2024-06-09 07:45,2,0,2,0,0,0
2024-06-09 08:00,0,0,0,0,0,0
2024-06-09 08:15,1,0,1,0,0,0
2024-06-09 08:30,8,0,8,0,0,0
2024-06-09 08:45,12,0,12,0,0,0
2024-06-09 09:00,3,0,3,0,0,0
2024-06-09 09:15,13,0,13,0,0,0
2024-06-09 09:30,19,0,19,0,0,0
2024-06-09 09:45,24,0,24,0,0,0
2024-06-09 10:00,15,0,15,0,0,0
2024-06-09 10:15,15,0,15,0,0,0
2024-06-09 10:30,31,0,31,0,0,0
2024-06-09 10:45,12,0,12,0,0,0
2024-06-09 11:00,23,0,23,0,0,0
2024-06-09 11:15,14,0,14,0,0,0
2024-06-09 11:30,13,0,13,0,0,0
2024-06-09 11:45,19,0,19,0,0,0
2024-06-09 12:00,30,0,30,0,0,0
2024-06-09 12:15,22,0,22,0,0,0
2024-06-09 12:30,30,0,30,0,0,0
2024-06-09 12:45,20,0,20,0,0,0
2024-06-09 13:00,33,0,33,0,0,0
2024-06-09 13:15,28,0,28,0,0,0
2024-06-09 13:30,26,0,26,0,0,0
2024-06-09 13:45,41,0,41,0,0,0
2024-06-09 14:00,36,0,36,0,0,0
2024-06-09 14:15,27,0,27,0,0,0
2024-06-09 14:30,32,0,32,0,0,0
2024-06-09 14:45,23,0,23,0,0,0
2024-06-09 15:00,33,0,33,0,0,0
2024-06-09 15:15,23,0,23,0,0,0
2024-06-09 15:30,32,0,32,0,0,0
2024-06-09 15:45,35,0,35,0,0,0
2024-06-09 16:00,28,0,28,0,0,0
2024-06-09 16:15,47,0,47,0,0,0
2024-06-09 16:30,25,0,25,0,0,0
2024-06-09 16:45,36,0,36,0,0,0
2024-06-09 17:00,27,0,27,0,0,0
2024-06-09 17:15,47,0,47,0,0,0
2024-06-09 17:30,35,0,35,0,0,0
2024-06-09 17:45,30,0,30,0,0,0
2024-06-09 18:00,20,0,20,0,0,0
2024-06-09 18:15,22,0,22,0,0,0
2024-06-09 18:30,19,0,19,0,0,0
2024-06-09 18:45,50,0,50,0,0,0
2024-06-09 19:00,36,0,36,0,0,0
2024-06-09 19:15,19,0,19,0,0,0
2024-06-09 19:30,23,0,23,0,0,0
2024-06-09 19:45,25,0,25,0,0,0
2024-06-09 20:00,24,0,24,0,0,0
2024-06-09 20:15,22,0,22,0,0,0
2024-06-09 20:30,30,0,30,0,0,0
2024-06-09 20:45,29,0,29,0,0,0
2024-06-09 21:00,26,0,26,0,0,0
2024-06-09 21:15,21,0,21,0,0,0
2024-06-09 21:30,7,0,7,0,0,0
2024-06-09 21:45,14,0,14,0,0,0
2024-06-09 22:00,13,0,13,0,0,0
2024-06-09 22:15,14,0,14,0,0,0
2024-06-09 22:30,11,0,11,0,0,0
2024-06-09 22:45,11,0,11,0,0,0
2024-06-09 23:00,8,0,8,0,0,0
2024-06-09 23:15,3,0,3,0,0,0
2024-06-09 23:30,5,0,5,0,0,0
2024-06-09 23:45,4,0,4,0,0,0
2024-06-10 00:00,1,0,1,0,0,0
2024-06-10 00:15,1,0,1,0,0,0
2024-06-10 00:30,3,0,3,0,0,0
2024-06-10 00:45,2,0,2,0,0,0
2024-06-10 01:00,0,0,0,0,0,0
2024-06-10 01:15,0,0,0,0,0,0
2024-06-10 01:30,2,0,2,0,0,0
2024-06-10 01:45,0,0,0,0,0,0
2024-06-10 02:00,0,0,0,0,0,0
2024-06-10 02:15,1,0,1,0,0,0
2024-06-10 02:30,0,0,0,0,0,0
2024-06-10 02:45,0,0,0,0,0,0
2024-06-10 03:00,0,0,0,0,0,0
2024-06-10 03:15,0,0,0,0,0,0
2024-06-10 03:30,0,0,0,0,0,0
2024-06-10 03:45,0,0,0,0,0,0
2024-06-10 04:00,0,0,0,0,0,0
2024-06-10 04:15,1,0,1,0,0,0
2024-06-10 04:30,1,0,1,0,0,0
2024-06-10 04:45,0,0,0,0,0,0
2024-06-10 05:00,0,0,0,0,0,0
2024-06-10 05:15,4,0,4,0,0,0
2024-06-10 05:30,9,0,9,0,0,0
2024-06-10 05:45,2,0,2,0,0,0
2024-06-10 06:00,6,0,6,0,0,0
2024-06-10 06:15,14,0,14,0,0,0
2024-06-10 06:30,7,0,7,0,0,0
2024-06-10 06:45,12,0,12,0,0,0
2024-06-10 07:00,23,0,23,0,0,0
2024-06-10 07:15,27,0,27,0,0,0
2024-06-10 07:30,14,0,14,0,0,0
2024-06-10 07:45,50,0,50,0,0,0
2024-06-10 08:00,35,0,35,0,0,0
2024-06-10 08:15,26,0,26,0,0,0
2024-06-10 08:30,25,0,25,0,0,0
2024-06-10 08:45,32,0,32,0,0,0
2024-06-10 09:00,24,0,24,0,0,0
2024-06-10 09:15,19,0,19,0,0,0
2024-06-10 09:30,13,0,13,0,0,0
2024-06-10 09:45,18,0,18,0,0,0
2024-06-10 10:00,12,0,12,0,0,0
2024-06-10 10:15,13,0,13,0,0,0
2024-06-10 10:30,6,0,6,0,0,0
2024-06-10 10:45,17,0,17,0,0,0
2024-06-10 11:00,17,0,17,0,0,0
2024-06-10 11:15,24,0,24,0,0,0
2024-06-10 11:30,13,0,13,0,0,0
2024-06-10 11:45,29,0,29,0,0,0
2024-06-10 12:00,22,0,22,0,0,0
2024-06-10 12:15,33,0,33,0,0,0
2024-06-10 12:30,40,0,40,0,0,0
2024-06-10 12:45,29,0,29,0,0,0
2024-06-10 13:00,37,0,37,0,0,0
2024-06-10 13:15,39,0,39,0,0,0
2024-06-10 13:30,25,0,25,0,0,0
2024-06-10 13:45,41,0,41,0,0,0
2024-06-10 14:00,41,0,41,0,0,0
2024-06-10 14:15,37,0,37,0,0,0
2024-06-10 14:30,33,0,33,0,0,0
2024-06-10 14:45,32,0,32,0,0,0
2024-06-10 15:00,40,0,40,0,0,0
2024-06-10 15:15,35,0,35,0,0,0
2024-06-10 15:30,36,0,36,0,0,0
2024-06-10 15:45,54,0,54,0,0,0
2024-06-10 16:00,42,0,42,0,0,0
2024-06-10 16:15,53,0,53,0,0,0
2024-06-10 16:30,55,0,55,0,0,0
2024-06-10 16:45,41,0,41,0,0,0
2024-06-10 17:00,61,0,61,0,0,0
2024-06-10 17:15,60,0,60,0,0,0
2024-06-10 17:30,59,0,59,0,0,0
2024-06-10 17:45,67,0,67,0,0,0
2024-06-10 18:00,67,0,67,0,0,0
2024-06-10 18:15,51,0,51,0,0,0
2024-06-10 18:30,59,0,59,0,0,0
2024-06-10 18:45,45,0,45,0,0,0
2024-06-10 19:00,35,0,35,0,0,0
2024-06-10 19:15,37,0,37,0,0,0
2024-06-10 19:30,30,0,30,0,0,0
2024-06-10 19:45,40,0,40,0,0,0
2024-06-10 20:00,27,0,27,0,0,0
2024-06-10 20:15,28,0,28,0,0,0
2024-06-10 20:30,16,0,16,0,0,0
2024-06-10 20:45,23,0,23,0,0,0
2024-06-10 21:00,11,0,11,0,0,0
2024-06-10 21:15,29,0,29,0,0,0
2024-06-10 21:30,18,0,18,0,0,0
2024-06-10 21:45,17,0,17,0,0,0
2024-06-10 22:00,19,0,19,0,0,0
2024-06-10 22:15,16,0,16,0,0,0
2024-06-10 22:30,11,0,11,0,0,0
2024-06-10 22:45,13,0,13,0,0,0
2024-06-10 23:00,2,0,2,0,0,0
2024-06-10 23:15,1,0,1,0,0,0
2024-06-10 23:30,2,0,2,0,0,0
2024-06-10 23:45,3,0,3,0,0,0
2024-06-11 00:00,5,0,5,0,0,0
2024-06-11 00:15,2,0,2,0,0,0
2024-06-11 00:30,1,0,1,0,0,0
2024-06-11 00:45,1,0,1,0,0,0
2024-06-11 01:00,1,0,1,0,0,0
2024-06-11 01:15,0,0,0,0,0,0
2024-06-11 01:30,0,0,0,0,0,0
2024-06-11 01:45,0,0,0,0,0,0
2024-06-11 02:00,1,0,1,0,0,0
2024-06-11 02:15,1,0,1,0,0,0
2024-06-11 02:30,2,0,2,0,0,0
2024-06-11 02:45,0,0,0,0,0,0
2024-06-11 03:00,0,0,0,0,0,0
2024-06-11 03:15,0,0,0,0,0,0
2024-06-11 03:30,0,0,0,0,0,0
2024-06-11 03:45,0,0,0,0,0,0
2024-06-11 04:00,0,0,0,0,0,0
2024-06-11 04:15,0,0,0,0,0,0
2024-06-11 04:30,0,0,0,0,0,0
2024-06-11 04:45,0,0,0,0,0,0
2024-06-11 05:00,0,0,0,0,0,0
2024-06-11 05:15,5,0,5,0,0,0
2024-06-11 05:30,5,0,5,0,0,0
2024-06-11 05:45,6,0,6,0,0,0
2024-06-11 06:00,4,0,4,0,0,0
2024-06-11 06:15,10,0,10,0,0,0
2024-06-11 06:30,9,0,9,0,0,0
2024-06-11 06:45,19,0,19,0,0,0
2024-06-11 07:00,23,0,23,0,0,0
2024-06-11 07:15,41,0,41,0,0,0
2024-06-11 07:30,51,0,51,0,0,0
2024-06-11 07:45,52,0,52,0,0,0
2024-06-11 08:00,40,0,40,0,0,0
2024-06-11 08:15,42,0,42,0,0,0
2024-06-11 08:30,37,0,37,0,0,0
2024-06-11 08:45,32,0,32,0,0,0
2024-06-11 09:00,31,0,31,0,0,0
2024-06-11 09:15,18,0,18,0,0,0
2024-06-11 09:30,29,0,29,0,0,0
2024-06-11 09:45,38,0,38,0,0,0
2024-06-11 10:00,21,0,21,0,0,0
2024-06-11 10:15,38,0,38,0,0,0
2024-06-11 10:30,19,0,19,0,0,0
2024-06-11 10:45,26,0,26,0,0,0
2024-06-11 11:00,26,0,26,0,0,0
2024-06-11 11:15,30,0,30,0,0,0
2024-06-11 11:30,35,0,35,0,0,0
2024-06-11 11:45,35,0,35,0,0,0
2024-06-11 12:00,35,0,35,0,0,0
2024-06-11 12:15,34,0,34,0,0,0
2024-06-11 12:30,48,0,48,0,0,0
2024-06-11 12:45,43,0,43,0,0,0
2024-06-11 13:00,57,0,57,0,0,0
2024-06-11 13:15,50,0,50,0,0,0
2024-06-11 13:30,39,0,39,0,0,0
2024-06-11 13:45,50,0,50,0,0,0
2024-06-11 14:00,66,0,66,0,0,0
2024-06-11 14:15,46,0,46,0,0,0
2024-06-11 14:30,44,0,44,0,0,0
2024-06-11 14:45,50,0,50,0,0,0
2024-06-11 15:00,47,0,47,0,0,0
2024-06-11 15:15,49,0,49,0,0,0
2024-06-11 15:30,63,0,63,0,0,0
2024-06-11 15:45,76,0,76,0,0,0
2024-06-11 16:00,85,0,85,0,0,0
2024-06-11 16:15,77,0,77,0,0,0
2024-06-11 16:30,62,0,62,0,0,0
2024-06-11 16:45,63,0,63,0,0,0
2024-06-11 17:00,69,3,66,0,0,0
2024-06-11 17:15,83,0,83,0,0,0
2024-06-11 17:30,69,0,69,0,0,0
2024-06-11 17:45,86,5,81,0,0,0
2024-06-11 18:00,92,4,88,0,0,0
2024-06-11 18:15,81,6,75,0,0,0
2024-06-11 18:30,63,2,61,0,0,0
2024-06-11 18:45,69,5,64,0,0,0
2024-06-11 19:00,56,10,46,0,0,0
2024-06-11 19:15,40,0,40,0,0,0
2024-06-11 19:30,51,0,51,0,0,0
2024-06-11 19:45,48,0,48,0,0,0
2024-06-11 20:00,38,0,38,0,0,0
2024-06-11 20:15,46,0,46,0,0,0
2024-06-11 20:30,24,0,24,0,0,0
2024-06-11 20:45,28,0,28,0,0,0
2024-06-11 21:00,22,0,22,0,0,0
2024-06-11 21:15,31,0,31,0,0,0
2024-06-11 21:30,19,0,19,0,0,0
2024-06-11 21:45,24,0,24,0,0,0
2024-06-11 22:00,22,1,21,0,0,0
2024-06-11 22:15,21,0,21,0,0,0
2024-06-11 22:30,19,0,19,0,0,0
2024-06-11 22:45,14,0,14,0,0,0
2024-06-11 23:00,10,1,9,0,0,0
2024-06-11 23:15,11,0,11,0,0,0
2024-06-11 23:30,13,0,13,0,0,0
2024-06-11 23:45,5,0,5,0,0,0
2024-06-12 00:00,12,0,12,0,0,0
2024-06-12 00:15,3,0,3,0,0,0
2024-06-12 00:30,3,0,3,0,0,0
2024-06-12 00:45,2,0,2,0,0,0
2024-06-12 01:00,1,0,1,0,0,0
2024-06-12 01:15,1,0,1,0,0,0
2024-06-12 01:30,1,0,1,0,0,0
2024-06-12 01:45,1,0,1,0,0,0
2024-06-12 02:00,0,0,0,0,0,0
2024-06-12 02:15,0,0,0,0,0,0
2024-06-12 02:30,1,0,1,0,0,0
2024-06-12 02:45,4,0,4,0,0,0
2024-06-12 03:00,0,0,0,0,0,0
2024-06-12 03:15,0,0,0,0,0,0
2024-06-12 03:30,1,0,1,0,0,0
2024-06-12 03:45,0,0,0,0,0,0
2024-06-12 04:00,0,0,0,0,0,0
2024-06-12 04:15,0,0,0,0,0,0
2024-06-12 04:30,2,0,2,0,0,0
2024-06-12 04:45,0,0,0,0,0,0
2024-06-12 05:00,1,0,1,0,0,0
2024-06-12 05:15,2,0,2,0,0,0
2024-06-12 05:30,8,0,8,0,0,0
2024-06-12 05:45,8,0,8,0,0,0
2024-06-12 06:00,3,0,3,0,0,0
2024-06-12 06:15,11,0,11,0,0,0
2024-06-12 06:30,9,0,9,0,0,0
2024-06-12 06:45,15,0,15,0,0,0
2024-06-12 07:00,22,0,22,0,0,0
2024-06-12 07:15,41,0,41,0,0,0
2024-06-12 07:30,39,0,39,0,0,0
2024-06-12 07:45,53,0,53,0,0,0
2024-06-12 08:00,35,0,35,0,0,0
2024-06-12 08:15,39,0,39,0,0,0
2024-06-12 08:30,27,0,27,0,0,0
2024-06-12 08:45,34,0,34,0,0,0
2024-06-12 09:00,35,0,35,0,0,0
2024-06-12 09:15,26,0,26,0,0,0
2024-06-12 09:30,18,0,18,0,0,0
2024-06-12 09:45,42,0,42,0,0,0
2024-06-12 10:00,28,0,28,0,0,0
2024-06-12 10:15,38,0,38,0,0,0
2024-06-12 10:30,39,0,39,0,0,0
2024-06-12 10:45,29,0,29,0,0,0
2024-06-12 11:00,44,0,44,0,0,0
2024-06-12 11:15,51,0,51,0,0,0
2024-06-12 11:30,43,0,43,0,0,0
2024-06-12 11:45,60,0,60,0,0,0
2024-06-12 12:00,45,0,45,0,0,0
2024-06-12 12:15,55,0,55,0,0,0
2024-06-12 12:30,66,0,66,0,0,0
2024-06-12 12:45,46,0,46,0,0,0
2024-06-12 13:00,97,41,56,0,0,0
2024-06-12 13:15,132,68,64,0,0,0
2024-06-12 13:30,104,63,41,0,0,0
2024-06-12 13:45,133,85,48,0,0,0
2024-06-12 14:00,136,66,70,0,0,0
2024-06-12 14:15,140,69,71,0,0,0
2024-06-12 14:30,123,68,55,0,0,0
2024-06-12 14:45,138,84,54,0,0,0
2024-06-12 15:00,152,75,77,0,0,0
2024-06-12 15:15,106,73,33,0,0,0
2024-06-12 15:30,125,59,66,0,0,0
2024-06-12 15:45,168,93,75,0,0,0
2024-06-12 16:00,158,94,64,0,0,0
2024-06-12 16:15,133,74,59,0,0,0
2024-06-12 16:30,152,96,56,0,0,0
2024-06-12 16:45,155,89,66,0,0,0
2024-06-12 17:00,150,80,70,0,0,0
2024-06-12 17:15,145,75,70,0,0,0
2024-06-12 17:30,165,98,67,0,0,0
2024-06-12 17:45,177,76,101,0,0,0
2024-06-12 18:00,120,60,60,0,0,0
2024-06-12 18:15,159,87,72,0,0,0
2024-06-12 18:30,105,57,48,0,0,0
2024-06-12 18:45,115,66,49,0,0,0
2024-06-12 19:00,99,43,56,0,0,0
2024-06-12 19:15,99,57,42,0,0,0
2024-06-12 19:30,97,50,47,0,0,0
2024-06-12 19:45,72,36,36,0,0,0
2024-06-12 20:00,73,28,45,0,0,0
2024-06-12 20:15,49,21,28,0,0,0
2024-06-12 20:30,52,21,31,0,0,0
2024-06-12 20:45,42,18,24,0,0,0
2024-06-12 21:00,46,22,24,0,0,0
2024-06-12 21:15,40,14,26,0,0,0
2024-06-12 21:30,46,27,19,0,0,0
2024-06-12 21:45,49,24,25,0,0,0
2024-06-12 22:00,46,22,24,0,0,0
2024-06-12 22:15,42,17,25,0,0,0
2024-06-12 22:30,48,22,26,0,0,0
2024-06-12 22:45,41,18,23,0,0,0
2024-06-12 23:00,44,17,27,0,0,0
2024-06-12 23:15,24,13,11,0,0,0
2024-06-12 23:30,27,18,9,0,0,0
2024-06-12 23:45,21,11,10,0,0,0
2024-06-13 00:00,20,5,15,0,0,0
2024-06-13 00:15,5,1,4,0,0,0
2024-06-13 00:30,15,8,7,0,0,0
2024-06-13 00:45,8,5,3,0,0,0
2024-06-13 01:00,4,1,3,0,0,0
2024-06-13 01:15,3,2,1,0,0,0
2024-06-13 01:30,9,2,7,0,0,0
2024-06-13 01:45,4,1,3,0,0,0
2024-06-13 02:00,7,0,7,0,0,0
2024-06-13 02:15,3,1,2,0,0,0
2024-06-13 02:30,1,0,1,0,0,0
2024-06-13 02:45,2,1,1,0,0,0
2024-06-13 03:00,5,1,4,0,0,0
2024-06-13 03:15,2,1,1,0,0,0
2024-06-13 03:30,3,0,3,0,0,0
2024-06-13 03:45,2,1,1,0,0,0
2024-06-13 04:00,1,0,1,0,0,0
2024-06-13 04:15,3,1,2,0,0,0
2024-06-13 04:30,2,1,1,0,0,0
2024-06-13 04:45,3,2,1,0,0,0
2024-06-13 05:00,1,1,0,0,0,0
2024-06-13 05:15,7,4,3,0,0,0
2024-06-13 05:30,11,7,4,0,0,0
2024-06-13 05:45,9,6,3,0,0,0
2024-06-13 06:00,16,12,4,0,0,0
2024-06-13 06:15,28,15,13,0,0,0
2024-06-13 06:30,32,22,10,0,0,0
2024-06-13 06:45,72,48,24,0,0,0
2024-06-13 07:00,59,37,22,0,0,0
2024-06-13 07:15,133,97,36,0,0,0
2024-06-13 07:30,236,187,49,0,0,0
2024-06-13 07:45,220,158,62,0,0,0
2024-06-13 08:00,168,122,46,0,0,0
2024-06-13 08:15,158,120,38,0,0,0
2024-06-13 08:30,137,117,20,0,0,0
2024-06-13 08:45,135,105,30,0,0,0
2024-06-13 09:00,111,90,21,0,0,0
2024-06-13 09:15,85,58,27,0,0,0
2024-06-13 09:30,123,98,25,0,0,0
2024-06-13 09:45,138,119,19,0,0,0
2024-06-13 10:00,104,82,22,0,0,0
2024-06-13 10:15,99,74,25,0,0,0
2024-06-13 10:30,104,74,30,0,0,0
2024-06-13 10:45,98,53,45,0,0,0
2024-06-13 11:00,88,59,29,0,0,0
2024-06-13 11:15,104,73,31,0,0,0
2024-06-13 11:30,117,78,39,0,0,0
2024-06-13 11:45,149,93,56,0,0,0
2024-06-13 12:00,123,80,43,0,0,0
2024-06-13 12:15,111,61,50,0,0,0
2024-06-13 12:30,108,58,50,0,0,0
2024-06-13 12:45,115,69,46,0,0,0
2024-06-13 13:00,120,59,61,0,0,0
2024-06-13 13:15,115,59,56,0,0,0
2024-06-13 13:30,120,78,42,0,0,0
2024-06-13 13:45,145,86,59,0,0,0
2024-06-13 14:00,137,73,64,0,0,0
2024-06-13 14:15,123,70,53,0,0,0
2024-06-13 14:30,118,63,55,0,0,0
2024-06-13 14:45,142,90,52,0,0,0
2024-06-13 15:00,147,84,63,0,0,0
2024-06-13 15:15,117,71,46,0,0,0
2024-06-13 15:30,118,63,55,0,0,0
2024-06-13 15:45,162,81,81,0,0,0
2024-06-13 16:00,168,96,72,0,0,0
2024-06-13 16:15,165,90,75,0,0,0
2024-06-13 16:30,163,108,55,0,0,0
2024-06-13 16:45,185,108,77,0,0,0
2024-06-13 17:00,172,82,90,0,0,0
2024-06-13 17:15,179,88,91,0,0,0
2024-06-13 17:30,158,96,62,0,0,0
2024-06-13 17:45,191,113,78,0,0,0
2024-06-13 18:00,188,89,99,0,0,0
2024-06-13 18:15,154,79,75,0,0,0
2024-06-13 18:30,118,57,61,0,0,0
2024-06-13 18:45,161,94,67,0,0,0
2024-06-13 19:00,161,95,66,0,0,0
2024-06-13 19:15,113,64,49,0,0,0
2024-06-13 19:30,85,36,49,0,0,0
2024-06-13 19:45,87,36,51,0,0,0
2024-06-13 20:00,79,32,47,0,0,0
2024-06-13 20:15,64,29,35,0,0,0
2024-06-13 20:30,58,28,30,0,0,0
2024-06-13 20:45,73,32,41,0,0,0
2024-06-13 21:00,48,24,24,0,0,0
2024-06-13 21:15,47,14,33,0,0,0
2024-06-13 21:30,65,22,43,0,0,0
2024-06-13 21:45,69,29,40,0,0,0
2024-06-13 22:00,74,39,35,0,0,0
2024-06-13 22:15,49,15,34,0,0,0
2024-06-13 22:30,42,19,23,0,0,0
2024-06-13 22:45,35,10,25,0,0,0
2024-06-13 23:00,41,15,26,0,0,0
2024-06-13 23:15,37,19,18,0,0,0
2024-06-13 23:30,20,5,15,0,0,0
2024-06-13 23:45,22,8,14,0,0,0
2024-06-14 00:00,16,5,11,0,0,0
2024-06-14 00:15,13,5,8,0,0,0
2024-06-14 00:30,20,13,7,0,0,0
2024-06-14 00:45,12,4,8,0,0,0
2024-06-14 01:00,6,2,4,0,0,0
2024-06-14 01:15,2,0,2,0,0,0
2024-06-14 01:30,3,1,2,0,0,0
2024-06-14 01:45,6,4,2,0,0,0
2024-06-14 02:00,7,1,6,0,0,0
2024-06-14 02:15,2,1,1,0,0,0
2024-06-14 02:30,1,0,1,0,0,0
2024-06-14 02:45,1,0,1,0,0,0
2024-06-14 03:00,2,0,2,0,0,0
2024-06-14 03:15,2,0,2,0,0,0
2024-06-14 03:30,1,1,0,0,0,0
2024-06-14 03:45,2,1,1,0,0,0
2024-06-14 04:00,1,1,0,0,0,0
2024-06-14 04:15,1,0,1,0,0,0
2024-06-14 04:30,2,2,0,0,0,0
2024-06-14 04:45,1,1,0,0,0,0
2024-06-14 05:00,1,1,0,0,0,0
2024-06-14 05:15,8,5,3,0,0,0
2024-06-14 05:30,16,11,5,0,0,0
2024-06-14 05:45,11,6,5,0,0,0
2024-06-14 06:00,16,13,3,0,0,0
2024-06-14 06:15,28,18,10,0,0,0
2024-06-14 06:30,33,22,11,0,0,0
2024-06-14 06:45,43,31,12,0,0,0
2024-06-14 07:00,48,32,16,0,0,0
2024-06-14 07:15,102,73,29,0,0,0
2024-06-14 07:30,216,174,42,0,0,0
2024-06-14 07:45,159,116,43,0,0,0
2024-06-14 08:00,136,109,27,0,0,0
2024-06-14 08:15,121,97,24,0,0,0
2024-06-14 08:30,123,98,25,0,0,0
2024-06-14 08:45,136,113,23,0,0,0
2024-06-14 09:00,98,74,24,0,0,0
2024-06-14 09:15,91,69,22,0,0,0
2024-06-14 09:30,87,67,20,0,0,0
2024-06-14 09:45,119,95,24,0,0,0
2024-06-14 10:00,97,77,20,0,0,0
2024-06-14 10:15,85,65,20,0,0,0
2024-06-14 10:30,97,72,25,0,0,0
2024-06-14 10:45,97,63,34,0,0,0
2024-06-14 11:00,94,64,30,0,0,0
2024-06-14 11:15,105,70,35,0,0,0
2024-06-14 11:30,95,46,49,0,0,0
2024-06-14 11:45,121,77,44,0,0,0
2024-06-14 12:00,113,63,50,0,0,0
2024-06-14 12:15,119,67,52,0,0,0
2024-06-14 12:30,135,69,66,0,0,0
2024-06-14 12:45,117,72,45,0,0,0
2024-06-14 13:00,142,63,79,0,0,0
2024-06-14 13:15,121,58,63,0,0,0
2024-06-14 13:30,113,64,49,0,0,0
2024-06-14 13:45,179,94,85,0,0,0
2024-06-14 14:00,121,53,68,0,0,0
2024-06-14 14:15,121,60,61,0,0,0
2024-06-14 14:30,104,66,38,0,0,0
2024-06-14 14:45,123,64,59,0,0,0
2024-06-14 15:00,142,83,59,0,0,0
2024-06-14 15:15,127,70,57,0,0,0
2024-06-14 15:30,138,72,66,0,0,0
2024-06-14 15:45,143,78,65,0,0,0
2024-06-14 16:00,129,72,57,0,0,0
2024-06-14 16:15,104,60,44,0,0,0
2024-06-14 16:30,116,68,48,0,0,0
2024-06-14 16:45,131,78,53,0,0,0
2024-06-14 17:00,128,72,56,0,0,0
2024-06-14 17:15,111,58,53,0,0,0
2024-06-14 17:30,121,69,52,0,0,0
2024-06-14 17:45,143,89,54,0,0,0
2024-06-14 18:00,111,58,53,0,0,0
2024-06-14 18:15,105,63,42,0,0,0
2024-06-14 18:30,130,78,52,0,0,0
2024-06-14 18:45,131,76,55,0,0,0
2024-06-14 19:00,125,69,56,0,0,0
2024-06-14 19:15,115,67,48,0,0,0
2024-06-14 19:30,119,83,36,0,0,0
2024-06-14 19:45,133,92,41,0,0,0
2024-06-14 20:00,113,69,44,0,0,0
2024-06-14 20:15,109,66,43,0,0,0
2024-06-14 20:30,89,41,48,0,0,0
2024-06-14 20:45,68,42,26,0,0,0
2024-06-14 21:00,40,24,16,0,0,0
2024-06-14 21:15,48,26,22,0,0,0
2024-06-14 21:30,41,18,23,0,0,0
2024-06-14 21:45,34,17,17,0,0,0
2024-06-14 22:00,35,18,17,0,0,0
2024-06-14 22:15,26,13,13,0,0,0
2024-06-14 22:30,16,6,10,0,0,0
2024-06-14 22:45,34,8,26,0,0,0
2024-06-14 23:00,68,21,47,0,0,0
2024-06-14 23:15,117,48,69,0,0,0
2024-06-14 23:30,111,52,59,0,0,0
2024-06-14 23:45,52,20,32,0,0,0
2024-06-15 00:00,67,29,38,0,0,0
2024-06-15 00:15,45,15,30,0,0,0
2024-06-15 00:30,39,24,15,0,0,0
2024-06-15 00:45,36,17,19,0,0,0
2024-06-15 01:00,31,6,25,0,0,0
2024-06-15 01:15,23,7,16,0,0,0
2024-06-15 01:30,29,10,19,0,0,0
2024-06-15 01:45,24,8,16,0,0,0
2024-06-15 02:00,15,3,12,0,0,0
2024-06-15 02:15,8,2,6,0,0,0
2024-06-15 02:30,10,1,9,0,0,0
2024-06-15 02:45,18,6,12,0,0,0
2024-06-15 03:00,9,2,7,0,0,0
2024-06-15 03:15,8,1,7,0,0,0
2024-06-15 03:30,11,1,10,0,0,0
2024-06-15 03:45,14,4,10,0,0,0
2024-06-15 04:00,3,1,2,0,0,0
2024-06-15 04:15,3,1,2,0,0,0
2024-06-15 04:30,1,1,0,0,0,0
2024-06-15 04:45,2,2,0,0,0,0
2024-06-15 05:00,4,2,2,0,0,0
2024-06-15 05:15,7,4,3,0,0,0
2024-06-15 05:30,11,7,4,0,0,0
2024-06-15 05:45,9,4,5,0,0,0
2024-06-15 06:00,4,0,4,0,0,0
2024-06-15 06:15,5,4,1,0,0,0
2024-06-15 06:30,9,9,0,0,0,0
2024-06-15 06:45,12,8,4,0,0,0
2024-06-15 07:00,8,6,2,0,0,0
2024-06-15 07:15,21,9,12,0,0,0
2024-06-15 07:30,10,3,7,0,0,0
2024-06-15 07:45,18,12,6,0,0,0
2024-06-15 08:00,21,14,7,0,0,0
2024-06-15 08:15,22,17,5,0,0,0
2024-06-15 08:30,16,8,8,0,0,0
2024-06-15 08:45,37,27,10,0,0,0
2024-06-15 09:00,28,21,7,0,0,0
2024-06-15 09:15,25,19,6,0,0,0
2024-06-15 09:30,44,30,14,0,0,0
2024-06-15 09:45,74,60,14,0,0,0
2024-06-15 10:00,82,60,22,0,0,0
2024-06-15 10:15,91,60,31,0,0,0
2024-06-15 10:30,95,69,26,0,0,0
2024-06-15 10:45,106,73,33,0,0,0
2024-06-15 11:00,123,63,60,0,0,0
2024-06-15 11:15,122,86,36,0,0,0
2024-06-15 11:30,109,62,47,0,0,0
2024-06-15 11:45,125,72,53,0,0,0
2024-06-15 12:00,97,53,44,0,0,0
2024-06-15 12:15,116,59,57,0,0,0
2024-06-15 12:30,120,64,56,0,0,0
2024-06-15 12:45,169,95,74,0,0,0
2024-06-15 13:00,142,79,63,0,0,0
2024-06-15 13:15,149,81,68,0,0,0
2024-06-15 13:30,153,78,75,0,0,0
2024-06-15 13:45,139,70,69,0,0,0
2024-06-15 14:00,150,82,68,0,0,0
2024-06-15 14:15,153,82,71,0,0,0
2024-06-15 14:30,138,65,73,0,0,0
2024-06-15 14:45,168,101,67,0,0,0
2024-06-15 15:00,153,95,58,0,0,0
2024-06-15 15:15,152,102,50,0,0,0
2024-06-15 15:30,150,93,57,0,0,0
2024-06-15 15:45,161,93,68,0,0,0
2024-06-15 16:00,166,93,73,0,0,0
2024-06-15 16:15,145,93,52,0,0,0
2024-06-15 16:30,139,90,49,0,0,0
2024-06-15 16:45,105,65,40,0,0,0
2024-06-15 17:00,162,97,65,0,0,0
2024-06-15 17:15,147,101,46,0,0,0
2024-06-15 17:30,142,84,58,0,0,0
2024-06-15 17:45,138,79,59,0,0,0
2024-06-15 18:00,154,89,65,0,0,0
2024-06-15 18:15,132,63,69,0,0,0
2024-06-15 18:30,123,64,59,0,0,0
2024-06-15 18:45,111,77,34,0,0,0
2024-06-15 19:00,110,66,44,0,0,0
2024-06-15 19:15,86,55,31,0,0,0
2024-06-15 19:30,77,49,28,0,0,0
2024-06-15 19:45,72,42,30,0,0,0
2024-06-15 20:00,59,32,27,0,0,0
2024-06-15 20:15,64,31,33,0,0,0
2024-06-15 20:30,51,35,16,0,0,0
2024-06-15 20:45,61,35,26,0,0,0
2024-06-15 21:00,35,13,22,0,0,0
2024-06-15 21:15,35,21,14,0,0,0
2024-06-15 21:30,37,26,11,0,0,0
2024-06-15 21:45,52,35,17,0,0,0
2024-06-15 22:00,39,23,16,0,0,0
2024-06-15 22:15,46,34,12,0,0,0
2024-06-15 22:30,34,20,14,0,0,0
2024-06-15 22:45,40,17,23,0,0,0
2024-06-15 23:00,40,23,17,0,0,0
2024-06-15 23:15,32,23,9,0,0,0
2024-06-15 23:30,36,22,14,0,0,0
2024-06-15 23:45,39,27,12,0,0,0
2024-06-16 00:00,37,22,15,0,0,0
2024-06-16 00:15,20,12,8,0,0,0
2024-06-16 00:30,31,23,8,0,0,0
2024-06-16 00:45,36,22,14,0,0,0
2024-06-16 01:00,22,11,11,0,0,0
2024-06-16 01:15,8,0,8,0,0,0
2024-06-16 01:30,10,0,10,0,0,0
2024-06-16 01:45,12,0,12,0,0,0
2024-06-16 02:00,10,0,10,0,0,0
2024-06-16 02:15,14,0,14,0,0,0
2024-06-16 02:30,12,0,12,0,0,0
2024-06-16 02:45,8,0,8,0,0,0
2024-06-16 03:00,2,0,2,0,0,0
2024-06-16 03:15,6,0,6,0,0,0
2024-06-16 03:30,6,0,6,0,0,0
2024-06-16 03:45,2,0,2,0,0,0
2024-06-16 04:00,3,0,3,0,0,0
2024-06-16 04:15,0,0,0,0,0,0
2024-06-16 04:30,0,0,0,0,0,0
2024-06-16 04:45,1,0,1,0,0,0
2024-06-16 05:00,1,0,1,0,0,0
2024-06-16 05:15,2,1,1,0,0,0
2024-06-16 05:30,8,2,6,0,0,0
2024-06-16 05:45,5,1,4,0,0,0
2024-06-16 06:00,2,2,0,0,0,0
2024-06-16 06:15,4,3,1,0,0,0
2024-06-16 06:30,3,0,3,0,0,0
2024-06-16 06:45,5,3,2,0,0,0
2024-06-16 07:00,4,3,1,0,0,0
2024-06-16 07:15,4,4,0,0,0,0
2024-06-16 07:30,9,8,1,0,0,0
2024-06-16 07:45,7,5,2,0,0,0
2024-06-16 08:00,8,7,1,0,0,0
2024-06-16 08:15,5,4,1,0,0,0
2024-06-16 08:30,16,12,4,0,0,0
2024-06-16 08:45,14,12,2,0,0,0
2024-06-16 09:00,22,17,5,0,0,0
2024-06-16 09:15,17,11,6,0,0,0
2024-06-16 09:30,28,19,9,0,0,0
2024-06-16 09:45,40,35,5,0,0,0
2024-06-16 10:00,46,31,15,0,0,0
2024-06-16 10:15,40,28,12,0,0,0
2024-06-16 10:30,48,29,19,0,0,0
2024-06-16 10:45,59,41,18,0,0,0
2024-06-16 11:00,32,17,15,0,0,0
2024-06-16 11:15,42,29,13,0,0,0
2024-06-16 11:30,55,32,23,0,0,0
2024-06-16 11:45,54,27,27,0,0,0
2024-06-16 12:00,41,20,21,0,0,0
2024-06-16 12:15,36,21,15,0,0,0
2024-06-16 12:30,54,26,28,0,0,0
2024-06-16 12:45,54,23,31,0,0,0
2024-06-16 13:00,66,43,23,0,0,0
2024-06-16 13:15,65,45,20,0,0,0
2024-06-16 13:30,65,42,23,0,0,0
2024-06-16 13:45,46,33,13,0,0,0
2024-06-16 14:00,49,30,19,0,0,0
2024-06-16 14:15,57,37,20,0,0,0
2024-06-16 14:30,49,27,22,0,0,0
2024-06-16 14:45,54,26,28,0,0,0
2024-06-16 15:00,45,19,26,0,0,0
2024-06-16 15:15,47,32,15,0,0,0
2024-06-16 15:30,36,27,9,0,0,0
2024-06-16 15:45,51,36,15,0,0,0
2024-06-16 16:00,48,27,21,0,0,0
2024-06-16 16:15,43,28,15,0,0,0
2024-06-16 16:30,71,41,30,0,0,0
2024-06-16 16:45,50,28,22,0,0,0
2024-06-16 17:00,40,24,16,0,0,0
2024-06-16 17:15,52,28,24,0,0,0
2024-06-16 17:30,41,25,16,0,0,0
2024-06-16 17:45,61,42,19,0,0,0
2024-06-16 18:00,47,21,26,0,0,0
2024-06-16 18:15,44,25,19,0,0,0
2024-06-16 18:30,53,33,20,0,0,0
2024-06-16 18:45,47,25,22,0,0,0
2024-06-16 19:00,48,26,22,0,0,0
2024-06-16 19:15,47,26,21,0,0,0
2024-06-16 19:30,47,29,18,0,0,0
2024-06-16 19:45,31,14,17,0,0,0
2024-06-16 20:00,25,11,14,0,0,0
2024-06-16 20:15,27,15,12,0,0,0
2024-06-16 20:30,28,13,15,0,0,0
2024-06-16 20:45,25,12,13,0,0,0
2024-06-16 21:00,31,16,15,0,0,0
2024-06-16 21:15,28,14,14,0,0,0
2024-06-16 21:30,16,7,9,0,0,0
2024-06-16 21:45,20,12,8,0,0,0
2024-06-16 22:00,22,8,14,0,0,0
2024-06-16 22:15,30,16,14,0,0,0
2024-06-16 22:30,17,11,6,0,0,0
2024-06-16 22:45,37,15,22,0,0,0
2024-06-16 23:00,25,13,12,0,0,0
2024-06-16 23:15,5,2,3,0,0,0
2024-06-16 23:30,10,6,4,0,0,0
2024-06-16 23:45,14,5,9,0,0,0
2024-06-17 00:00,2,1,1,0,0,0
2024-06-17 00:15,4,1,3,0,0,0
2024-06-17 00:30,0,0,0,0,0,0
2024-06-17 00:45,0,0,0,0,0,0
2024-06-17 01:00,2,1,1,0,0,0
2024-06-17 01:15,1,0,1,0,0,0
2024-06-17 01:30,2,2,0,0,0,0
2024-06-17 01:45,2,2,0,0,0,0
2024-06-17 02:00,1,0,1,0,0,0
2024-06-17 02:15,2,0,2,0,0,0
2024-06-17 02:30,0,0,0,0,0,0
2024-06-17 02:45,0,0,0,0,0,0
2024-06-17 03:00,0,0,0,0,0,0
2024-06-17 03:15,0,0,0,0,0,0
2024-06-17 03:30,1,0,1,0,0,0
2024-06-17 03:45,3,1,2,0,0,0
2024-06-17 04:00,1,1,0,0,0,0
2024-06-17 04:15,0,0,0,0,0,0
2024-06-17 04:30,1,1,0,0,0,0
2024-06-17 04:45,3,2,1,0,0,0
2024-06-17 05:00,5,1,4,0,0,0
2024-06-17 05:15,6,3,3,0,0,0
2024-06-17 05:30,14,5,9,0,0,0
2024-06-17 05:45,12,7,5,0,0,0
2024-06-17 06:00,18,14,4,0,0,0
2024-06-17 06:15,35,20,15,0,0,0
2024-06-17 06:30,37,27,10,0,0,0
2024-06-17 06:45,56,40,16,0,0,0
2024-06-17 07:00,66,42,24,0,0,0
2024-06-17 07:15,112,85,27,0,0,0
2024-06-17 07:30,216,171,45,0,0,0
2024-06-17 07:45,212,147,65,0,0,0
2024-06-17 08:00,134,114,20,0,0,0
2024-06-17 08:15,151,111,40,0,0,0
2024-06-17 08:30,134,94,40,0,0,0
2024-06-17 08:45,154,124,30,0,0,0
2024-06-17 09:00,118,88,30,0,0,0
2024-06-17 09:15,87,70,17,0,0,0
2024-06-17 09:30,103,74,29,0,0,0
2024-06-17 09:45,147,122,25,0,0,0
2024-06-17 10:00,103,86,17,0,0,0
2024-06-17 10:15,83,52,31,0,0,0
2024-06-17 10:30,102,67,35,0,0,0
2024-06-17 10:45,112,78,34,0,0,0
2024-06-17 11:00,74,47,27,0,0,0
2024-06-17 11:15,97,68,29,0,0,0
2024-06-17 11:30,98,62,36,0,0,0
2024-06-17 11:45,122,76,46,0,0,0
2024-06-17 12:00,88,60,28,0,0,0
2024-06-17 12:15,89,51,38,0,0,0
2024-06-17 12:30,93,46,47,0,0,0
2024-06-17 12:45,110,57,53,0,0,0
2024-06-17 13:00,130,70,60,0,0,0
2024-06-17 13:15,99,49,50,0,0,0
2024-06-17 13:30,78,52,26,0,0,0
2024-06-17 13:45,112,62,50,0,0,0
2024-06-17 14:00,100,63,37,0,0,0
2024-06-17 14:15,116,60,56,0,0,0
2024-06-17 14:30,85,46,39,0,0,0
2024-06-17 14:45,122,78,44,0,0,0
2024-06-17 15:00,105,54,51,0,0,0
2024-06-17 15:15,117,67,50,0,0,0
2024-06-17 15:30,128,66,62,0,0,0
2024-06-17 15:45,122,73,49,0,0,0
2024-06-17 16:00,156,89,67,0,0,0
2024-06-17 16:15,166,84,82,0,0,0
2024-06-17 16:30,193,102,91,0,0,0
2024-06-17 16:45,167,99,68,0,0,0
2024-06-17 17:00,157,81,76,0,0,0
2024-06-17 17:15,129,66,63,0,0,0
2024-06-17 17:30,150,74,76,0,0,0
2024-06-17 17:45,135,75,60,0,0,0
2024-06-17 18:00,137,58,79,0,0,0
2024-06-17 18:15,143,83,60,0,0,0
2024-06-17 18:30,114,51,63,0,0,0
2024-06-17 18:45,117,61,56,0,0,0
2024-06-17 19:00,84,38,46,0,0,0
2024-06-17 19:15,71,39,32,0,0,0
2024-06-17 19:30,92,50,42,0,0,0
2024-06-17 19:45,99,46,53,0,0,0
2024-06-17 20:00,65,28,37,0,0,0
2024-06-17 20:15,53,26,27,0,0,0
2024-06-17 20:30,55,21,34,0,0,0
2024-06-17 20:45,58,21,37,0,0,0
2024-06-17 21:00,51,25,26,0,0,0
2024-06-17 21:15,40,12,28,0,0,0
2024-06-17 21:30,41,20,21,0,0,0
2024-06-17 21:45,40,14,26,0,0,0
2024-06-17 22:00,46,21,25,0,0,0
2024-06-17 22:15,42,19,23,0,0,0
2024-06-17 22:30,29,12,17,0,0,0
2024-06-17 22:45,22,8,14,0,0,0
2024-06-17 23:00,24,3,21,0,0,0
2024-06-17 23:15,19,11,8,0,0,0
2024-06-17 23:30,22,8,14,0,0,0
2024-06-17 23:45,6,1,5,0,0,0
2024-06-18 00:00,13,3,10,0,0,0
2024-06-18 00:15,10,7,3,0,0,0
2024-06-18 00:30,7,3,4,0,0,0
2024-06-18 00:45,6,1,5,0,0,0
2024-06-18 01:00,5,1,4,0,0,0
2024-06-18 01:15,3,0,3,0,0,0
2024-06-18 01:30,0,0,0,0,0,0
2024-06-18 01:45,1,0,1,0,0,0
2024-06-18 02:00,1,1,0,0,0,0
2024-06-18 02:15,1,0,1,0,0,0
2024-06-18 02:30,5,2,3,0,0,0
2024-06-18 02:45,2,0,2,0,0,0
2024-06-18 03:00,0,0,0,0,0,0
2024-06-18 03:15,0,0,0,0,0,0
2024-06-18 03:30,0,0,0,0,0,0
2024-06-18 03:45,0,0,0,0,0,0
2024-06-18 04:00,0,0,0,0,0,0
2024-06-18 04:15,2,1,1,0,0,0
2024-06-18 04:30,1,0,1,0,0,0
2024-06-18 04:45,3,3,0,0,0,0
2024-06-18 05:00,2,2,0,0,0,0
2024-06-18 05:15,4,3,1,0,0,0
2024-06-18 05:30,14,7,7,0,0,0
2024-06-18 05:45,12,6,6,0,0,0
2024-06-18 06:00,18,15,3,0,0,0
2024-06-18 06:15,30,20,10,0,0,0
2024-06-18 06:30,47,35,12,0,0,0
2024-06-18 06:45,53,33,20,0,0,0
2024-06-18 07:00,66,46,20,0,0,0
2024-06-18 07:15,141,103,38,0,0,0
2024-06-18 07:30,205,166,39,0,0,0
2024-06-18 07:45,234,174,60,0,0,0
2024-06-18 08:00,152,120,32,0,0,0
2024-06-18 08:15,162,118,44,0,0,0
2024-06-18 08:30,122,97,25,0,0,0
2024-06-18 08:45,158,126,32,0,0,0
2024-06-18 09:00,97,84,13,0,0,0
2024-06-18 09:15,84,63,21,0,0,0
2024-06-18 09:30,110,82,28,0,0,0
2024-06-18 09:45,134,106,28,0,0,0
2024-06-18 10:00,102,80,22,0,0,0
2024-06-18 10:15,83,53,30,0,0,0
2024-06-18 10:30,98,67,31,0,0,0
2024-06-18 10:45,91,59,32,0,0,0
2024-06-18 11:00,77,42,35,0,0,0
2024-06-18 11:15,116,83,33,0,0,0
2024-06-18 11:30,104,65,39,0,0,0
2024-06-18 11:45,128,82,46,0,0,0
2024-06-18 12:00,118,71,47,0,0,0
2024-06-18 12:15,95,66,29,0,0,0
2024-06-18 12:30,97,52,45,0,0,0
2024-06-18 12:45,106,65,41,0,0,0
2024-06-18 13:00,121,64,57,0,0,0
2024-06-18 13:15,118,66,52,0,0,0
2024-06-18 13:30,88,47,41,0,0,0
2024-06-18 13:45,133,60,73,0,0,0
2024-06-18 14:00,140,59,81,0,0,0
2024-06-18 14:15,108,64,44,0,0,0
2024-06-18 14:30,114,65,49,0,0,0
2024-06-18 14:45,132,82,50,0,0,0
2024-06-18 15:00,117,62,55,0,0,0
2024-06-18 15:15,119,56,63,0,0,0
2024-06-18 15:30,101,54,47,0,0,0
2024-06-18 15:45,129,64,65,0,0,0
2024-06-18 16:00,134,70,64,0,0,0
2024-06-18 16:15,100,49,51,0,0,0
2024-06-18 16:30,102,58,44,0,0,0
2024-06-18 16:45,111,56,55,0,0,0
2024-06-18 17:00,105,54,51,0,0,0
2024-06-18 17:15,118,43,75,0,0,0
2024-06-18 17:30,104,50,54,0,0,0
2024-06-18 17:45,133,64,69,0,0,0
2024-06-18 18:00,127,57,70,0,0,0
2024-06-18 18:15,123,63,60,0,0,0
2024-06-18 18:30,94,40,54,0,0,0
2024-06-18 18:45,82,33,49,0,0,0
2024-06-18 19:00,76,27,49,0,0,0
2024-06-18 19:15,60,23,37,0,0,0
2024-06-18 19:30,68,36,32,0,0,0
2024-06-18 19:45,59,27,32,0,0,0
2024-06-18 20:00,69,37,32,0,0,0
2024-06-18 20:15,54,21,33,0,0,0
2024-06-18 20:30,49,19,30,0,0,0
2024-06-18 20:45,29,10,19,0,0,0
2024-06-18 21:00,37,18,19,0,0,0
2024-06-18 21:15,25,15,10,0,0,0
2024-06-18 21:30,35,11,24,0,0,0
2024-06-18 21:45,43,21,22,0,0,0
2024-06-18 22:00,37,19,18,0,0,0
2024-06-18 22:15,35,14,21,0,0,0
2024-06-18 22:30,31,12,19,0,0,0
2024-06-18 22:45,17,7,10,0,0,0
2024-06-18 23:00,15,10,5,0,0,0
2024-06-18 23:15,14,4,10,0,0,0
2024-06-18 23:30,8,2,6,0,0,0
2024-06-18 23:45,13,4,9,0,0,0
2024-06-19 00:00,8,3,5,0,0,0
2024-06-19 00:15,2,0,2,0,0,0
2024-06-19 00:30,4,1,3,0,0,0
2024-06-19 00:45,0,0,0,0,0,0
2024-06-19 01:00,8,1,7,0,0,0
2024-06-19 01:15,3,1,2,0,0,0
2024-06-19 01:30,1,0,1,0,0,0
2024-06-19 01:45,1,0,1,0,0,0
2024-06-19 02:00,1,1,0,0,0,0
2024-06-19 02:15,1,0,1,0,0,0
2024-06-19 02:30,1,1,0,0,0,0
2024-06-19 02:45,0,0,0,0,0,0
2024-06-19 03:00,0,0,0,0,0,0
2024-06-19 03:15,3,2,1,0,0,0
2024-06-19 03:30,1,1,0,0,0,0
2024-06-19 03:45,0,0,0,0,0,0
2024-06-19 04:00,0,0,0,0,0,0
2024-06-19 04:15,3,3,0,0,0,0
2024-06-19 04:30,0,0,0,0,0,0
2024-06-19 04:45,2,1,1,0,0,0
2024-06-19 05:00,2,2,0,0,0,0
2024-06-19 05:15,7,4,3,0,0,0
2024-06-19 05:30,11,5,6,0,0,0
2024-06-19 05:45,19,11,8,0,0,0
2024-06-19 06:00,14,9,5,0,0,0
2024-06-19 06:15,37,23,14,0,0,0
2024-06-19 06:30,53,32,21,0,0,0
2024-06-19 06:45,60,39,21,0,0,0
2024-06-19 07:00,67,43,24,0,0,0
2024-06-19 07:15,137,99,38,0,0,0
2024-06-19 07:30,227,182,45,0,0,0
2024-06-19 07:45,251,176,75,0,0,0
2024-06-19 08:00,158,117,41,0,0,0
2024-06-19 08:15,154,113,41,0,0,0
2024-06-19 08:30,116,92,24,0,0,0
2024-06-19 08:45,149,118,31,0,0,0
2024-06-19 09:00,117,88,29,0,0,0
2024-06-19 09:15,104,81,23,0,0,0
2024-06-19 09:30,119,101,18,0,0,0
2024-06-19 09:45,179,149,30,0,0,0
2024-06-19 10:00,132,110,22,0,0,0
2024-06-19 10:15,103,70,33,0,0,0
2024-06-19 10:30,129,95,34,0,0,0
2024-06-19 10:45,142,99,43,0,0,0
2024-06-19 11:00,116,81,35,0,0,0
2024-06-19 11:15,120,89,31,0,0,0
2024-06-19 11:30,121,75,46,0,0,0
2024-06-19 11:45,162,114,48,0,0,0
2024-06-19 12:00,145,86,59,0,0,0
2024-06-19 12:15,115,82,33,0,0,0
2024-06-19 12:30,161,80,81,0,0,0
2024-06-19 12:45,149,80,69,0,0,0
2024-06-19 13:00,158,76,82,0,0,0
2024-06-19 13:15,142,70,72,0,0,0
2024-06-19 13:30,120,64,56,0,0,0
2024-06-19 13:45,178,85,93,0,0,0
2024-06-19 14:00,151,82,69,0,0,0
2024-06-19 14:15,143,80,63,0,0,0
2024-06-19 14:30,130,69,61,0,0,0
2024-06-19 14:45,150,84,66,0,0,0
2024-06-19 15:00,154,80,74,0,0,0
2024-06-19 15:15,145,83,62,0,0,0
2024-06-19 15:30,146,66,80,0,0,0
2024-06-19 15:45,185,91,94,0,0,0
2024-06-19 16:00,187,107,80,0,0,0
2024-06-19 16:15,176,83,93,0,0,0
2024-06-19 16:30,169,92,77,0,0,0
2024-06-19 16:45,217,109,108,0,0,0
2024-06-19 17:00,190,109,81,0,0,0
2024-06-19 17:15,212,106,106,0,0,0
2024-06-19 17:30,219,105,114,0,0,0
2024-06-19 17:45,208,99,109,0,0,0
2024-06-19 18:00,117,55,62,0,0,0
2024-06-19 18:15,91,45,46,0,0,0
2024-06-19 18:30,61,35,26,0,0,0
2024-06-19 18:45,77,41,36,0,0,0
2024-06-19 19:00,73,38,35,0,0,0
2024-06-19 19:15,73,35,38,0,0,0
2024-06-19 19:30,44,12,32,0,0,0
2024-06-19 19:45,58,17,41,0,0,0
2024-06-19 20:00,128,50,78,0,0,0
2024-06-19 20:15,104,48,56,0,0,0
2024-06-19 20:30,80,25,55,0,0,0
2024-06-19 20:45,89,35,54,0,0,0
2024-06-19 21:00,73,27,46,0,0,0
2024-06-19 21:15,61,23,38,0,0,0
2024-06-19 21:30,67,27,40,0,0,0
2024-06-19 21:45,71,22,49,0,0,0
2024-06-19 22:00,74,33,41,0,0,0
2024-06-19 22:15,45,19,26,0,0,0
2024-06-19 22:30,36,14,22,0,0,0
2024-06-19 22:45,32,11,21,0,0,0
2024-06-19 23:00,42,12,30,0,0,0
2024-06-19 23:15,28,9,19,0,0,0
2024-06-19 23:30,26,15,11,0,0,0
2024-06-19 23:45,29,11,18,0,0,0
2024-06-20 00:00,17,2,15,0,0,0
2024-06-20 00:15,14,2,12,0,0,0
2024-06-20 00:30,17,9,8,0,0,0
2024-06-20 00:45,12,5,7,0,0,0
2024-06-20 01:00,8,2,6,0,0,0
2024-06-20 01:15,9,2,7,0,0,0
2024-06-20 01:30,7,0,7,0,0,0
2024-06-20 01:45,4,0,4,0,0,0
2024-06-20 02:00,6,0,6,0,0,0
2024-06-20 02:15,6,1,5,0,0,0
2024-06-20 02:30,12,1,11,0,0,0
2024-06-20 02:45,6,1,5,0,0,0
2024-06-20 03:00,8,0,8,0,0,0
2024-06-20 03:15,2,1,1,0,0,0
2024-06-20 03:30,1,0,1,0,0,0
2024-06-20 03:45,3,0,3,0,0,0
2024-06-20 04:00,0,0,0,0,0,0
2024-06-20 04:15,3,2,1,0,0,0
2024-06-20 04:30,2,0,2,0,0,0
2024-06-20 04:45,2,2,0,0,0,0
2024-06-20 05:00,2,1,1,0,0,0
2024-06-20 05:15,9,4,5,0,0,0
2024-06-20 05:30,11,5,6,0,0,0
2024-06-20 05:45,12,6,6,0,0,0
2024-06-20 06:00,23,9,14,0,0,0
2024-06-20 06:15,22,12,10,0,0,0
2024-06-20 06:30,41,27,14,0,0,0
2024-06-20 06:45,67,40,27,0,0,0
2024-06-20 07:00,69,40,29,0,0,0
2024-06-20 07:15,96,65,31,0,0,0
2024-06-20 07:30,227,173,54,0,0,0
2024-06-20 07:45,208,139,69,0,0,0
2024-06-20 08:00,153,113,40,0,0,0
2024-06-20 08:15,137,97,40,0,0,0
2024-06-20 08:30,121,97,24,0,0,0
2024-06-20 08:45,136,111,25,0,0,0
2024-06-20 09:00,90,69,21,0,0,0
2024-06-20 09:15,88,63,25,0,0,0
2024-06-20 09:30,114,91,23,0,0,0
2024-06-20 09:45,139,107,32,0,0,0
2024-06-20 10:00,100,79,21,0,0,0
2024-06-20 10:15,98,66,32,0,0,0
2024-06-20 10:30,87,59,28,0,0,0
2024-06-20 10:45,105,72,33,0,0,0
2024-06-20 11:00,87,55,32,0,0,0
2024-06-20 11:15,92,57,35,0,0,0
2024-06-20 11:30,118,76,42,0,0,0
2024-06-20 11:45,133,87,46,0,0,0
2024-06-20 12:00,122,62,60,0,0,0
2024-06-20 12:15,101,52,49,0,0,0
2024-06-20 12:30,113,58,55,0,0,0
2024-06-20 12:45,106,59,47,0,0,0
2024-06-20 13:00,109,52,57,0,0,0
2024-06-20 13:15,146,77,69,0,0,0
2024-06-20 13:30,110,62,48,0,0,0
2024-06-20 13:45,135,66,69,0,0,0
2024-06-20 14:00,119,62,57,0,0,0
2024-06-20 14:15,118,66,52,0,0,0
2024-06-20 14:30,132,74,58,0,0,0
2024-06-20 14:45,171,92,79,0,0,0
2024-06-20 15:00,129,74,55,0,0,0
2024-06-20 15:15,146,66,80,0,0,0
2024-06-20 15:30,166,98,68,0,0,0
2024-06-20 15:45,157,95,62,0,0,0
2024-06-20 16:00,157,81,76,0,0,0
2024-06-20 16:15,189,87,102,0,0,0
2024-06-20 16:30,119,61,58,0,0,0
2024-06-20 16:45,143,63,80,0,0,0
2024-06-20 17:00,155,75,80,0,0,0
2024-06-20 17:15,138,61,77,0,0,0
2024-06-20 17:30,126,64,62,0,0,0
2024-06-20 17:45,158,69,89,0,0,0
2024-06-20 18:00,145,53,92,0,0,0
2024-06-20 18:15,134,47,87,0,0,0
2024-06-20 18:30,140,67,73,0,0,0
2024-06-20 18:45,124,73,51,0,0,0
2024-06-20 19:00,95,53,42,0,0,0
2024-06-20 19:15,116,61,55,0,0,0
2024-06-20 19:30,77,22,55,0,0,0
2024-06-20 19:45,65,28,37,0,0,0
2024-06-20 20:00,70,30,40,0,0,0
2024-06-20 20:15,59,23,36,0,0,0
2024-06-20 20:30,57,26,31,0,0,0
2024-06-20 20:45,48,25,23,0,0,0
2024-06-20 21:00,47,22,25,0,0,0
2024-06-20 21:15,48,17,31,0,0,0
2024-06-20 21:30,35,18,17,0,0,0
2024-06-20 21:45,45,20,25,0,0,0
2024-06-20 22:00,69,22,47,0,0,0
2024-06-20 22:15,33,11,22,0,0,0
2024-06-20 22:30,31,12,19,0,0,0
2024-06-20 22:45,25,8,17,0,0,0
2024-06-20 23:00,27,11,16,0,0,0
2024-06-20 23:15,24,9,15,0,0,0
2024-06-20 23:30,15,5,10,0,0,0
2024-06-20 23:45,9,2,7,0,0,0
2024-06-21 00:00,28,11,17,0,0,0
2024-06-21 00:15,12,6,6,0,0,0
2024-06-21 00:30,16,3,13,0,0,0
2024-06-21 00:45,11,4,7,0,0,0
2024-06-21 01:00,5,2,3,0,0,0
2024-06-21 01:15,4,1,3,0,0,0
2024-06-21 01:30,3,0,3,0,0,0
2024-06-21 01:45,2,0,2,0,0,0
2024-06-21 02:00,3,0,3,0,0,0
2024-06-21 02:15,6,3,3,0,0,0
2024-06-21 02:30,2,0,2,0,0,0
2024-06-21 02:45,2,0,2,0,0,0
2024-06-21 03:00,0,0,0,0,0,0
2024-06-21 03:15,0,0,0,0,0,0
2024-06-21 03:30,0,0,0,0,0,0
2024-06-21 03:45,0,0,0,0,0,0
2024-06-21 04:00,4,3,1,0,0,0
2024-06-21 04:15,0,0,0,0,0,0
2024-06-21 04:30,0,0,0,0,0,0
2024-06-21 04:45,1,1,0,0,0,0
2024-06-21 05:00,1,0,1,0,0,0
2024-06-21 05:15,4,2,2,0,0,0
2024-06-21 05:30,13,2,11,0,0,0
2024-06-21 05:45,19,11,8,0,0,0
2024-06-21 06:00,17,11,6,0,0,0
2024-06-21 06:15,23,15,8,0,0,0
2024-06-21 06:30,36,21,15,0,0,0
2024-06-21 06:45,35,23,12,0,0,0
2024-06-21 07:00,50,33,17,0,0,0
2024-06-21 07:15,102,79,23,0,0,0
2024-06-21 07:30,181,145,36,0,0,0
2024-06-21 07:45,101,64,37,0,0,0
2024-06-21 08:00,49,35,14,0,0,0
2024-06-21 08:15,136,107,29,0,0,0
2024-06-21 08:30,116,87,29,0,0,0
2024-06-21 08:45,105,78,27,0,0,0
2024-06-21 09:00,86,60,26,0,0,0
2024-06-21 09:15,79,55,24,0,0,0
2024-06-21 09:30,102,76,26,0,0,0
2024-06-21 09:45,106,79,27,0,0,0
2024-06-21 10:00,96,69,27,0,0,0
2024-06-21 10:15,92,69,23,0,0,0
2024-06-21 10:30,66,46,20,0,0,0
2024-06-21 10:45,78,50,28,0,0,0
2024-06-21 11:00,62,36,26,0,0,0
2024-06-21 11:15,78,50,28,0,0,0
2024-06-21 11:30,91,46,45,0,0,0
2024-06-21 11:45,107,71,36,0,0,0
2024-06-21 12:00,103,62,41,0,0,0
2024-06-21 12:15,112,70,42,0,0,0
2024-06-21 12:30,105,52,53,0,0,0
2024-06-21 12:45,107,60,47,0,0,0
2024-06-21 13:00,138,62,76,0,0,0
2024-06-21 13:15,105,53,52,0,0,0
2024-06-21 13:30,116,60,56,0,0,0
2024-06-21 13:45,121,68,53,0,0,0
2024-06-21 14:00,143,78,65,0,0,0
2024-06-21 14:15,107,59,48,0,0,0
2024-06-21 14:30,108,55,53,0,0,0
2024-06-21 14:45,61,34,27,0,0,0
2024-06-21 15:00,57,26,31,0,0,0
2024-06-21 15:15,93,39,54,0,0,0
2024-06-21 15:30,129,66,63,0,0,0
2024-06-21 15:45,106,40,66,0,0,0
2024-06-21 16:00,113,64,49,0,0,0
2024-06-21 16:15,75,31,44,0,0,0
2024-06-21 16:30,73,35,38,0,0,0
2024-06-21 16:45,63,32,31,0,0,0
2024-06-21 17:00,56,29,27,0,0,0
2024-06-21 17:15,55,24,31,0,0,0
2024-06-21 17:30,60,25,35,0,0,0
2024-06-21 17:45,73,35,38,0,0,0
2024-06-21 18:00,72,29,43,0,0,0
2024-06-21 18:15,76,36,40,0,0,0
2024-06-21 18:30,75,33,42,0,0,0
2024-06-21 18:45,82,43,39,0,0,0
2024-06-21 19:00,70,39,31,0,0,0
2024-06-21 19:15,76,41,35,0,0,0
2024-06-21 19:30,77,44,33,0,0,0
2024-06-21 19:45,58,29,29,0,0,0
2024-06-21 20:00,57,26,31,0,0,0
2024-06-21 20:15,45,16,29,0,0,0
2024-06-21 20:30,53,21,32,0,0,0
2024-06-21 20:45,39,16,23,0,0,0
2024-06-21 21:00,30,14,16,0,0,0
2024-06-21 21:15,39,17,22,0,0,0
2024-06-21 21:30,31,10,21,0,0,0
2024-06-21 21:45,27,10,17,0,0,0
2024-06-21 22:00,41,16,25,0,0,0
2024-06-21 22:15,34,11,23,0,0,0
2024-06-21 22:30,28,13,15,0,0,0
2024-06-21 22:45,28,11,17,0,0,0
2024-06-21 23:00,32,15,17,0,0,0
2024-06-21 23:15,33,5,28,0,0,0
2024-06-21 23:30,33,15,18,0,0,0
2024-06-21 23:45,19,7,12,0,0,0
2024-06-22 00:00,38,12,26,0,0,0
2024-06-22 00:15,12,2,10,0,0,0
2024-06-22 00:30,14,7,7,0,0,0
2024-06-22 00:45,16,7,9,0,0,0
2024-06-22 01:00,18,7,11,0,0,0
2024-06-22 01:15,14,0,14,0,0,0
2024-06-22 01:30,10,1,9,0,0,0
2024-06-22 01:45,10,5,5,0,0,0
2024-06-22 02:00,12,2,10,0,0,0
2024-06-22 02:15,5,1,4,0,0,0
2024-06-22 02:30,7,1,6,0,0,0
2024-06-22 02:45,1,0,1,0,0,0
2024-06-22 03:00,3,1,2,0,0,0
2024-06-22 03:15,6,1,5,0,0,0
2024-06-22 03:30,4,2,2,0,0,0
2024-06-22 03:45,6,2,4,0,0,0
2024-06-22 04:00,2,0,2,0,0,0
2024-06-22 04:15,2,1,1,0,0,0
2024-06-22 04:30,3,0,3,0,0,0
2024-06-22 04:45,1,0,1,0,0,0
2024-06-22 05:00,4,1,3,0,0,0
2024-06-22 05:15,2,2,0,0,0,0
2024-06-22 05:30,7,4,3,0,0,0
2024-06-22 05:45,12,8,4,0,0,0
2024-06-22 06:00,4,1,3,0,0,0
2024-06-22 06:15,8,5,3,0,0,0
2024-06-22 06:30,7,5,2,0,0,0
2024-06-22 06:45,11,5,6,0,0,0
2024-06-22 07:00,12,12,0,0,0,0
2024-06-22 07:15,19,14,5,0,0,0
2024-06-22 07:30,17,11,6,0,0,0
2024-06-22 07:45,35,26,9,0,0,0
2024-06-22 08:00,24,19,5,0,0,0
2024-06-22 08:15,36,20,16,0,0,0
2024-06-22 08:30,47,32,15,0,0,0
2024-06-22 08:45,83,58,25,0,0,0
2024-06-22 09:00,74,59,15,0,0,0
2024-06-22 09:15,67,50,17,0,0,0
2024-06-22 09:30,84,68,16,0,0,0
2024-06-22 09:45,110,84,26,0,0,0
2024-06-22 10:00,113,96,17,0,0,0
2024-06-22 10:15,97,73,24,0,0,0
2024-06-22 10:30,143,112,31,0,0,0
2024-06-22 10:45,107,79,28,0,0,0
2024-06-22 11:00,122,88,34,0,0,0
2024-06-22 11:15,128,89,39,0,0,0
2024-06-22 11:30,151,114,37,0,0,0
2024-06-22 11:45,162,111,51,0,0,0
2024-06-22 12:00,114,66,48,0,0,0
2024-06-22 12:15,137,102,35,0,0,0
2024-06-22 12:30,146,81,65,0,0,0
2024-06-22 12:45,127,73,54,0,0,0
2024-06-22 13:00,179,103,76,0,0,0
2024-06-22 13:15,132,80,52,0,0,0
2024-06-22 13:30,137,65,72,0,0,0
2024-06-22 13:45,147,78,69,0,0,0
2024-06-22 14:00,151,74,77,0,0,0
2024-06-22 14:15,131,67,64,0,0,0
2024-06-22 14:30,118,53,65,0,0,0
2024-06-22 14:45,126,52,74,0,0,0
2024-06-22 15:00,93,34,59,0,0,0
2024-06-22 15:15,122,59,63,0,0,0
2024-06-22 15:30,114,52,62,0,0,0
2024-06-22 15:45,122,56,66,0,0,0
2024-06-22 16:00,120,64,56,0,0,0
2024-06-22 16:15,121,68,53,0,0,0
2024-06-22 16:30,93,44,49,0,0,0
2024-06-22 16:45,99,50,49,0,0,0
2024-06-22 17:00,104,48,56,0,0,0
2024-06-22 17:15,111,49,62,0,0,0
2024-06-22 17:30,123,62,61,0,0,0
2024-06-22 17:45,121,71,50,0,0,0
2024-06-22 18:00,99,47,52,0,0,0
2024-06-22 18:15,93,31,62,0,0,0
2024-06-22 18:30,77,28,49,0,0,0
2024-06-22 18:45,76,46,30,0,0,0
2024-06-22 19:00,90,44,46,0,0,0
2024-06-22 19:15,74,36,38,0,0,0
2024-06-22 19:30,42,20,22,0,0,0
2024-06-22 19:45,89,42,47,0,0,0
2024-06-22 20:00,60,31,29,0,0,0
2024-06-22 20:15,65,25,40,0,0,0
2024-06-22 20:30,47,20,27,0,0,0
2024-06-22 20:45,39,17,22,0,0,0
2024-06-22 21:00,56,28,28,0,0,0
2024-06-22 21:15,55,25,30,0,0,0
2024-06-22 21:30,33,13,20,0,0,0
2024-06-22 21:45,39,16,23,0,0,0
2024-06-22 22:00,35,24,11,0,0,0
2024-06-22 22:15,30,15,15,0,0,0
2024-06-22 22:30,43,21,22,0,0,0
2024-06-22 22:45,28,12,16,0,0,0
2024-06-22 23:00,25,15,10,0,0,0
2024-06-22 23:15,33,16,17,0,0,0
2024-06-22 23:30,38,13,25,0,0,0
2024-06-22 23:45,15,3,12,0,0,0
2024-06-23 00:00,30,16,14,0,0,0
2024-06-23 00:15,14,4,10,0,0,0
2024-06-23 00:30,25,9,16,0,0,0
2024-06-23 00:45,20,4,16,0,0,0
2024-06-23 01:00,27,16,11,0,0,0
2024-06-23 01:15,13,6,7,0,0,0
2024-06-23 01:30,9,3,6,0,0,0
2024-06-23 01:45,11,3,8,0,0,0
2024-06-23 02:00,7,6,1,0,0,0
2024-06-23 02:15,14,1,13,0,0,0
2024-06-23 02:30,16,9,7,0,0,0
2024-06-23 02:45,7,2,5,0,0,0
2024-06-23 03:00,3,1,2,0,0,0
2024-06-23 03:15,5,0,5,0,0,0
2024-06-23 03:30,5,0,5,0,0,0
2024-06-23 03:45,3,0,3,0,0,0
2024-06-23 04:00,2,0,2,0,0,0
2024-06-23 04:15,4,0,4,0,0,0
2024-06-23 04:30,5,1,4,0,0,0
2024-06-23 04:45,3,1,2,0,0,0
2024-06-23 05:00,4,1,3,0,0,0
2024-06-23 05:15,5,3,2,0,0,0
2024-06-23 05:30,5,3,2,0,0,0
2024-06-23 05:45,6,1,5,0,0,0
2024-06-23 06:00,5,4,1,0,0,0
2024-06-23 06:15,2,1,1,0,0,0
2024-06-23 06:30,6,6,0,0,0,0
2024-06-23 06:45,4,4,0,0,0,0
2024-06-23 07:00,1,1,0,0,0,0
2024-06-23 07:15,2,1,1,0,0,0
2024-06-23 07:30,5,4,1,0,0,0
2024-06-23 07:45,12,8,4,0,0,0
2024-06-23 08:00,16,12,4,0,0,0
2024-06-23 08:15,16,9,7,0,0,0
2024-06-23 08:30,16,4,12,0,0,0
2024-06-23 08:45,23,13,10,0,0,0
2024-06-23 09:00,28,22,6,0,0,0
2024-06-23 09:15,22,15,7,0,0,0
2024-06-23 09:30,32,23,9,0,0,0
2024-06-23 09:45,53,38,15,0,0,0
2024-06-23 10:00,45,24,21,0,0,0
2024-06-23 10:15,50,33,17,0,0,0
2024-06-23 10:30,31,22,9,0,0,0
2024-06-23 10:45,55,35,20,0,0,0
2024-06-23 11:00,40,25,15,0,0,0
2024-06-23 11:15,55,27,28,0,0,0
2024-06-23 11:30,39,18,21,0,0,0
2024-06-23 11:45,64,44,20,0,0,0
2024-06-23 12:00,50,35,15,0,0,0
2024-06-23 12:15,49,33,16,0,0,0
2024-06-23 12:30,74,43,31,0,0,0
2024-06-23 12:45,75,44,31,0,0,0
2024-06-23 13:00,58,25,33,0,0,0
2024-06-23 13:15,52,25,27,0,0,0
2024-06-23 13:30,61,32,29,0,0,0
2024-06-23 13:45,84,67,17,0,0,0
2024-06-23 14:00,80,44,36,0,0,0
2024-06-23 14:15,71,36,35,0,0,0
2024-06-23 14:30,84,45,39,0,0,0
2024-06-23 14:45,77,36,41,0,0,0
2024-06-23 15:00,73,40,33,0,0,0
2024-06-23 15:15,61,25,36,0,0,0
2024-06-23 15:30,74,42,32,0,0,0
2024-06-23 15:45,86,54,32,0,0,0
2024-06-23 16:00,50,24,26,0,0,0
2024-06-23 16:15,86,43,43,0,0,0
2024-06-23 16:30,57,25,32,0,0,0
2024-06-23 16:45,94,65,29,0,0,0
2024-06-23 17:00,80,51,29,0,0,0
2024-06-23 17:15,69,43,26,0,0,0
2024-06-23 17:30,92,53,39,0,0,0
2024-06-23 17:45,76,48,28,0,0,0
2024-06-23 18:00,59,30,29,0,0,0
2024-06-23 18:15,63,41,22,0,0,0
2024-06-23 18:30,72,46,26,0,0,0
2024-06-23 18:45,76,43,33,0,0,0
2024-06-23 19:00,73,37,36,0,0,0
2024-06-23 19:15,54,31,23,0,0,0
2024-06-23 19:30,58,31,27,0,0,0
2024-06-23 19:45,101,61,40,0,0,0
2024-06-23 20:00,75,44,31,0,0,0
2024-06-23 20:15,63,33,30,0,0,0
2024-06-23 20:30,76,40,36,0,0,0
2024-06-23 20:45,44,30,14,0,0,0
2024-06-23 21:00,40,26,14,0,0,0
2024-06-23 21:15,24,14,10,0,0,0
2024-06-23 21:30,18,12,6,0,0,0
2024-06-23 21:45,21,10,11,0,0,0
2024-06-23 22:00,27,12,15,0,0,0
2024-06-23 22:15,12,6,6,0,0,0
2024-06-23 22:30,12,5,7,0,0,0
2024-06-23 22:45,29,7,22,0,0,0
2024-06-23 23:00,135,34,101,0,0,0
2024-06-23 23:15,76,24,52,0,0,0
2024-06-23 23:30,42,13,29,0,0,0
2024-06-23 23:45,25,10,15,0,0,0
2024-06-24 00:00,19,6,13,0,0,0
2024-06-24 00:15,16,8,8,0,0,0
2024-06-24 00:30,5,0,5,0,0,0
2024-06-24 00:45,10,5,5,0,0,0
2024-06-24 01:00,4,1,3,0,0,0
2024-06-24 01:15,4,1,3,0,0,0
2024-06-24 01:30,2,1,1,0,0,0
2024-06-24 01:45,0,0,0,0,0,0
2024-06-24 02:00,3,2,1,0,0,0
2024-06-24 02:15,1,0,1,0,0,0
2024-06-24 02:30,1,0,1,0,0,0
2024-06-24 02:45,0,0,0,0,0,0
2024-06-24 03:00,0,0,0,0,0,0
2024-06-24 03:15,1,1,0,0,0,0
2024-06-24 03:30,0,0,0,0,0,0
2024-06-24 03:45,1,0,1,0,0,0
2024-06-24 04:00,2,1,1,0,0,0
2024-06-24 04:15,0,0,0,0,0,0
2024-06-24 04:30,1,1,0,0,0,0
2024-06-24 04:45,1,1,0,0,0,0
2024-06-24 05:00,4,2,2,0,0,0
2024-06-24 05:15,9,7,2,0,0,0
2024-06-24 05:30,10,4,6,0,0,0
2024-06-24 05:45,21,12,9,0,0,0
2024-06-24 06:00,10,4,6,0,0,0
2024-06-24 06:15,39,24,15,0,0,0
2024-06-24 06:30,42,20,22,0,0,0
2024-06-24 06:45,54,36,18,0,0,0
2024-06-24 07:00,63,36,27,0,0,0
2024-06-24 07:15,107,72,35,0,0,0
2024-06-24 07:30,180,144,36,0,0,0
2024-06-24 07:45,183,128,55,0,0,0
2024-06-24 08:00,141,99,42,0,0,0
2024-06-24 08:15,148,106,42,0,0,0
2024-06-24 08:30,146,105,41,0,0,0
2024-06-24 08:45,136,99,37,0,0,0
2024-06-24 09:00,104,79,25,0,0,0
2024-06-24 09:15,97,76,21,0,0,0
2024-06-24 09:30,119,86,33,0,0,0
2024-06-24 09:45,136,107,29,0,0,0
2024-06-24 10:00,106,85,21,0,0,0
2024-06-24 10:15,106,77,29,0,0,0
2024-06-24 10:30,100,63,37,0,0,0
2024-06-24 10:45,106,62,44,0,0,0
2024-06-24 11:00,91,67,24,0,0,0
2024-06-24 11:15,94,61,33,0,0,0
2024-06-24 11:30,100,60,40,0,0,0
2024-06-24 11:45,106,68,38,0,0,0
2024-06-24 12:00,109,62,47,0,0,0
2024-06-24 12:15,102,53,49,0,0,0
2024-06-24 12:30,112,59,53,0,0,0
2024-06-24 12:45,116,63,53,0,0,0
2024-06-24 13:00,146,69,77,0,0,0
2024-06-24 13:15,113,54,59,0,0,0
2024-06-24 13:30,103,53,50,0,0,0
2024-06-24 13:45,102,60,42,0,0,0
2024-06-24 14:00,140,65,75,0,0,0
2024-06-24 14:15,115,52,63,0,0,0
2024-06-24 14:30,127,71,56,0,0,0
2024-06-24 14:45,162,87,75,0,0,0
2024-06-24 15:00,116,61,55,0,0,0
2024-06-24 15:15,141,79,62,0,0,0
2024-06-24 15:30,153,88,65,0,0,0
2024-06-24 15:45,178,98,80,0,0,0
2024-06-24 16:00,178,88,90,0,0,0
2024-06-24 16:15,183,85,98,0,0,0
2024-06-24 16:30,151,69,82,0,0,0
2024-06-24 16:45,192,92,100,0,0,0
2024-06-24 17:00,156,76,80,0,0,0
2024-06-24 17:15,157,71,86,0,0,0
2024-06-24 17:30,163,87,76,0,0,0
2024-06-24 17:45,180,81,99,0,0,0
2024-06-24 18:00,157,70,87,0,0,0
2024-06-24 18:15,150,69,81,0,0,0
2024-06-24 18:30,132,67,65,0,0,0
2024-06-24 18:45,112,55,57,0,0,0
2024-06-24 19:00,95,41,54,0,0,0
2024-06-24 19:15,95,46,49,0,0,0
2024-06-24 19:30,87,43,44,0,0,0
2024-06-24 19:45,84,36,48,0,0,0
2024-06-24 20:00,72,29,43,0,0,0
2024-06-24 20:15,61,26,35,0,0,0
2024-06-24 20:30,51,22,29,0,0,0
2024-06-24 20:45,65,25,40,0,0,0
2024-06-24 21:00,52,27,25,0,0,0
2024-06-24 21:15,50,22,28,0,0,0
2024-06-24 21:30,50,22,28,0,0,0
2024-06-24 21:45,61,20,41,0,0,0
2024-06-24 22:00,38,13,25,0,0,0
2024-06-24 22:15,44,16,28,0,0,0
2024-06-24 22:30,31,10,21,0,0,0
2024-06-24 22:45,23,10,13,0,0,0
2024-06-24 23:00,32,14,18,0,0,0
2024-06-24 23:15,23,8,15,0,0,0
2024-06-24 23:30,26,13,13,0,0,0
2024-06-24 23:45,14,3,11,0,0,0
2024-06-25 00:00,8,3,5,0,0,0
2024-06-25 00:15,12,4,8,0,0,0
2024-06-25 00:30,5,1,4,0,0,0
2024-06-25 00:45,7,1,6,0,0,0
2024-06-25 01:00,3,1,2,0,0,0
2024-06-25 01:15,2,1,1,0,0,0
2024-06-25 01:30,2,0,2,0,0,0
2024-06-25 01:45,4,2,2,0,0,0
2024-06-25 02:00,1,0,1,0,0,0
2024-06-25 02:15,1,0,1,0,0,0
2024-06-25 02:30,1,0,1,0,0,0
2024-06-25 02:45,2,0,2,0,0,0
2024-06-25 03:00,2,1,1,0,0,0
2024-06-25 03:15,1,0,1,0,0,0
2024-06-25 03:30,0,0,0,0,0,0
2024-06-25 03:45,3,1,2,0,0,0
2024-06-25 04:00,1,1,0,0,0,0
2024-06-25 04:15,0,0,0,0,0,0
2024-06-25 04:30,0,0,0,0,0,0
2024-06-25 04:45,2,2,0,0,0,0
2024-06-25 05:00,5,4,1,0,0,0
2024-06-25 05:15,10,6,4,0,0,0
2024-06-25 05:30,14,4,10,0,0,0
2024-06-25 05:45,22,10,12,0,0,0
2024-06-25 06:00,26,16,10,0,0,0
2024-06-25 06:15,28,15,13,0,0,0
2024-06-25 06:30,49,28,21,0,0,0
2024-06-25 06:45,74,43,31,0,0,0
2024-06-25 07:00,95,72,23,0,0,0
2024-06-25 07:15,131,89,42,0,0,0
2024-06-25 07:30,187,140,47,0,0,0
2024-06-25 07:45,201,136,65,0,0,0
2024-06-25 08:00,144,98,46,0,0,0
2024-06-25 08:15,150,106,44,0,0,0
2024-06-25 08:30,127,89,38,0,0,0
2024-06-25 08:45,147,110,37,0,0,0
2024-06-25 09:00,111,82,29,0,0,0
2024-06-25 09:15,97,62,35,0,0,0
2024-06-25 09:30,116,83,33,0,0,0
2024-06-25 09:45,131,103,28,0,0,0
2024-06-25 10:00,113,72,41,0,0,0
2024-06-25 10:15,108,73,35,0,0,0
2024-06-25 10:30,79,42,37,0,0,0
2024-06-25 10:45,126,80,46,0,0,0
2024-06-25 11:00,112,77,35,0,0,0
2024-06-25 11:15,94,58,36,0,0,0
2024-06-25 11:30,106,69,37,0,0,0
2024-06-25 11:45,139,97,42,0,0,0
2024-06-25 12:00,133,79,54,0,0,0
2024-06-25 12:15,128,66,62,0,0,0
2024-06-25 12:30,133,66,67,0,0,0
2024-06-25 12:45,100,43,57,0,0,0
2024-06-25 13:00,148,69,79,0,0,0
2024-06-25 13:15,130,61,69,0,0,0
2024-06-25 13:30,115,71,44,0,0,0
2024-06-25 13:45,156,67,89,0,0,0
2024-06-25 14:00,134,63,71,0,0,0
2024-06-25 14:15,127,66,61,0,0,0
2024-06-25 14:30,126,60,66,0,0,0
2024-06-25 14:45,157,94,63,0,0,0
2024-06-25 15:00,149,66,83,0,0,0
2024-06-25 15:15,134,68,66,0,0,0
2024-06-25 15:30,147,86,61,0,0,0
2024-06-25 15:45,182,78,104,0,0,0
2024-06-25 16:00,190,90,100,0,0,0
2024-06-25 16:15,178,81,97,0,0,0
2024-06-25 16:30,163,93,70,0,0,0
2024-06-25 16:45,162,85,77,0,0,0
2024-06-25 17:00,147,60,87,0,0,0
2024-06-25 17:15,187,83,104,0,0,0
2024-06-25 17:30,166,75,91,0,0,0
2024-06-25 17:45,190,93,97,0,0,0
2024-06-25 18:00,182,72,110,0,0,0
2024-06-25 18:15,176,79,97,0,0,0
2024-06-25 18:30,146,76,70,0,0,0
2024-06-25 18:45,160,78,82,0,0,0
2024-06-25 19:00,106,40,66,0,0,0
2024-06-25 19:15,121,67,54,0,0,0
2024-06-25 19:30,90,45,45,0,0,0
2024-06-25 19:45,101,38,63,0,0,0
2024-06-25 20:00,80,31,49,0,0,0
2024-06-25 20:15,97,47,50,0,0,0
2024-06-25 20:30,75,35,40,0,0,0
2024-06-25 20:45,65,22,43,0,0,0
2024-06-25 21:00,70,28,42,0,0,0
2024-06-25 21:15,59,30,29,0,0,0
2024-06-25 21:30,61,28,33,0,0,0
2024-06-25 21:45,64,21,43,0,0,0
2024-06-25 22:00,67,34,33,0,0,0
2024-06-25 22:15,68,37,31,0,0,0
2024-06-25 22:30,45,24,21,0,0,0
2024-06-25 22:45,36,14,22,0,0,0
2024-06-25 23:00,52,25,27,0,0,0
2024-06-25 23:15,28,9,19,0,0,0
2024-06-25 23:30,19,7,12,0,0,0
2024-06-25 23:45,15,6,9,0,0,0
2024-06-26 00:00,19,5,14,0,0,0
2024-06-26 00:15,6,2,4,0,0,0
2024-06-26 00:30,3,0,3,0,0,0
2024-06-26 00:45,11,2,9,0,0,0
2024-06-26 01:00,4,2,2,0,0,0
2024-06-26 01:15,0,0,0,0,0,0
2024-06-26 01:30,3,2,1,0,0,0
2024-06-26 01:45,2,0,2,0,0,0
2024-06-26 02:00,2,1,1,0,0,0
2024-06-26 02:15,0,0,0,0,0,0
2024-06-26 02:30,1,1,0,0,0,0
2024-06-26 02:45,1,0,1,0,0,0
2024-06-26 03:00,1,1,0,0,0,0
2024-06-26 03:15,1,0,1,0,0,0
2024-06-26 03:30,0,0,0,0,0,0
2024-06-26 03:45,1,0,1,0,0,0
2024-06-26 04:00,1,0,1,0,0,0
2024-06-26 04:15,2,2,0,0,0,0
2024-06-26 04:30,1,0,1,0,0,0
2024-06-26 04:45,2,1,1,0,0,0
2024-06-26 05:00,5,4,1,0,0,0
2024-06-26 05:15,10,5,5,0,0,0
2024-06-26 05:30,18,6,12,0,0,0
2024-06-26 05:45,13,8,5,0,0,0
2024-06-26 06:00,17,13,4,0,0,0
2024-06-26 06:15,37,19,18,0,0,0
2024-06-26 06:30,43,30,13,0,0,0
2024-06-26 06:45,63,38,25,0,0,0
2024-06-26 07:00,77,48,29,0,0,0
2024-06-26 07:15,135,96,39,0,0,0
2024-06-26 07:30,187,149,38,0,0,0
2024-06-26 07:45,221,163,58,0,0,0
2024-06-26 08:00,149,108,41,0,0,0
2024-06-26 08:15,154,106,48,0,0,0
2024-06-26 08:30,154,108,46,0,0,0
2024-06-26 08:45,163,126,37,0,0,0
2024-06-26 09:00,126,95,31,0,0,0
2024-06-26 09:15,122,90,32,0,0,0
2024-06-26 09:30,149,112,37,0,0,0
2024-06-26 09:45,190,140,50,0,0,0
2024-06-26 10:00,156,108,48,0,0,0
2024-06-26 10:15,118,74,44,0,0,0
2024-06-26 10:30,124,69,55,0,0,0
2024-06-26 10:45,120,85,35,0,0,0
2024-06-26 11:00,117,73,44,0,0,0
2024-06-26 11:15,134,83,51,0,0,0
2024-06-26 11:30,118,62,56,0,0,0
2024-06-26 11:45,160,101,59,0,0,0
2024-06-26 12:00,137,78,59,0,0,0
2024-06-26 12:15,137,79,58,0,0,0
2024-06-26 12:30,145,82,63,0,0,0
2024-06-26 12:45,128,62,66,0,0,0
2024-06-26 13:00,160,59,101,0,0,0
2024-06-26 13:15,136,62,74,0,0,0
2024-06-26 13:30,149,69,80,0,0,0
2024-06-26 13:45,134,82,52,0,0,0
2024-06-26 14:00,152,58,94,0,0,0
2024-06-26 14:15,154,84,70,0,0,0
2024-06-26 14:30,144,72,72,0,0,0
2024-06-26 14:45,144,83,61,0,0,0
2024-06-26 15:00,139,59,80,0,0,0
2024-06-26 15:15,158,76,82,0,0,0
2024-06-26 15:30,157,70,87,0,0,0
2024-06-26 15:45,166,82,84,0,0,0
2024-06-26 16:00,165,74,91,0,0,0
2024-06-26 16:15,164,77,87,0,0,0
2024-06-26 16:30,136,48,88,0,0,0
2024-06-26 16:45,169,87,82,0,0,0
2024-06-26 17:00,160,96,64,0,0,0
2024-06-26 17:15,186,87,99,0,0,0
2024-06-26 17:30,191,95,96,0,0,0
2024-06-26 17:45,176,80,96,0,0,0
2024-06-26 18:00,159,67,92,0,0,0
2024-06-26 18:15,153,66,87,0,0,0
2024-06-26 18:30,127,51,76,0,0,0
2024-06-26 18:45,162,83,79,0,0,0
2024-06-26 19:00,118,56,62,0,0,0
2024-06-26 19:15,110,48,62,0,0,0
2024-06-26 19:30,99,45,54,0,0,0
2024-06-26 19:45,93,43,50,0,0,0
2024-06-26 20:00,90,49,41,0,0,0
2024-06-26 20:15,112,51,61,0,0,0
2024-06-26 20:30,95,53,42,0,0,0
2024-06-26 20:45,83,44,39,0,0,0
2024-06-26 21:00,71,45,26,0,0,0
2024-06-26 21:15,60,28,32,0,0,0
2024-06-26 21:30,87,59,28,0,0,0
2024-06-26 21:45,104,58,46,0,0,0
2024-06-26 22:00,64,33,31,0,0,0
2024-06-26 22:15,58,36,22,0,0,0
2024-06-26 22:30,67,22,45,0,0,0
2024-06-26 22:45,55,20,35,0,0,0
2024-06-26 23:00,42,20,22,0,0,0
2024-06-26 23:15,69,19,50,0,0,0
2024-06-26 23:30,44,16,28,0,0,0
2024-06-26 23:45,18,10,8,0,0,0
2024-06-27 00:00,22,6,16,0,0,0
2024-06-27 00:15,15,5,10,0,0,0
2024-06-27 00:30,8,2,6,0,0,0
2024-06-27 00:45,9,6,3,0,0,0
2024-06-27 01:00,6,1,5,0,0,0
2024-06-27 01:15,15,7,8,0,0,0
2024-06-27 01:30,8,2,6,0,0,0
2024-06-27 01:45,13,2,11,0,0,0
2024-06-27 02:00,6,1,5,0,0,0
2024-06-27 02:15,6,0,6,0,0,0
2024-06-27 02:30,9,0,9,0,0,0
2024-06-27 02:45,6,0,6,0,0,0
2024-06-27 03:00,1,0,1,0,0,0
2024-06-27 03:15,6,0,6,0,0,0
2024-06-27 03:30,2,0,2,0,0,0
2024-06-27 03:45,1,0,1,0,0,0
2024-06-27 04:00,4,1,3,0,0,0
2024-06-27 04:15,5,4,1,0,0,0
2024-06-27 04:30,2,2,0,0,0,0
2024-06-27 04:45,1,1,0,0,0,0
2024-06-27 05:00,2,2,0,0,0,0
2024-06-27 05:15,10,6,4,0,0,0
2024-06-27 05:30,15,8,7,0,0,0
2024-06-27 05:45,14,6,8,0,0,0
2024-06-27 06:00,19,12,7,0,0,0
2024-06-27 06:15,25,15,10,0,0,0
2024-06-27 06:30,38,25,13,0,0,0
2024-06-27 06:45,69,46,23,0,0,0
2024-06-27 07:00,81,51,30,0,0,0
2024-06-27 07:15,104,72,32,0,0,0
2024-06-27 07:30,158,125,33,0,0,0
2024-06-27 07:45,231,161,70,0,0,0
2024-06-27 08:00,142,109,33,0,0,0
2024-06-27 08:15,146,106,40,0,0,0
2024-06-27 08:30,130,96,34,0,0,0
2024-06-27 08:45,150,105,45,0,0,0
2024-06-27 09:00,115,81,34,0,0,0
2024-06-27 09:15,88,62,26,0,0,0
2024-06-27 09:30,104,80,24,0,0,0
2024-06-27 09:45,111,82,29,0,0,0
2024-06-27 10:00,96,76,20,0,0,0
2024-06-27 10:15,78,60,18,0,0,0
2024-06-27 10:30,109,75,34,0,0,0
2024-06-27 10:45,112,77,35,0,0,0
2024-06-27 11:00,99,59,40,0,0,0
2024-06-27 11:15,93,55,38,0,0,0
2024-06-27 11:30,112,76,36,0,0,0
2024-06-27 11:45,126,92,34,0,0,0
2024-06-27 12:00,121,75,46,0,0,0
2024-06-27 12:15,120,59,61,0,0,0
2024-06-27 12:30,130,65,65,0,0,0
2024-06-27 12:45,133,65,68,0,0,0
2024-06-27 13:00,129,59,70,0,0,0
2024-06-27 13:15,111,54,57,0,0,0
2024-06-27 13:30,121,64,57,0,0,0
2024-06-27 13:45,145,80,65,0,0,0
2024-06-27 14:00,118,58,60,0,0,0
2024-06-27 14:15,114,56,58,0,0,0
2024-06-27 14:30,126,74,52,0,0,0
2024-06-27 14:45,124,69,55,0,0,0
2024-06-27 15:00,129,69,60,0,0,0
2024-06-27 15:15,134,55,79,0,0,0
2024-06-27 15:30,162,87,75,0,0,0
2024-06-27 15:45,178,82,96,0,0,0
2024-06-27 16:00,177,89,88,0,0,0
2024-06-27 16:15,170,66,104,0,0,0
2024-06-27 16:30,156,80,76,0,0,0
2024-06-27 16:45,171,82,89,0,0,0
2024-06-27 17:00,144,70,74,0,0,0
2024-06-27 17:15,180,79,101,0,0,0
2024-06-27 17:30,155,81,74,0,0,0
2024-06-27 17:45,178,96,82,0,0,0
2024-06-27 18:00,150,70,80,0,0,0
2024-06-27 18:15,179,90,89,0,0,0
2024-06-27 18:30,153,78,75,0,0,0
2024-06-27 18:45,150,87,63,0,0,0
2024-06-27 19:00,141,60,81,0,0,0
2024-06-27 19:15,136,78,58,0,0,0
2024-06-27 19:30,98,58,40,0,0,0
2024-06-27 19:45,104,51,53,0,0,0
2024-06-27 20:00,96,43,53,0,0,0
2024-06-27 20:15,112,58,54,0,0,0
2024-06-27 20:30,83,40,43,0,0,0
2024-06-27 20:45,94,52,42,0,0,0
2024-06-27 21:00,81,46,35,0,0,0
2024-06-27 21:15,86,38,48,0,0,0
2024-06-27 21:30,83,45,38,0,0,0
2024-06-27 21:45,91,48,43,0,0,0
2024-06-27 22:00,87,52,35,0,0,0
2024-06-27 22:15,56,28,28,0,0,0
2024-06-27 22:30,66,31,35,0,0,0
2024-06-27 22:45,74,37,37,0,0,0
2024-06-27 23:00,32,12,20,0,0,0
2024-06-27 23:15,81,13,68,0,0,0
2024-06-27 23:30,46,12,34,0,0,0
2024-06-27 23:45,22,4,18,0,0,0
