Datetime,100034983 (Warendorfer Straße),101034983 (Warendorfer Straße stadteinwärts),102034983 (Warendorfer Straße stadtauswärts),100034983-status,101034983-status,102034983-status
2025-05-01 00:00,32,17,15,0,0,0
2025-05-01 00:15,38,14,24,0,0,0
2025-05-01 00:30,38,12,26,0,0,0
2025-05-01 00:45,31,7,24,0,0,0
2025-05-01 01:00,28,8,20,0,0,0
2025-05-01 01:15,18,6,12,0,0,0
2025-05-01 01:30,19,0,19,0,0,0
2025-05-01 01:45,25,4,21,0,0,0
2025-05-01 02:00,14,2,12,0,0,0
2025-05-01 02:15,16,4,12,0,0,0
2025-05-01 02:30,16,4,12,0,0,0
2025-05-01 02:45,10,3,7,0,0,0
2025-05-01 03:00,10,0,10,0,0,0
2025-05-01 03:15,6,0,6,0,0,0
2025-05-01 03:30,5,2,3,0,0,0
2025-05-01 03:45,2,0,2,0,0,0
2025-05-01 04:00,7,1,6,0,0,0
2025-05-01 04:15,0,0,0,0,0,0
2025-05-01 04:30,1,0,1,0,0,0
2025-05-01 04:45,5,3,2,0,0,0
2025-05-01 05:00,2,1,1,0,0,0
2025-05-01 05:15,0,0,0,0,0,0
2025-05-01 05:30,4,2,2,0,0,0
2025-05-01 05:45,5,1,4,0,0,0
2025-05-01 06:00,1,1,0,0,0,0
2025-05-01 06:15,7,5,2,0,0,0
2025-05-01 06:30,3,2,1,0,0,0
2025-05-01 06:45,6,4,2,0,0,0
2025-05-01 07:00,4,3,1,0,0,0
2025-05-01 07:15,3,2,1,0,0,0
2025-05-01 07:30,8,4,4,0,0,0
2025-05-01 07:45,16,9,7,0,0,0
2025-05-01 08:00,5,2,3,0,0,0
2025-05-01 08:15,11,8,3,0,0,0
2025-05-01 08:30,20,11,9,0,0,0
2025-05-01 08:45,22,13,9,0,0,0
2025-05-01 09:00,29,12,17,0,0,0
2025-05-01 09:15,35,21,14,0,0,0
2025-05-01 09:30,28,20,8,0,0,0
2025-05-01 09:45,40,23,17,0,0,0
2025-05-01 10:00,37,22,15,0,0,0
2025-05-01 10:15,49,20,29,0,0,0
2025-05-01 10:30,59,33,26,0,0,0
2025-05-01 10:45,62,29,33,0,0,0
2025-05-01 11:00,86,46,40,0,0,0
2025-05-01 11:15,61,29,32,0,0,0
2025-05-01 11:30,76,41,35,0,0,0
2025-05-01 11:45,106,70,36,0,0,0
2025-05-01 12:00,92,45,47,0,0,0
2025-05-01 12:15,71,29,42,0,0,0
2025-05-01 12:30,92,51,41,0,0,0
2025-05-01 12:45,102,60,42,0,0,0
2025-05-01 13:00,93,55,38,0,0,0
2025-05-01 13:15,75,43,32,0,0,0
2025-05-01 13:30,90,57,33,0,0,0
2025-05-01 13:45,97,58,39,0,0,0
2025-05-01 14:00,78,44,34,0,0,0
2025-05-01 14:15,94,49,45,0,0,0
2025-05-01 14:30,93,46,47,0,0,0
2025-05-01 14:45,108,52,56,0,0,0
2025-05-01 15:00,109,56,53,0,0,0
2025-05-01 15:15,76,42,34,0,0,0
2025-05-01 15:30,91,56,35,0,0,0
2025-05-01 15:45,98,60,38,0,0,0
2025-05-01 16:00,95,51,44,0,0,0
2025-05-01 16:15,89,44,45,0,0,0
2025-05-01 16:30,75,31,44,0,0,0
2025-05-01 16:45,75,45,30,0,0,0
2025-05-01 17:00,59,35,24,0,0,0
2025-05-01 17:15,100,67,33,0,0,0
2025-05-01 17:30,85,37,48,0,0,0
2025-05-01 17:45,78,44,34,0,0,0
2025-05-01 18:00,61,29,32,0,0,0
2025-05-01 18:15,63,26,37,0,0,0
2025-05-01 18:30,73,49,24,0,0,0
2025-05-01 18:45,79,35,44,0,0,0
2025-05-01 19:00,67,34,33,0,0,0
2025-05-01 19:15,86,49,37,0,0,0
2025-05-01 19:30,57,31,26,0,0,0
2025-05-01 19:45,74,40,34,0,0,0
2025-05-01 20:00,46,21,25,0,0,0
2025-05-01 20:15,59,24,35,0,0,0
2025-05-01 20:30,45,24,21,0,0,0
2025-05-01 20:45,52,32,20,0,0,0
2025-05-01 21:00,61,27,34,0,0,0
2025-05-01 21:15,51,33,18,0,0,0
2025-05-01 21:30,41,14,27,0,0,0
2025-05-01 21:45,39,23,16,0,0,0
2025-05-01 22:00,33,13,20,0,0,0
2025-05-01 22:15,27,10,17,0,0,0
2025-05-01 22:30,17,10,7,0,0,0
2025-05-01 22:45,25,12,13,0,0,0
2025-05-01 23:00,24,11,13,0,0,0
2025-05-01 23:15,10,7,3,0,0,0
2025-05-01 23:30,10,4,6,0,0,0
2025-05-01 23:45,11,5,6,0,0,0
2025-05-02 00:00,11,5,6,0,0,0
2025-05-02 00:15,14,7,7,0,0,0
2025-05-02 00:30,7,5,2,0,0,0
2025-05-02 00:45,6,3,3,0,0,0
2025-05-02 01:00,7,1,6,0,0,0
2025-05-02 01:15,1,0,1,0,0,0
2025-05-02 01:30,5,3,2,0,0,0
2025-05-02 01:45,1,0,1,0,0,0
2025-05-02 02:00,3,1,2,0,0,0
2025-05-02 02:15,3,2,1,0,0,0
2025-05-02 02:30,2,0,2,0,0,0
2025-05-02 02:45,1,0,1,0,0,0
2025-05-02 03:00,3,1,2,0,0,0
2025-05-02 03:15,1,0,1,0,0,0
2025-05-02 03:30,0,0,0,0,0,0
2025-05-02 03:45,0,0,0,0,0,0
2025-05-02 04:00,1,1,0,0,0,0
2025-05-02 04:15,0,0,0,0,0,0
2025-05-02 04:30,0,0,0,0,0,0
2025-05-02 04:45,1,1,0,0,0,0
2025-05-02 05:00,3,3,0,0,0,0
2025-05-02 05:15,8,4,4,0,0,0
2025-05-02 05:30,9,4,5,0,0,0
2025-05-02 05:45,12,7,5,0,0,0
2025-05-02 06:00,6,5,1,0,0,0
2025-05-02 06:15,19,14,5,0,0,0
2025-05-02 06:30,24,17,7,0,0,0
2025-05-02 06:45,31,21,10,0,0,0
2025-05-02 07:00,42,33,9,0,0,0
2025-05-02 07:15,97,72,25,0,0,0
2025-05-02 07:30,152,116,36,0,0,0
2025-05-02 07:45,112,74,38,0,0,0
2025-05-02 08:00,96,74,22,0,0,0
2025-05-02 08:15,68,54,14,0,0,0
2025-05-02 08:30,79,67,12,0,0,0
2025-05-02 08:45,114,89,25,0,0,0
2025-05-02 09:00,62,46,16,0,0,0
2025-05-02 09:15,88,66,22,0,0,0
2025-05-02 09:30,89,61,28,0,0,0
2025-05-02 09:45,91,64,27,0,0,0
2025-05-02 10:00,121,87,34,0,0,0
2025-05-02 10:15,94,65,29,0,0,0
2025-05-02 10:30,100,66,34,0,0,0
2025-05-02 10:45,94,56,38,0,0,0
2025-05-02 11:00,104,84,20,0,0,0
2025-05-02 11:15,97,57,40,0,0,0
2025-05-02 11:30,108,61,47,0,0,0
2025-05-02 11:45,124,76,48,0,0,0
2025-05-02 12:00,119,63,56,0,0,0
2025-05-02 12:15,122,68,54,0,0,0
2025-05-02 12:30,148,74,74,0,0,0
2025-05-02 12:45,119,64,55,0,0,0
2025-05-02 13:00,151,76,75,0,0,0
2025-05-02 13:15,132,60,72,0,0,0
2025-05-02 13:30,126,58,68,0,0,0
2025-05-02 13:45,140,66,74,0,0,0
2025-05-02 14:00,133,51,82,0,0,0
2025-05-02 14:15,112,52,60,0,0,0
2025-05-02 14:30,111,54,57,0,0,0
2025-05-02 14:45,124,71,53,0,0,0
2025-05-02 15:00,149,69,80,0,0,0
2025-05-02 15:15,94,47,47,0,0,0
2025-05-02 15:30,116,61,55,0,0,0
2025-05-02 15:45,133,79,54,0,0,0
2025-05-02 16:00,118,66,52,0,0,0
2025-05-02 16:15,125,60,65,0,0,0
2025-05-02 16:30,115,56,59,0,0,0
2025-05-02 16:45,117,61,56,0,0,0
2025-05-02 17:00,88,39,49,0,0,0
2025-05-02 17:15,105,61,44,0,0,0
2025-05-02 17:30,124,58,66,0,0,0
2025-05-02 17:45,149,64,85,0,0,0
2025-05-02 18:00,109,43,66,0,0,0
2025-05-02 18:15,113,55,58,0,0,0
2025-05-02 18:30,79,35,44,0,0,0
2025-05-02 18:45,97,52,45,0,0,0
2025-05-02 19:00,107,53,54,0,0,0
2025-05-02 19:15,94,44,50,0,0,0
2025-05-02 19:30,76,46,30,0,0,0
2025-05-02 19:45,72,38,34,0,0,0
2025-05-02 20:00,65,33,32,0,0,0
2025-05-02 20:15,52,19,33,0,0,0
2025-05-02 20:30,69,33,36,0,0,0
2025-05-02 20:45,55,30,25,0,0,0
2025-05-02 21:00,58,30,28,0,0,0
2025-05-02 21:15,34,14,20,0,0,0
2025-05-02 21:30,35,15,20,0,0,0
2025-05-02 21:45,40,16,24,0,0,0
2025-05-02 22:00,44,18,26,0,0,0
2025-05-02 22:15,33,13,20,0,0,0
2025-05-02 22:30,49,18,31,0,0,0
2025-05-02 22:45,36,10,26,0,0,0
2025-05-02 23:00,28,8,20,0,0,0
2025-05-02 23:15,39,15,24,0,0,0
2025-05-02 23:30,24,10,14,0,0,0
2025-05-02 23:45,17,7,10,0,0,0
2025-05-03 00:00,8,3,5,0,0,0
2025-05-03 00:15,27,8,19,0,0,0
2025-05-03 00:30,28,21,7,0,0,0
2025-05-03 00:45,12,1,11,0,0,0
2025-05-03 01:00,8,1,7,0,0,0
2025-05-03 01:15,12,6,6,0,0,0
2025-05-03 01:30,6,0,6,0,0,0
2025-05-03 01:45,8,1,7,0,0,0
2025-05-03 02:00,8,2,6,0,0,0
2025-05-03 02:15,6,0,6,0,0,0
2025-05-03 02:30,3,0,3,0,0,0
2025-05-03 02:45,7,0,7,0,0,0
2025-05-03 03:00,8,3,5,0,0,0
2025-05-03 03:15,2,0,2,0,0,0
2025-05-03 03:30,2,1,1,0,0,0
2025-05-03 03:45,1,1,0,0,0,0
2025-05-03 04:00,3,1,2,0,0,0
2025-05-03 04:15,0,0,0,0,0,0
2025-05-03 04:30,0,0,0,0,0,0
2025-05-03 04:45,2,0,2,0,0,0
2025-05-03 05:00,1,1,0,0,0,0
2025-05-03 05:15,2,0,2,0,0,0
2025-05-03 05:30,2,1,1,0,0,0
2025-05-03 05:45,11,7,4,0,0,0
2025-05-03 06:00,4,4,0,0,0,0
2025-05-03 06:15,3,1,2,0,0,0
2025-05-03 06:30,3,2,1,0,0,0
2025-05-03 06:45,13,7,6,0,0,0
2025-05-03 07:00,8,6,2,0,0,0
2025-05-03 07:15,14,9,5,0,0,0
2025-05-03 07:30,19,12,7,0,0,0
2025-05-03 07:45,35,22,13,0,0,0
2025-05-03 08:00,23,14,9,0,0,0
2025-05-03 08:15,32,26,6,0,0,0
2025-05-03 08:30,31,18,13,0,0,0
2025-05-03 08:45,62,42,20,0,0,0
2025-05-03 09:00,49,36,13,0,0,0
2025-05-03 09:15,61,46,15,0,0,0
2025-05-03 09:30,79,62,17,0,0,0
2025-05-03 09:45,109,85,24,0,0,0
2025-05-03 10:00,112,81,31,0,0,0
2025-05-03 10:15,112,76,36,0,0,0
2025-05-03 10:30,118,87,31,0,0,0
2025-05-03 10:45,129,97,32,0,0,0
2025-05-03 11:00,110,79,31,0,0,0
2025-05-03 11:15,124,77,47,0,0,0
2025-05-03 11:30,145,106,39,0,0,0
2025-05-03 11:45,124,80,44,0,0,0
2025-05-03 12:00,116,73,43,0,0,0
2025-05-03 12:15,137,80,57,0,0,0
2025-05-03 12:30,140,84,56,0,0,0
2025-05-03 12:45,160,98,62,0,0,0
2025-05-03 13:00,124,72,52,0,0,0
2025-05-03 13:15,128,75,53,0,0,0
2025-05-03 13:30,128,72,56,0,0,0
2025-05-03 13:45,111,69,42,0,0,0
2025-05-03 14:00,107,52,55,0,0,0
2025-05-03 14:15,112,49,63,0,0,0
2025-05-03 14:30,117,50,67,0,0,0
2025-05-03 14:45,119,48,71,0,0,0
2025-05-03 15:00,155,69,86,0,0,0
2025-05-03 15:15,123,45,78,0,0,0
2025-05-03 15:30,111,54,57,0,0,0
2025-05-03 15:45,99,47,52,0,0,0
2025-05-03 16:00,99,55,44,0,0,0
2025-05-03 16:15,93,47,46,0,0,0
2025-05-03 16:30,111,52,59,0,0,0
2025-05-03 16:45,91,44,47,0,0,0
2025-05-03 17:00,78,34,44,0,0,0
2025-05-03 17:15,65,33,32,0,0,0
2025-05-03 17:30,77,36,41,0,0,0
2025-05-03 17:45,99,56,43,0,0,0
2025-05-03 18:00,78,45,33,0,0,0
2025-05-03 18:15,94,37,57,0,0,0
2025-05-03 18:30,66,28,38,0,0,0
2025-05-03 18:45,83,43,40,0,0,0
2025-05-03 19:00,76,45,31,0,0,0
2025-05-03 19:15,54,34,20,0,0,0
2025-05-03 19:30,52,22,30,0,0,0
2025-05-03 19:45,64,37,27,0,0,0
2025-05-03 20:00,65,36,29,0,0,0
2025-05-03 20:15,42,23,19,0,0,0
2025-05-03 20:30,39,17,22,0,0,0
2025-05-03 20:45,28,17,11,0,0,0
2025-05-03 21:00,40,19,21,0,0,0
2025-05-03 21:15,30,14,16,0,0,0
2025-05-03 21:30,39,17,22,0,0,0
2025-05-03 21:45,40,20,20,0,0,0
2025-05-03 22:00,38,19,19,0,0,0
2025-05-03 22:15,28,14,14,0,0,0
2025-05-03 22:30,33,9,24,0,0,0
2025-05-03 22:45,20,10,10,0,0,0
2025-05-03 23:00,26,10,16,0,0,0
2025-05-03 23:15,26,14,12,0,0,0
2025-05-03 23:30,19,9,10,0,0,0
2025-05-03 23:45,21,7,14,0,0,0
2025-05-04 00:00,16,9,7,0,0,0
2025-05-04 00:15,18,7,11,0,0,0
2025-05-04 00:30,18,6,12,0,0,0
2025-05-04 00:45,18,7,11,0,0,0
2025-05-04 01:00,8,4,4,0,0,0
2025-05-04 01:15,17,6,11,0,0,0
2025-05-04 01:30,4,0,4,0,0,0
2025-05-04 01:45,11,0,11,0,0,0
2025-05-04 02:00,5,2,3,0,0,0
2025-05-04 02:15,1,0,1,0,0,0
2025-05-04 02:30,7,5,2,0,0,0
2025-05-04 02:45,4,1,3,0,0,0
2025-05-04 03:00,3,2,1,0,0,0
2025-05-04 03:15,3,0,3,0,0,0
2025-05-04 03:30,0,0,0,0,0,0
2025-05-04 03:45,4,2,2,0,0,0
2025-05-04 04:00,1,1,0,0,0,0
2025-05-04 04:15,2,2,0,0,0,0
2025-05-04 04:30,3,1,2,0,0,0
2025-05-04 04:45,2,0,2,0,0,0
2025-05-04 05:00,0,0,0,0,0,0
2025-05-04 05:15,2,1,1,0,0,0
2025-05-04 05:30,2,1,1,0,0,0
2025-05-04 05:45,1,0,1,0,0,0
2025-05-04 06:00,1,1,0,0,0,0
2025-05-04 06:15,2,2,0,0,0,0
2025-05-04 06:30,5,3,2,0,0,0
2025-05-04 06:45,5,3,2,0,0,0
2025-05-04 07:00,0,0,0,0,0,0
2025-05-04 07:15,1,0,1,0,0,0
2025-05-04 07:30,6,4,2,0,0,0
2025-05-04 07:45,4,3,1,0,0,0
2025-05-04 08:00,14,10,4,0,0,0
2025-05-04 08:15,10,6,4,0,0,0
2025-05-04 08:30,10,7,3,0,0,0
2025-05-04 08:45,15,7,8,0,0,0
2025-05-04 09:00,17,5,12,0,0,0
2025-05-04 09:15,6,2,4,0,0,0
2025-05-04 09:30,22,13,9,0,0,0
2025-05-04 09:45,41,31,10,0,0,0
2025-05-04 10:00,41,18,23,0,0,0
2025-05-04 10:15,26,16,10,0,0,0
2025-05-04 10:30,35,26,9,0,0,0
2025-05-04 10:45,50,32,18,0,0,0
2025-05-04 11:00,25,13,12,0,0,0
2025-05-04 11:15,22,17,5,0,0,0
2025-05-04 11:30,39,21,18,0,0,0
2025-05-04 11:45,58,32,26,0,0,0
2025-05-04 12:00,39,30,9,0,0,0
2025-05-04 12:15,41,23,18,0,0,0
2025-05-04 12:30,45,30,15,0,0,0
2025-05-04 12:45,57,39,18,0,0,0
2025-05-04 13:00,39,20,19,0,0,0
2025-05-04 13:15,35,12,23,0,0,0
2025-05-04 13:30,57,26,31,0,0,0
2025-05-04 13:45,80,57,23,0,0,0
2025-05-04 14:00,43,30,13,0,0,0
2025-05-04 14:15,52,29,23,0,0,0
2025-05-04 14:30,47,23,24,0,0,0
2025-05-04 14:45,69,35,34,0,0,0
2025-05-04 15:00,44,24,20,0,0,0
2025-05-04 15:15,60,33,27,0,0,0
2025-05-04 15:30,49,29,20,0,0,0
2025-05-04 15:45,39,22,17,0,0,0
2025-05-04 16:00,50,29,21,0,0,0
2025-05-04 16:15,44,23,21,0,0,0
2025-05-04 16:30,42,17,25,0,0,0
2025-05-04 16:45,53,28,25,0,0,0
2025-05-04 17:00,47,29,18,0,0,0
2025-05-04 17:15,37,24,13,0,0,0
2025-05-04 17:30,69,37,32,0,0,0
2025-05-04 17:45,55,24,31,0,0,0
2025-05-04 18:00,48,30,18,0,0,0
2025-05-04 18:15,49,27,22,0,0,0
2025-05-04 18:30,38,21,17,0,0,0
2025-05-04 18:45,49,30,19,0,0,0
2025-05-04 19:00,37,16,21,0,0,0
2025-05-04 19:15,32,16,16,0,0,0
2025-05-04 19:30,42,24,18,0,0,0
2025-05-04 19:45,44,24,20,0,0,0
2025-05-04 20:00,28,19,9,0,0,0
2025-05-04 20:15,24,9,15,0,0,0
2025-05-04 20:30,16,8,8,0,0,0
2025-05-04 20:45,18,8,10,0,0,0
2025-05-04 21:00,27,13,14,0,0,0
2025-05-04 21:15,24,6,18,0,0,0
2025-05-04 21:30,19,11,8,0,0,0
2025-05-04 21:45,25,16,9,0,0,0
2025-05-04 22:00,19,2,17,0,0,0
2025-05-04 22:15,16,9,7,0,0,0
2025-05-04 22:30,8,3,5,0,0,0
2025-05-04 22:45,6,4,2,0,0,0
2025-05-04 23:00,9,4,5,0,0,0
2025-05-04 23:15,9,2,7,0,0,0
2025-05-04 23:30,4,4,0,0,0,0
2025-05-04 23:45,4,1,3,0,0,0
2025-05-05 00:00,1,0,1,0,0,0
2025-05-05 00:15,3,3,0,0,0,0
2025-05-05 00:30,1,0,1,0,0,0
2025-05-05 00:45,4,1,3,0,0,0
2025-05-05 01:00,1,0,1,0,0,0
2025-05-05 01:15,0,0,0,0,0,0
2025-05-05 01:30,0,0,0,0,0,0
2025-05-05 01:45,0,0,0,0,0,0
2025-05-05 02:00,1,1,0,0,0,0
2025-05-05 02:15,0,0,0,0,0,0
2025-05-05 02:30,0,0,0,0,0,0
2025-05-05 02:45,2,1,1,0,0,0
2025-05-05 03:00,2,1,1,0,0,0
2025-05-05 03:15,1,1,0,0,0,0
2025-05-05 03:30,2,1,1,0,0,0
2025-05-05 03:45,0,0,0,0,0,0
2025-05-05 04:00,1,1,0,0,0,0
2025-05-05 04:15,0,0,0,0,0,0
2025-05-05 04:30,0,0,0,0,0,0
2025-05-05 04:45,0,0,0,0,0,0
2025-05-05 05:00,4,3,1,0,0,0
2025-05-05 05:15,6,3,3,0,0,0
2025-05-05 05:30,14,10,4,0,0,0
2025-05-05 05:45,13,9,4,0,0,0
2025-05-05 06:00,13,7,6,0,0,0
2025-05-05 06:15,28,18,10,0,0,0
2025-05-05 06:30,57,38,19,0,0,0
2025-05-05 06:45,64,41,23,0,0,0
2025-05-05 07:00,71,52,19,0,0,0
2025-05-05 07:15,127,93,34,0,0,0
2025-05-05 07:30,235,182,53,0,0,0
2025-05-05 07:45,190,134,56,0,0,0
2025-05-05 08:00,152,116,36,0,0,0
2025-05-05 08:15,125,94,31,0,0,0
2025-05-05 08:30,128,100,28,0,0,0
2025-05-05 08:45,129,100,29,0,0,0
2025-05-05 09:00,88,66,22,0,0,0
2025-05-05 09:15,94,68,26,0,0,0
2025-05-05 09:30,93,64,29,0,0,0
2025-05-05 09:45,124,90,34,0,0,0
2025-05-05 10:00,106,82,24,0,0,0
2025-05-05 10:15,80,53,27,0,0,0
2025-05-05 10:30,85,55,30,0,0,0
2025-05-05 10:45,85,55,30,0,0,0
2025-05-05 11:00,66,50,16,0,0,0
2025-05-05 11:15,97,67,30,0,0,0
2025-05-05 11:30,94,54,40,0,0,0
2025-05-05 11:45,113,74,39,0,0,0
2025-05-05 12:00,94,68,26,0,0,0
2025-05-05 12:15,101,52,49,0,0,0
2025-05-05 12:30,125,58,67,0,0,0
2025-05-05 12:45,121,64,57,0,0,0
2025-05-05 13:00,90,42,48,0,0,0
2025-05-05 13:15,89,42,47,0,0,0
2025-05-05 13:30,104,54,50,0,0,0
2025-05-05 13:45,112,72,40,0,0,0
2025-05-05 14:00,115,59,56,0,0,0
2025-05-05 14:15,120,72,48,0,0,0
2025-05-05 14:30,104,57,47,0,0,0
2025-05-05 14:45,114,61,53,0,0,0
2025-05-05 15:00,134,76,58,0,0,0
2025-05-05 15:15,111,68,43,0,0,0
2025-05-05 15:30,122,57,65,0,0,0
2025-05-05 15:45,127,66,61,0,0,0
2025-05-05 16:00,171,88,83,0,0,0
2025-05-05 16:15,146,73,73,0,0,0
2025-05-05 16:30,138,77,61,0,0,0
2025-05-05 16:45,155,71,84,0,0,0
2025-05-05 17:00,131,64,67,0,0,0
2025-05-05 17:15,146,74,72,0,0,0
2025-05-05 17:30,135,64,71,0,0,0
2025-05-05 17:45,158,76,82,0,0,0
2025-05-05 18:00,153,57,96,0,0,0
2025-05-05 18:15,149,65,84,0,0,0
2025-05-05 18:30,92,53,39,0,0,0
2025-05-05 18:45,106,49,57,0,0,0
2025-05-05 19:00,98,48,50,0,0,0
2025-05-05 19:15,86,44,42,0,0,0
2025-05-05 19:30,76,32,44,0,0,0
2025-05-05 19:45,93,43,50,0,0,0
2025-05-05 20:00,59,19,40,0,0,0
2025-05-05 20:15,51,17,34,0,0,0
2025-05-05 20:30,35,13,22,0,0,0
2025-05-05 20:45,28,14,14,0,0,0
2025-05-05 21:00,37,15,22,0,0,0
2025-05-05 21:15,54,27,27,0,0,0
2025-05-05 21:30,37,10,27,0,0,0
2025-05-05 21:45,33,13,20,0,0,0
2025-05-05 22:00,34,13,21,0,0,0
2025-05-05 22:15,38,18,20,0,0,0
2025-05-05 22:30,20,11,9,0,0,0
2025-05-05 22:45,20,3,17,0,0,0
2025-05-05 23:00,14,7,7,0,0,0
2025-05-05 23:15,17,7,10,0,0,0
2025-05-05 23:30,13,4,9,0,0,0
2025-05-05 23:45,8,2,6,0,0,0
2025-05-06 00:00,6,1,5,0,0,0
2025-05-06 00:15,8,1,7,0,0,0
2025-05-06 00:30,7,0,7,0,0,0
2025-05-06 00:45,9,1,8,0,0,0
2025-05-06 01:00,4,1,3,0,0,0
2025-05-06 01:15,6,0,6,0,0,0
2025-05-06 01:30,2,0,2,0,0,0
2025-05-06 01:45,1,1,0,0,0,0
2025-05-06 02:00,3,0,3,0,0,0
2025-05-06 02:15,0,0,0,0,0,0
2025-05-06 02:30,3,0,3,0,0,0
2025-05-06 02:45,1,0,1,0,0,0
2025-05-06 03:00,0,0,0,0,0,0
2025-05-06 03:15,3,1,2,0,0,0
2025-05-06 03:30,3,0,3,0,0,0
2025-05-06 03:45,0,0,0,0,0,0
2025-05-06 04:00,1,0,1,0,0,0
2025-05-06 04:15,0,0,0,0,0,0
2025-05-06 04:30,0,0,0,0,0,0
2025-05-06 04:45,0,0,0,0,0,0
2025-05-06 05:00,3,2,1,0,0,0
2025-05-06 05:15,5,1,4,0,0,0
2025-05-06 05:30,15,9,6,0,0,0
2025-05-06 05:45,19,10,9,0,0,0
2025-05-06 06:00,10,6,4,0,0,0
2025-05-06 06:15,28,14,14,0,0,0
2025-05-06 06:30,50,34,16,0,0,0
2025-05-06 06:45,60,44,16,0,0,0
2025-05-06 07:00,71,52,19,0,0,0
2025-05-06 07:15,158,120,38,0,0,0
2025-05-06 07:30,225,182,43,0,0,0
2025-05-06 07:45,207,149,58,0,0,0
2025-05-06 08:00,158,115,43,0,0,0
2025-05-06 08:15,152,116,36,0,0,0
2025-05-06 08:30,148,114,34,0,0,0
2025-05-06 08:45,158,131,27,0,0,0
2025-05-06 09:00,81,65,16,0,0,0
2025-05-06 09:15,112,79,33,0,0,0
2025-05-06 09:30,96,82,14,0,0,0
2025-05-06 09:45,137,112,25,0,0,0
2025-05-06 10:00,119,91,28,0,0,0
2025-05-06 10:15,91,64,27,0,0,0
2025-05-06 10:30,68,43,25,0,0,0
2025-05-06 10:45,88,57,31,0,0,0
2025-05-06 11:00,70,46,24,0,0,0
2025-05-06 11:15,88,53,35,0,0,0
2025-05-06 11:30,99,67,32,0,0,0
2025-05-06 11:45,127,81,46,0,0,0
2025-05-06 12:00,95,61,34,0,0,0
2025-05-06 12:15,104,57,47,0,0,0
2025-05-06 12:30,85,41,44,0,0,0
2025-05-06 12:45,99,52,47,0,0,0
2025-05-06 13:00,115,55,60,0,0,0
2025-05-06 13:15,117,63,54,0,0,0
2025-05-06 13:30,84,49,35,0,0,0
2025-05-06 13:45,123,73,50,0,0,0
2025-05-06 14:00,127,61,66,0,0,0
2025-05-06 14:15,96,48,48,0,0,0
2025-05-06 14:30,119,68,51,0,0,0
2025-05-06 14:45,146,86,60,0,0,0
2025-05-06 15:00,125,66,59,0,0,0
2025-05-06 15:15,110,60,50,0,0,0
2025-05-06 15:30,126,68,58,0,0,0
2025-05-06 15:45,163,90,73,0,0,0
2025-05-06 16:00,198,104,94,0,0,0
2025-05-06 16:15,181,94,87,0,0,0
2025-05-06 16:30,155,85,70,0,0,0
2025-05-06 16:45,153,79,74,0,0,0
2025-05-06 17:00,163,89,74,0,0,0
2025-05-06 17:15,159,70,89,0,0,0
2025-05-06 17:30,148,70,78,0,0,0
2025-05-06 17:45,156,77,79,0,0,0
2025-05-06 18:00,157,69,88,0,0,0
2025-05-06 18:15,149,70,79,0,0,0
2025-05-06 18:30,135,70,65,0,0,0
2025-05-06 18:45,114,53,61,0,0,0
2025-05-06 19:00,95,37,58,0,0,0
2025-05-06 19:15,98,52,46,0,0,0
2025-05-06 19:30,81,32,49,0,0,0
2025-05-06 19:45,78,40,38,0,0,0
2025-05-06 20:00,69,37,32,0,0,0
2025-05-06 20:15,54,25,29,0,0,0
2025-05-06 20:30,50,26,24,0,0,0
2025-05-06 20:45,66,30,36,0,0,0
2025-05-06 21:00,49,19,30,0,0,0
2025-05-06 21:15,54,25,29,0,0,0
2025-05-06 21:30,40,20,20,0,0,0
2025-05-06 21:45,42,18,24,0,0,0
2025-05-06 22:00,53,16,37,0,0,0
2025-05-06 22:15,58,17,41,0,0,0
2025-05-06 22:30,34,13,21,0,0,0
2025-05-06 22:45,25,7,18,0,0,0
2025-05-06 23:00,21,9,12,0,0,0
2025-05-06 23:15,12,5,7,0,0,0
2025-05-06 23:30,14,8,6,0,0,0
2025-05-06 23:45,29,20,9,0,0,0
2025-05-07 00:00,7,1,6,0,0,0
2025-05-07 00:15,6,0,6,0,0,0
2025-05-07 00:30,3,1,2,0,0,0
2025-05-07 00:45,3,1,2,0,0,0
2025-05-07 01:00,4,2,2,0,0,0
2025-05-07 01:15,1,0,1,0,0,0
2025-05-07 01:30,2,0,2,0,0,0
2025-05-07 01:45,1,0,1,0,0,0
2025-05-07 02:00,0,0,0,0,0,0
2025-05-07 02:15,1,0,1,0,0,0
2025-05-07 02:30,0,0,0,0,0,0
2025-05-07 02:45,0,0,0,0,0,0
2025-05-07 03:00,1,1,0,0,0,0
2025-05-07 03:15,1,0,1,0,0,0
2025-05-07 03:30,1,0,1,0,0,0
2025-05-07 03:45,2,2,0,0,0,0
2025-05-07 04:00,0,0,0,0,0,0
2025-05-07 04:15,2,2,0,0,0,0
2025-05-07 04:30,0,0,0,0,0,0
2025-05-07 04:45,0,0,0,0,0,0
2025-05-07 05:00,2,1,1,0,0,0
2025-05-07 05:15,7,5,2,0,0,0
2025-05-07 05:30,15,7,8,0,0,0
2025-05-07 05:45,19,13,6,0,0,0
2025-05-07 06:00,10,6,4,0,0,0
2025-05-07 06:15,30,20,10,0,0,0
2025-05-07 06:30,46,33,13,0,0,0
2025-05-07 06:45,61,46,15,0,0,0
2025-05-07 07:00,88,59,29,0,0,0
2025-05-07 07:15,147,105,42,0,0,0
2025-05-07 07:30,206,162,44,0,0,0
2025-05-07 07:45,193,142,51,0,0,0
2025-05-07 08:00,174,134,40,0,0,0
2025-05-07 08:15,151,113,38,0,0,0
2025-05-07 08:30,138,103,35,0,0,0
2025-05-07 08:45,157,126,31,0,0,0
2025-05-07 09:00,102,73,29,0,0,0
2025-05-07 09:15,109,83,26,0,0,0
2025-05-07 09:30,122,101,21,0,0,0
2025-05-07 09:45,146,115,31,0,0,0
2025-05-07 10:00,124,93,31,0,0,0
2025-05-07 10:15,100,79,21,0,0,0
2025-05-07 10:30,114,81,33,0,0,0
2025-05-07 10:45,101,69,32,0,0,0
2025-05-07 11:00,106,68,38,0,0,0
2025-05-07 11:15,114,83,31,0,0,0
2025-05-07 11:30,119,74,45,0,0,0
2025-05-07 11:45,160,113,47,0,0,0
2025-05-07 12:00,122,75,47,0,0,0
2025-05-07 12:15,122,68,54,0,0,0
2025-05-07 12:30,154,91,63,0,0,0
2025-05-07 12:45,134,84,50,0,0,0
2025-05-07 13:00,152,86,66,0,0,0
2025-05-07 13:15,142,63,79,0,0,0
2025-05-07 13:30,127,66,61,0,0,0
2025-05-07 13:45,138,66,72,0,0,0
2025-05-07 14:00,153,72,81,0,0,0
2025-05-07 14:15,140,67,73,0,0,0
2025-05-07 14:30,114,44,70,0,0,0
2025-05-07 14:45,143,87,56,0,0,0
2025-05-07 15:00,153,99,54,0,0,0
2025-05-07 15:15,123,66,57,0,0,0
2025-05-07 15:30,142,72,70,0,0,0
2025-05-07 15:45,142,77,65,0,0,0
2025-05-07 16:00,166,96,70,0,0,0
2025-05-07 16:15,140,84,56,0,0,0
2025-05-07 16:30,144,76,68,0,0,0
2025-05-07 16:45,137,76,61,0,0,0
2025-05-07 17:00,133,61,72,0,0,0
2025-05-07 17:15,131,61,70,0,0,0
2025-05-07 17:30,170,86,84,0,0,0
2025-05-07 17:45,174,68,106,0,0,0
2025-05-07 18:00,145,64,81,0,0,0
2025-05-07 18:15,114,55,59,0,0,0
2025-05-07 18:30,118,67,51,0,0,0
2025-05-07 18:45,139,78,61,0,0,0
2025-05-07 19:00,101,67,34,0,0,0
2025-05-07 19:15,96,53,43,0,0,0
2025-05-07 19:30,88,45,43,0,0,0
2025-05-07 19:45,98,48,50,0,0,0
2025-05-07 20:00,79,32,47,0,0,0
2025-05-07 20:15,53,24,29,0,0,0
2025-05-07 20:30,53,20,33,0,0,0
2025-05-07 20:45,59,25,34,0,0,0
2025-05-07 21:00,69,15,54,0,0,0
2025-05-07 21:15,59,20,39,0,0,0
2025-05-07 21:30,42,20,22,0,0,0
2025-05-07 21:45,49,22,27,0,0,0
2025-05-07 22:00,48,14,34,0,0,0
2025-05-07 22:15,44,8,36,0,0,0
2025-05-07 22:30,38,13,25,0,0,0
2025-05-07 22:45,42,12,30,0,0,0
2025-05-07 23:00,36,15,21,0,0,0
2025-05-07 23:15,23,9,14,0,0,0
2025-05-07 23:30,18,3,15,0,0,0
2025-05-07 23:45,25,9,16,0,0,0
2025-05-08 00:00,13,6,7,0,0,0
2025-05-08 00:15,14,11,3,0,0,0
2025-05-08 00:30,12,9,3,0,0,0
2025-05-08 00:45,1,0,1,0,0,0
2025-05-08 01:00,4,3,1,0,0,0
2025-05-08 01:15,5,0,5,0,0,0
2025-05-08 01:30,5,1,4,0,0,0
2025-05-08 01:45,6,3,3,0,0,0
2025-05-08 02:00,2,0,2,0,0,0
2025-05-08 02:15,3,3,0,0,0,0
2025-05-08 02:30,1,0,1,0,0,0
2025-05-08 02:45,3,0,3,0,0,0
2025-05-08 03:00,2,1,1,0,0,0
2025-05-08 03:15,1,0,1,0,0,0
2025-05-08 03:30,3,0,3,0,0,0
2025-05-08 03:45,1,1,0,0,0,0
2025-05-08 04:00,1,1,0,0,0,0
2025-05-08 04:15,1,0,1,0,0,0
2025-05-08 04:30,3,0,3,0,0,0
2025-05-08 04:45,0,0,0,0,0,0
2025-05-08 05:00,3,2,1,0,0,0
2025-05-08 05:15,8,6,2,0,0,0
2025-05-08 05:30,11,7,4,0,0,0
2025-05-08 05:45,15,8,7,0,0,0
2025-05-08 06:00,15,9,6,0,0,0
2025-05-08 06:15,21,13,8,0,0,0
2025-05-08 06:30,42,28,14,0,0,0
2025-05-08 06:45,66,40,26,0,0,0
2025-05-08 07:00,84,64,20,0,0,0
2025-05-08 07:15,138,99,39,0,0,0
2025-05-08 07:30,228,183,45,0,0,0
2025-05-08 07:45,219,166,53,0,0,0
2025-05-08 08:00,161,115,46,0,0,0
2025-05-08 08:15,132,105,27,0,0,0
2025-05-08 08:30,134,112,22,0,0,0
2025-05-08 08:45,147,105,42,0,0,0
2025-05-08 09:00,88,58,30,0,0,0
2025-05-08 09:15,105,78,27,0,0,0
2025-05-08 09:30,113,87,26,0,0,0
2025-05-08 09:45,162,125,37,0,0,0
2025-05-08 10:00,88,76,12,0,0,0
2025-05-08 10:15,96,69,27,0,0,0
2025-05-08 10:30,92,64,28,0,0,0
2025-05-08 10:45,91,59,32,0,0,0
2025-05-08 11:00,80,57,23,0,0,0
2025-05-08 11:15,106,80,26,0,0,0
2025-05-08 11:30,105,70,35,0,0,0
2025-05-08 11:45,137,90,47,0,0,0
2025-05-08 12:00,114,67,47,0,0,0
2025-05-08 12:15,109,73,36,0,0,0
2025-05-08 12:30,125,66,59,0,0,0
2025-05-08 12:45,95,60,35,0,0,0
2025-05-08 13:00,121,58,63,0,0,0
2025-05-08 13:15,130,62,68,0,0,0
2025-05-08 13:30,118,56,62,0,0,0
2025-05-08 13:45,145,87,58,0,0,0
2025-05-08 14:00,162,85,77,0,0,0
2025-05-08 14:15,133,69,64,0,0,0
2025-05-08 14:30,142,72,70,0,0,0
2025-05-08 14:45,119,57,62,0,0,0
2025-05-08 15:00,142,78,64,0,0,0
2025-05-08 15:15,119,63,56,0,0,0
2025-05-08 15:30,177,92,85,0,0,0
2025-05-08 15:45,192,112,80,0,0,0
2025-05-08 16:00,190,99,91,0,0,0
2025-05-08 16:15,164,93,71,0,0,0
2025-05-08 16:30,151,77,74,0,0,0
2025-05-08 16:45,167,91,76,0,0,0
2025-05-08 17:00,129,66,63,0,0,0
2025-05-08 17:15,136,72,64,0,0,0
2025-05-08 17:30,145,79,66,0,0,0
2025-05-08 17:45,197,92,105,0,0,0
2025-05-08 18:00,145,60,85,0,0,0
2025-05-08 18:15,133,65,68,0,0,0
2025-05-08 18:30,125,69,56,0,0,0
2025-05-08 18:45,146,71,75,0,0,0
2025-05-08 19:00,103,46,57,0,0,0
2025-05-08 19:15,92,43,49,0,0,0
2025-05-08 19:30,97,46,51,0,0,0
2025-05-08 19:45,96,42,54,0,0,0
2025-05-08 20:00,70,27,43,0,0,0
2025-05-08 20:15,44,24,20,0,0,0
2025-05-08 20:30,39,16,23,0,0,0
2025-05-08 20:45,41,12,29,0,0,0
2025-05-08 21:00,55,22,33,0,0,0
2025-05-08 21:15,65,25,40,0,0,0
2025-05-08 21:30,52,24,28,0,0,0
2025-05-08 21:45,60,29,31,0,0,0
2025-05-08 22:00,51,22,29,0,0,0
2025-05-08 22:15,42,19,23,0,0,0
2025-05-08 22:30,45,16,29,0,0,0
2025-05-08 22:45,37,15,22,0,0,0
2025-05-08 23:00,25,8,17,0,0,0
2025-05-08 23:15,24,14,10,0,0,0
2025-05-08 23:30,18,9,9,0,0,0
2025-05-08 23:45,11,9,2,0,0,0
2025-05-09 00:00,4,1,3,0,0,0
2025-05-09 00:15,13,7,6,0,0,0
2025-05-09 00:30,5,3,2,0,0,0
2025-05-09 00:45,1,0,1,0,0,0
2025-05-09 01:00,3,2,1,0,0,0
2025-05-09 01:15,3,1,2,0,0,0
2025-05-09 01:30,3,0,3,0,0,0
2025-05-09 01:45,2,1,1,0,0,0
2025-05-09 02:00,1,1,0,0,0,0
2025-05-09 02:15,2,0,2,0,0,0
2025-05-09 02:30,0,0,0,0,0,0
2025-05-09 02:45,0,0,0,0,0,0
2025-05-09 03:00,0,0,0,0,0,0
2025-05-09 03:15,1,0,1,0,0,0
2025-05-09 03:30,1,0,1,0,0,0
2025-05-09 03:45,1,1,0,0,0,0
2025-05-09 04:00,2,1,1,0,0,0
2025-05-09 04:15,0,0,0,0,0,0
2025-05-09 04:30,1,0,1,0,0,0
2025-05-09 04:45,0,0,0,0,0,0
2025-05-09 05:00,5,2,3,0,0,0
2025-05-09 05:15,3,2,1,0,0,0
2025-05-09 05:30,11,7,4,0,0,0
2025-05-09 05:45,12,7,5,0,0,0
2025-05-09 06:00,18,10,8,0,0,0
2025-05-09 06:15,14,10,4,0,0,0
2025-05-09 06:30,31,21,10,0,0,0
2025-05-09 06:45,61,47,14,0,0,0
2025-05-09 07:00,69,50,19,0,0,0
2025-05-09 07:15,125,86,39,0,0,0
2025-05-09 07:30,190,147,43,0,0,0
2025-05-09 07:45,169,132,37,0,0,0
2025-05-09 08:00,108,85,23,0,0,0
2025-05-09 08:15,124,98,26,0,0,0
2025-05-09 08:30,109,90,19,0,0,0
2025-05-09 08:45,127,101,26,0,0,0
2025-05-09 09:00,82,55,27,0,0,0
2025-05-09 09:15,89,64,25,0,0,0
2025-05-09 09:30,105,84,21,0,0,0
2025-05-09 09:45,106,79,27,0,0,0
2025-05-09 10:00,99,74,25,0,0,0
2025-05-09 10:15,94,56,38,0,0,0
2025-05-09 10:30,88,59,29,0,0,0
2025-05-09 10:45,107,74,33,0,0,0
2025-05-09 11:00,95,57,38,0,0,0
2025-05-09 11:15,85,57,28,0,0,0
2025-05-09 11:30,111,73,38,0,0,0
2025-05-09 11:45,128,84,44,0,0,0
2025-05-09 12:00,116,70,46,0,0,0
2025-05-09 12:15,105,63,42,0,0,0
2025-05-09 12:30,134,59,75,0,0,0
2025-05-09 12:45,155,80,75,0,0,0
2025-05-09 13:00,125,48,77,0,0,0
2025-05-09 13:15,123,61,62,0,0,0
2025-05-09 13:30,126,64,62,0,0,0
2025-05-09 13:45,122,60,62,0,0,0
2025-05-09 14:00,144,68,76,0,0,0
2025-05-09 14:15,139,65,74,0,0,0
2025-05-09 14:30,134,85,49,0,0,0
2025-05-09 14:45,148,72,76,0,0,0
2025-05-09 15:00,131,70,61,0,0,0
2025-05-09 15:15,165,90,75,0,0,0
2025-05-09 15:30,127,58,69,0,0,0
2025-05-09 15:45,164,96,68,0,0,0
2025-05-09 16:00,133,73,60,0,0,0
2025-05-09 16:15,132,72,60,0,0,0
2025-05-09 16:30,122,59,63,0,0,0
2025-05-09 16:45,147,79,68,0,0,0
2025-05-09 17:00,108,54,54,0,0,0
2025-05-09 17:15,154,76,78,0,0,0
2025-05-09 17:30,129,71,58,0,0,0
2025-05-09 17:45,139,74,65,0,0,0
2025-05-09 18:00,145,75,70,0,0,0
2025-05-09 18:15,115,70,45,0,0,0
2025-05-09 18:30,94,55,39,0,0,0
2025-05-09 18:45,124,60,64,0,0,0
2025-05-09 19:00,77,47,30,0,0,0
2025-05-09 19:15,96,50,46,0,0,0
2025-05-09 19:30,70,35,35,0,0,0
2025-05-09 19:45,73,38,35,0,0,0
2025-05-09 20:00,72,35,37,0,0,0
2025-05-09 20:15,69,42,27,0,0,0
2025-05-09 20:30,50,20,30,0,0,0
2025-05-09 20:45,50,17,33,0,0,0
2025-05-09 21:00,51,20,31,0,0,0
2025-05-09 21:15,70,37,33,0,0,0
2025-05-09 21:30,51,28,23,0,0,0
2025-05-09 21:45,50,26,24,0,0,0
2025-05-09 22:00,48,19,29,0,0,0
2025-05-09 22:15,53,27,26,0,0,0
2025-05-09 22:30,40,13,27,0,0,0
2025-05-09 22:45,52,17,35,0,0,0
2025-05-09 23:00,45,14,31,0,0,0
2025-05-09 23:15,40,13,27,0,0,0
2025-05-09 23:30,32,7,25,0,0,0
2025-05-09 23:45,41,13,28,0,0,0
2025-05-10 00:00,40,13,27,0,0,0
2025-05-10 00:15,14,4,10,0,0,0
2025-05-10 00:30,23,7,16,0,0,0
2025-05-10 00:45,22,7,15,0,0,0
2025-05-10 01:00,20,5,15,0,0,0
2025-05-10 01:15,21,8,13,0,0,0
2025-05-10 01:30,9,1,8,0,0,0
2025-05-10 01:45,12,3,9,0,0,0
2025-05-10 02:00,12,1,11,0,0,0
2025-05-10 02:15,10,1,9,0,0,0
2025-05-10 02:30,6,1,5,0,0,0
2025-05-10 02:45,12,2,10,0,0,0
2025-05-10 03:00,7,1,6,0,0,0
2025-05-10 03:15,5,0,5,0,0,0
2025-05-10 03:30,10,2,8,0,0,0
2025-05-10 03:45,3,2,1,0,0,0
2025-05-10 04:00,3,0,3,0,0,0
2025-05-10 04:15,3,0,3,0,0,0
2025-05-10 04:30,1,1,0,0,0,0
2025-05-10 04:45,3,2,1,0,0,0
2025-05-10 05:00,2,1,1,0,0,0
2025-05-10 05:15,4,2,2,0,0,0
2025-05-10 05:30,6,3,3,0,0,0
2025-05-10 05:45,11,5,6,0,0,0
2025-05-10 06:00,2,1,1,0,0,0
2025-05-10 06:15,3,3,0,0,0,0
2025-05-10 06:30,7,6,1,0,0,0
2025-05-10 06:45,21,17,4,0,0,0
2025-05-10 07:00,14,12,2,0,0,0
2025-05-10 07:15,23,17,6,0,0,0
2025-05-10 07:30,31,20,11,0,0,0
2025-05-10 07:45,31,27,4,0,0,0
2025-05-10 08:00,28,21,7,0,0,0
2025-05-10 08:15,43,32,11,0,0,0
2025-05-10 08:30,57,43,14,0,0,0
2025-05-10 08:45,72,51,21,0,0,0
2025-05-10 09:00,68,39,29,0,0,0
2025-05-10 09:15,67,47,20,0,0,0
2025-05-10 09:30,88,68,20,0,0,0
2025-05-10 09:45,113,89,24,0,0,0
2025-05-10 10:00,95,71,24,0,0,0
2025-05-10 10:15,126,88,38,0,0,0
2025-05-10 10:30,153,110,43,0,0,0
2025-05-10 10:45,119,85,34,0,0,0
2025-05-10 11:00,118,90,28,0,0,0
2025-05-10 11:15,135,96,39,0,0,0
2025-05-10 11:30,124,89,35,0,0,0
2025-05-10 11:45,157,109,48,0,0,0
2025-05-10 12:00,125,78,47,0,0,0
2025-05-10 12:15,172,106,66,0,0,0
2025-05-10 12:30,141,81,60,0,0,0
2025-05-10 12:45,129,66,63,0,0,0
2025-05-10 13:00,129,71,58,0,0,0
2025-05-10 13:15,134,74,60,0,0,0
2025-05-10 13:30,143,69,74,0,0,0
2025-05-10 13:45,124,69,55,0,0,0
2025-05-10 14:00,156,67,89,0,0,0
2025-05-10 14:15,142,55,87,0,0,0
2025-05-10 14:30,115,42,73,0,0,0
2025-05-10 14:45,111,50,61,0,0,0
2025-05-10 15:00,122,48,74,0,0,0
2025-05-10 15:15,98,45,53,0,0,0
2025-05-10 15:30,109,49,60,0,0,0
2025-05-10 15:45,93,39,54,0,0,0
2025-05-10 16:00,86,53,33,0,0,0
2025-05-10 16:15,96,47,49,0,0,0
2025-05-10 16:30,74,40,34,0,0,0
2025-05-10 16:45,96,47,49,0,0,0
2025-05-10 17:00,94,49,45,0,0,0
2025-05-10 17:15,88,45,43,0,0,0
2025-05-10 17:30,84,40,44,0,0,0
2025-05-10 17:45,111,63,48,0,0,0
2025-05-10 18:00,92,43,49,0,0,0
2025-05-10 18:15,93,47,46,0,0,0
2025-05-10 18:30,96,59,37,0,0,0
2025-05-10 18:45,94,50,44,0,0,0
2025-05-10 19:00,86,55,31,0,0,0
2025-05-10 19:15,77,41,36,0,0,0
2025-05-10 19:30,68,31,37,0,0,0
2025-05-10 19:45,46,24,22,0,0,0
2025-05-10 20:00,60,24,36,0,0,0
2025-05-10 20:15,50,33,17,0,0,0
2025-05-10 20:30,51,20,31,0,0,0
2025-05-10 20:45,40,14,26,0,0,0
2025-05-10 21:00,47,12,35,0,0,0
2025-05-10 21:15,45,16,29,0,0,0
2025-05-10 21:30,30,20,10,0,0,0
2025-05-10 21:45,40,17,23,0,0,0
2025-05-10 22:00,42,22,20,0,0,0
2025-05-10 22:15,34,11,23,0,0,0
2025-05-10 22:30,16,6,10,0,0,0
2025-05-10 22:45,43,20,23,0,0,0
2025-05-10 23:00,45,21,24,0,0,0
2025-05-10 23:15,31,14,17,0,0,0
2025-05-10 23:30,30,15,15,0,0,0
2025-05-10 23:45,17,8,9,0,0,0
2025-05-11 00:00,21,11,10,0,0,0
2025-05-11 00:15,16,3,13,0,0,0
2025-05-11 00:30,19,9,10,0,0,0
2025-05-11 00:45,18,4,14,0,0,0
2025-05-11 01:00,13,4,9,0,0,0
2025-05-11 01:15,15,7,8,0,0,0
2025-05-11 01:30,11,2,9,0,0,0
2025-05-11 01:45,7,3,4,0,0,0
2025-05-11 02:00,6,2,4,0,0,0
2025-05-11 02:15,9,3,6,0,0,0
2025-05-11 02:30,6,1,5,0,0,0
2025-05-11 02:45,7,2,5,0,0,0
2025-05-11 03:00,12,5,7,0,0,0
2025-05-11 03:15,3,1,2,0,0,0
2025-05-11 03:30,3,1,2,0,0,0
2025-05-11 03:45,4,1,3,0,0,0
2025-05-11 04:00,4,1,3,0,0,0
2025-05-11 04:15,1,1,0,0,0,0
2025-05-11 04:30,2,0,2,0,0,0
2025-05-11 04:45,4,0,4,0,0,0
2025-05-11 05:00,4,1,3,0,0,0
2025-05-11 05:15,5,2,3,0,0,0
2025-05-11 05:30,7,3,4,0,0,0
2025-05-11 05:45,3,1,2,0,0,0
2025-05-11 06:00,5,1,4,0,0,0
2025-05-11 06:15,4,3,1,0,0,0
2025-05-11 06:30,5,5,0,0,0,0
2025-05-11 06:45,3,1,2,0,0,0
2025-05-11 07:00,2,1,1,0,0,0
2025-05-11 07:15,5,5,0,0,0,0
2025-05-11 07:30,5,3,2,0,0,0
2025-05-11 07:45,5,3,2,0,0,0
2025-05-11 08:00,6,5,1,0,0,0
2025-05-11 08:15,12,6,6,0,0,0
2025-05-11 08:30,17,12,5,0,0,0
2025-05-11 08:45,20,13,7,0,0,0
2025-05-11 09:00,21,8,13,0,0,0
2025-05-11 09:15,24,16,8,0,0,0
2025-05-11 09:30,36,24,12,0,0,0
2025-05-11 09:45,48,34,14,0,0,0
2025-05-11 10:00,28,21,7,0,0,0
2025-05-11 10:15,46,28,18,0,0,0
2025-05-11 10:30,39,21,18,0,0,0
2025-05-11 10:45,55,31,24,0,0,0
2025-05-11 11:00,39,24,15,0,0,0
2025-05-11 11:15,60,43,17,0,0,0
2025-05-11 11:30,51,31,20,0,0,0
2025-05-11 11:45,61,41,20,0,0,0
2025-05-11 12:00,44,22,22,0,0,0
2025-05-11 12:15,50,24,26,0,0,0
2025-05-11 12:30,56,33,23,0,0,0
2025-05-11 12:45,69,46,23,0,0,0
2025-05-11 13:00,67,39,28,0,0,0
2025-05-11 13:15,66,38,28,0,0,0
2025-05-11 13:30,79,35,44,0,0,0
2025-05-11 13:45,69,41,28,0,0,0
2025-05-11 14:00,52,22,30,0,0,0
2025-05-11 14:15,91,48,43,0,0,0
2025-05-11 14:30,67,37,30,0,0,0
2025-05-11 14:45,80,45,35,0,0,0
2025-05-11 15:00,79,46,33,0,0,0
2025-05-11 15:15,63,43,20,0,0,0
2025-05-11 15:30,65,39,26,0,0,0
2025-05-11 15:45,76,40,36,0,0,0
2025-05-11 16:00,52,23,29,0,0,0
2025-05-11 16:15,77,46,31,0,0,0
2025-05-11 16:30,60,42,18,0,0,0
2025-05-11 16:45,74,26,48,0,0,0
2025-05-11 17:00,73,44,29,0,0,0
2025-05-11 17:15,66,32,34,0,0,0
2025-05-11 17:30,77,46,31,0,0,0
2025-05-11 17:45,84,49,35,0,0,0
2025-05-11 18:00,64,34,30,0,0,0
2025-05-11 18:15,49,27,22,0,0,0
2025-05-11 18:30,57,32,25,0,0,0
2025-05-11 18:45,48,35,13,0,0,0
2025-05-11 19:00,62,31,31,0,0,0
2025-05-11 19:15,57,32,25,0,0,0
2025-05-11 19:30,46,33,13,0,0,0
2025-05-11 19:45,46,29,17,0,0,0
2025-05-11 20:00,46,26,20,0,0,0
2025-05-11 20:15,33,15,18,0,0,0
2025-05-11 20:30,34,13,21,0,0,0
2025-05-11 20:45,43,15,28,0,0,0
2025-05-11 21:00,32,11,21,0,0,0
2025-05-11 21:15,20,6,14,0,0,0
2025-05-11 21:30,24,12,12,0,0,0
2025-05-11 21:45,31,8,23,0,0,0
2025-05-11 22:00,28,10,18,0,0,0
2025-05-11 22:15,20,16,4,0,0,0
2025-05-11 22:30,18,8,10,0,0,0
2025-05-11 22:45,9,5,4,0,0,0
2025-05-11 23:00,10,5,5,0,0,0
2025-05-11 23:15,6,4,2,0,0,0
2025-05-11 23:30,3,0,3,0,0,0
2025-05-11 23:45,4,4,0,0,0,0
2025-05-12 00:00,5,0,5,0,0,0
2025-05-12 00:15,5,2,3,0,0,0
2025-05-12 00:30,3,0,3,0,0,0
2025-05-12 00:45,1,1,0,0,0,0
2025-05-12 01:00,5,4,1,0,0,0
2025-05-12 01:15,1,0,1,0,0,0
2025-05-12 01:30,1,1,0,0,0,0
2025-05-12 01:45,0,0,0,0,0,0
2025-05-12 02:00,1,0,1,0,0,0
2025-05-12 02:15,0,0,0,0,0,0
2025-05-12 02:30,0,0,0,0,0,0
2025-05-12 02:45,1,0,1,0,0,0
2025-05-12 03:00,2,2,0,0,0,0
2025-05-12 03:15,0,0,0,0,0,0
2025-05-12 03:30,1,0,1,0,0,0
2025-05-12 03:45,1,0,1,0,0,0
2025-05-12 04:00,0,0,0,0,0,0
2025-05-12 04:15,1,1,0,0,0,0
2025-05-12 04:30,0,0,0,0,0,0
2025-05-12 04:45,1,0,1,0,0,0
2025-05-12 05:00,2,2,0,0,0,0
2025-05-12 05:15,5,3,2,0,0,0
2025-05-12 05:30,18,10,8,0,0,0
2025-05-12 05:45,14,8,6,0,0,0
2025-05-12 06:00,11,10,1,0,0,0
2025-05-12 06:15,28,15,13,0,0,0
2025-05-12 06:30,40,33,7,0,0,0
2025-05-12 06:45,55,40,15,0,0,0
2025-05-12 07:00,79,51,28,0,0,0
2025-05-12 07:15,117,82,35,0,0,0
2025-05-12 07:30,239,177,62,0,0,0
2025-05-12 07:45,200,150,50,0,0,0
2025-05-12 08:00,156,122,34,0,0,0
2025-05-12 08:15,154,112,42,0,0,0
2025-05-12 08:30,141,108,33,0,0,0
2025-05-12 08:45,135,100,35,0,0,0
2025-05-12 09:00,96,71,25,0,0,0
2025-05-12 09:15,87,53,34,0,0,0
2025-05-12 09:30,89,68,21,0,0,0
2025-05-12 09:45,130,104,26,0,0,0
2025-05-12 10:00,101,76,25,0,0,0
2025-05-12 10:15,90,49,41,0,0,0
2025-05-12 10:30,92,60,32,0,0,0
2025-05-12 10:45,98,66,32,0,0,0
2025-05-12 11:00,82,60,22,0,0,0
2025-05-12 11:15,104,65,39,0,0,0
2025-05-12 11:30,95,58,37,0,0,0
2025-05-12 11:45,115,67,48,0,0,0
2025-05-12 12:00,101,57,44,0,0,0
2025-05-12 12:15,102,57,45,0,0,0
2025-05-12 12:30,130,71,59,0,0,0
2025-05-12 12:45,103,62,41,0,0,0
2025-05-12 13:00,117,61,56,0,0,0
2025-05-12 13:15,109,51,58,0,0,0
2025-05-12 13:30,129,69,60,0,0,0
2025-05-12 13:45,131,85,46,0,0,0
2025-05-12 14:00,111,49,62,0,0,0
2025-05-12 14:15,107,59,48,0,0,0
2025-05-12 14:30,110,58,52,0,0,0
2025-05-12 14:45,140,86,54,0,0,0
2025-05-12 15:00,136,77,59,0,0,0
2025-05-12 15:15,128,77,51,0,0,0
2025-05-12 15:30,126,63,63,0,0,0
2025-05-12 15:45,160,82,78,0,0,0
2025-05-12 16:00,172,91,81,0,0,0
2025-05-12 16:15,180,87,93,0,0,0
2025-05-12 16:30,174,93,81,0,0,0
2025-05-12 16:45,120,65,55,0,0,0
2025-05-12 17:00,159,76,83,0,0,0
2025-05-12 17:15,131,64,67,0,0,0
2025-05-12 17:30,138,68,70,0,0,0
2025-05-12 17:45,175,81,94,0,0,0
2025-05-12 18:00,163,75,88,0,0,0
2025-05-12 18:15,135,72,63,0,0,0
2025-05-12 18:30,103,56,47,0,0,0
2025-05-12 18:45,95,34,61,0,0,0
2025-05-12 19:00,96,39,57,0,0,0
2025-05-12 19:15,93,50,43,0,0,0
2025-05-12 19:30,84,36,48,0,0,0
2025-05-12 19:45,108,49,59,0,0,0
2025-05-12 20:00,87,28,59,0,0,0
2025-05-12 20:15,54,21,33,0,0,0
2025-05-12 20:30,70,36,34,0,0,0
2025-05-12 20:45,62,26,36,0,0,0
2025-05-12 21:00,31,13,18,0,0,0
2025-05-12 21:15,46,14,32,0,0,0
2025-05-12 21:30,45,20,25,0,0,0
2025-05-12 21:45,55,19,36,0,0,0
2025-05-12 22:00,50,15,35,0,0,0
2025-05-12 22:15,36,18,18,0,0,0
2025-05-12 22:30,30,14,16,0,0,0
2025-05-12 22:45,22,15,7,0,0,0
2025-05-12 23:00,15,5,10,0,0,0
2025-05-12 23:15,14,7,7,0,0,0
2025-05-12 23:30,12,3,9,0,0,0
2025-05-12 23:45,3,0,3,0,0,0
2025-05-13 00:00,5,2,3,0,0,0
2025-05-13 00:15,5,5,0,0,0,0
2025-05-13 00:30,5,1,4,0,0,0
2025-05-13 00:45,1,0,1,0,0,0
2025-05-13 01:00,1,0,1,0,0,0
2025-05-13 01:15,1,1,0,0,0,0
2025-05-13 01:30,1,0,1,0,0,0
2025-05-13 01:45,0,0,0,0,0,0
2025-05-13 02:00,0,0,0,0,0,0
2025-05-13 02:15,1,1,0,0,0,0
2025-05-13 02:30,1,0,1,0,0,0
2025-05-13 02:45,0,0,0,0,0,0
2025-05-13 03:00,0,0,0,0,0,0
2025-05-13 03:15,1,0,1,0,0,0
2025-05-13 03:30,0,0,0,0,0,0
2025-05-13 03:45,0,0,0,0,0,0
2025-05-13 04:00,2,2,0,0,0,0
2025-05-13 04:15,1,1,0,0,0,0
2025-05-13 04:30,2,1,1,0,0,0
2025-05-13 04:45,0,0,0,0,0,0
2025-05-13 05:00,4,3,1,0,0,0
2025-05-13 05:15,4,3,1,0,0,0
2025-05-13 05:30,17,8,9,0,0,0
2025-05-13 05:45,15,6,9,0,0,0
2025-05-13 06:00,14,8,6,0,0,0
2025-05-13 06:15,34,21,13,0,0,0
2025-05-13 06:30,39,28,11,0,0,0
2025-05-13 06:45,59,43,16,0,0,0
2025-05-13 07:00,66,51,15,0,0,0
2025-05-13 07:15,142,101,41,0,0,0
2025-05-13 07:30,231,175,56,0,0,0
2025-05-13 07:45,197,150,47,0,0,0
2025-05-13 08:00,165,127,38,0,0,0
2025-05-13 08:15,177,124,53,0,0,0
2025-05-13 08:30,133,105,28,0,0,0
2025-05-13 08:45,180,137,43,0,0,0
2025-05-13 09:00,111,80,31,0,0,0
2025-05-13 09:15,93,64,29,0,0,0
2025-05-13 09:30,98,75,23,0,0,0
2025-05-13 09:45,173,133,40,0,0,0
2025-05-13 10:00,104,79,25,0,0,0
2025-05-13 10:15,77,50,27,0,0,0
2025-05-13 10:30,107,74,33,0,0,0
2025-05-13 10:45,113,79,34,0,0,0
2025-05-13 11:00,88,60,28,0,0,0
2025-05-13 11:15,100,58,42,0,0,0
2025-05-13 11:30,104,69,35,0,0,0
2025-05-13 11:45,126,73,53,0,0,0
2025-05-13 12:00,107,62,45,0,0,0
2025-05-13 12:15,99,52,47,0,0,0
2025-05-13 12:30,111,49,62,0,0,0
2025-05-13 12:45,105,59,46,0,0,0
2025-05-13 13:00,111,61,50,0,0,0
2025-05-13 13:15,114,56,58,0,0,0
2025-05-13 13:30,104,57,47,0,0,0
2025-05-13 13:45,122,64,58,0,0,0
2025-05-13 14:00,157,80,77,0,0,0
2025-05-13 14:15,121,56,65,0,0,0
2025-05-13 14:30,122,55,67,0,0,0
2025-05-13 14:45,138,73,65,0,0,0
2025-05-13 15:00,146,86,60,0,0,0
2025-05-13 15:15,149,80,69,0,0,0
2025-05-13 15:30,148,75,73,0,0,0
2025-05-13 15:45,185,107,78,0,0,0
2025-05-13 16:00,197,99,98,0,0,0
2025-05-13 16:15,161,92,69,0,0,0
2025-05-13 16:30,172,82,90,0,0,0
2025-05-13 16:45,194,99,95,0,0,0
2025-05-13 17:00,161,65,96,0,0,0
2025-05-13 17:15,177,78,99,0,0,0
2025-05-13 17:30,159,78,81,0,0,0
2025-05-13 17:45,184,93,91,0,0,0
2025-05-13 18:00,166,82,84,0,0,0
2025-05-13 18:15,152,65,87,0,0,0
2025-05-13 18:30,133,66,67,0,0,0
2025-05-13 18:45,141,71,70,0,0,0
2025-05-13 19:00,116,65,51,0,0,0
2025-05-13 19:15,93,42,51,0,0,0
2025-05-13 19:30,84,37,47,0,0,0
2025-05-13 19:45,108,41,67,0,0,0
2025-05-13 20:00,90,35,55,0,0,0
2025-05-13 20:15,78,30,48,0,0,0
2025-05-13 20:30,53,22,31,0,0,0
2025-05-13 20:45,56,21,35,0,0,0
2025-05-13 21:00,49,16,33,0,0,0
2025-05-13 21:15,34,14,20,0,0,0
2025-05-13 21:30,45,16,29,0,0,0
2025-05-13 21:45,56,19,37,0,0,0
2025-05-13 22:00,65,31,34,0,0,0
2025-05-13 22:15,40,16,24,0,0,0
2025-05-13 22:30,42,7,35,0,0,0
2025-05-13 22:45,23,8,15,0,0,0
2025-05-13 23:00,21,10,11,0,0,0
2025-05-13 23:15,14,8,6,0,0,0
2025-05-13 23:30,19,4,15,0,0,0
2025-05-13 23:45,14,6,8,0,0,0
2025-05-14 00:00,4,1,3,0,0,0
2025-05-14 00:15,7,3,4,0,0,0
2025-05-14 00:30,6,3,3,0,0,0
2025-05-14 00:45,5,2,3,0,0,0
2025-05-14 01:00,5,1,4,0,0,0
2025-05-14 01:15,4,1,3,0,0,0
2025-05-14 01:30,3,0,3,0,0,0
2025-05-14 01:45,2,1,1,0,0,0
2025-05-14 02:00,0,0,0,0,0,0
2025-05-14 02:15,0,0,0,0,0,0
2025-05-14 02:30,0,0,0,0,0,0
2025-05-14 02:45,4,0,4,0,0,0
2025-05-14 03:00,1,0,1,0,0,0
2025-05-14 03:15,1,0,1,0,0,0
2025-05-14 03:30,0,0,0,0,0,0
2025-05-14 03:45,1,1,0,0,0,0
2025-05-14 04:00,2,1,1,0,0,0
2025-05-14 04:15,0,0,0,0,0,0
2025-05-14 04:30,1,1,0,0,0,0
2025-05-14 04:45,1,0,1,0,0,0
2025-05-14 05:00,4,3,1,0,0,0
2025-05-14 05:15,6,6,0,0,0,0
2025-05-14 05:30,18,8,10,0,0,0
2025-05-14 05:45,18,11,7,0,0,0
2025-05-14 06:00,12,5,7,0,0,0
2025-05-14 06:15,26,15,11,0,0,0
2025-05-14 06:30,48,32,16,0,0,0
2025-05-14 06:45,63,40,23,0,0,0
2025-05-14 07:00,89,66,23,0,0,0
2025-05-14 07:15,164,111,53,0,0,0
2025-05-14 07:30,214,164,50,0,0,0
2025-05-14 07:45,217,162,55,0,0,0
2025-05-14 08:00,146,103,43,0,0,0
2025-05-14 08:15,171,125,46,0,0,0
2025-05-14 08:30,158,122,36,0,0,0
2025-05-14 08:45,165,129,36,0,0,0
2025-05-14 09:00,98,78,20,0,0,0
2025-05-14 09:15,107,72,35,0,0,0
2025-05-14 09:30,125,102,23,0,0,0
2025-05-14 09:45,132,102,30,0,0,0
2025-05-14 10:00,117,87,30,0,0,0
2025-05-14 10:15,100,73,27,0,0,0
2025-05-14 10:30,114,79,35,0,0,0
2025-05-14 10:45,106,74,32,0,0,0
2025-05-14 11:00,106,65,41,0,0,0
2025-05-14 11:15,115,75,40,0,0,0
2025-05-14 11:30,115,77,38,0,0,0
2025-05-14 11:45,137,96,41,0,0,0
2025-05-14 12:00,130,69,61,0,0,0
2025-05-14 12:15,133,72,61,0,0,0
2025-05-14 12:30,121,58,63,0,0,0
2025-05-14 12:45,133,57,76,0,0,0
2025-05-14 13:00,140,58,82,0,0,0
2025-05-14 13:15,118,58,60,0,0,0
2025-05-14 13:30,150,87,63,0,0,0
2025-05-14 13:45,170,86,84,0,0,0
2025-05-14 14:00,135,74,61,0,0,0
2025-05-14 14:15,138,59,79,0,0,0
2025-05-14 14:30,103,43,60,0,0,0
2025-05-14 14:45,153,67,86,0,0,0
2025-05-14 15:00,133,67,66,0,0,0
2025-05-14 15:15,139,83,56,0,0,0
2025-05-14 15:30,165,75,90,0,0,0
2025-05-14 15:45,195,107,88,0,0,0
2025-05-14 16:00,180,92,88,0,0,0
2025-05-14 16:15,142,64,78,0,0,0
2025-05-14 16:30,161,70,91,0,0,0
2025-05-14 16:45,166,88,78,0,0,0
2025-05-14 17:00,146,71,75,0,0,0
2025-05-14 17:15,163,74,89,0,0,0
2025-05-14 17:30,161,86,75,0,0,0
2025-05-14 17:45,194,77,117,0,0,0
2025-05-14 18:00,126,52,74,0,0,0
2025-05-14 18:15,127,63,64,0,0,0
2025-05-14 18:30,126,61,65,0,0,0
2025-05-14 18:45,145,82,63,0,0,0
2025-05-14 19:00,90,39,51,0,0,0
2025-05-14 19:15,87,43,44,0,0,0
2025-05-14 19:30,72,27,45,0,0,0
2025-05-14 19:45,112,59,53,0,0,0
2025-05-14 20:00,81,42,39,0,0,0
2025-05-14 20:15,70,34,36,0,0,0
2025-05-14 20:30,57,27,30,0,0,0
2025-05-14 20:45,68,31,37,0,0,0
2025-05-14 21:00,53,22,31,0,0,0
2025-05-14 21:15,61,22,39,0,0,0
2025-05-14 21:30,45,25,20,0,0,0
2025-05-14 21:45,41,20,21,0,0,0
2025-05-14 22:00,50,11,39,0,0,0
2025-05-14 22:15,49,8,41,0,0,0
2025-05-14 22:30,33,10,23,0,0,0
2025-05-14 22:45,26,11,15,0,0,0
2025-05-14 23:00,27,12,15,0,0,0
2025-05-14 23:15,17,4,13,0,0,0
2025-05-14 23:30,21,7,14,0,0,0
2025-05-14 23:45,13,7,6,0,0,0
2025-05-15 00:00,12,5,7,0,0,0
2025-05-15 00:15,9,3,6,0,0,0
2025-05-15 00:30,11,4,7,0,0,0
2025-05-15 00:45,10,2,8,0,0,0
2025-05-15 01:00,3,0,3,0,0,0
2025-05-15 01:15,5,0,5,0,0,0
2025-05-15 01:30,8,3,5,0,0,0
2025-05-15 01:45,1,0,1,0,0,0
2025-05-15 02:00,4,0,4,0,0,0
2025-05-15 02:15,3,0,3,0,0,0
2025-05-15 02:30,2,2,0,0,0,0
2025-05-15 02:45,2,1,1,0,0,0
2025-05-15 03:00,4,0,4,0,0,0
2025-05-15 03:15,2,1,1,0,0,0
2025-05-15 03:30,1,0,1,0,0,0
2025-05-15 03:45,2,0,2,0,0,0
2025-05-15 04:00,2,1,1,0,0,0
2025-05-15 04:15,4,1,3,0,0,0
2025-05-15 04:30,1,1,0,0,0,0
2025-05-15 04:45,0,0,0,0,0,0
2025-05-15 05:00,5,3,2,0,0,0
2025-05-15 05:15,2,2,0,0,0,0
2025-05-15 05:30,11,4,7,0,0,0
2025-05-15 05:45,15,7,8,0,0,0
2025-05-15 06:00,11,4,7,0,0,0
2025-05-15 06:15,39,22,17,0,0,0
2025-05-15 06:30,45,29,16,0,0,0
2025-05-15 06:45,56,42,14,0,0,0
2025-05-15 07:00,79,55,24,0,0,0
2025-05-15 07:15,141,102,39,0,0,0
2025-05-15 07:30,213,160,53,0,0,0
2025-05-15 07:45,199,149,50,0,0,0
2025-05-15 08:00,164,123,41,0,0,0
2025-05-15 08:15,147,110,37,0,0,0
2025-05-15 08:30,138,101,37,0,0,0
2025-05-15 08:45,161,121,40,0,0,0
2025-05-15 09:00,89,58,31,0,0,0
2025-05-15 09:15,87,69,18,0,0,0
2025-05-15 09:30,100,74,26,0,0,0
2025-05-15 09:45,142,115,27,0,0,0
2025-05-15 10:00,104,81,23,0,0,0
2025-05-15 10:15,83,55,28,0,0,0
2025-05-15 10:30,92,62,30,0,0,0
2025-05-15 10:45,90,59,31,0,0,0
2025-05-15 11:00,82,59,23,0,0,0
2025-05-15 11:15,88,61,27,0,0,0
2025-05-15 11:30,87,60,27,0,0,0
2025-05-15 11:45,106,65,41,0,0,0
2025-05-15 12:00,102,60,42,0,0,0
2025-05-15 12:15,105,71,34,0,0,0
2025-05-15 12:30,114,51,63,0,0,0
2025-05-15 12:45,112,66,46,0,0,0
2025-05-15 13:00,111,53,58,0,0,0
2025-05-15 13:15,112,60,52,0,0,0
2025-05-15 13:30,118,85,33,0,0,0
2025-05-15 13:45,121,70,51,0,0,0
2025-05-15 14:00,135,60,75,0,0,0
2025-05-15 14:15,131,66,65,0,0,0
2025-05-15 14:30,114,52,62,0,0,0
2025-05-15 14:45,139,69,70,0,0,0
2025-05-15 15:00,143,62,81,0,0,0
2025-05-15 15:15,140,75,65,0,0,0
2025-05-15 15:30,132,67,65,0,0,0
2025-05-15 15:45,168,94,74,0,0,0
2025-05-15 16:00,164,84,80,0,0,0
2025-05-15 16:15,150,69,81,0,0,0
2025-05-15 16:30,157,81,76,0,0,0
2025-05-15 16:45,173,103,70,0,0,0
2025-05-15 17:00,182,88,94,0,0,0
2025-05-15 17:15,167,92,75,0,0,0
2025-05-15 17:30,169,84,85,0,0,0
2025-05-15 17:45,168,83,85,0,0,0
2025-05-15 18:00,154,74,80,0,0,0
2025-05-15 18:15,150,59,91,0,0,0
2025-05-15 18:30,137,63,74,0,0,0
2025-05-15 18:45,116,62,54,0,0,0
2025-05-15 19:00,93,49,44,0,0,0
2025-05-15 19:15,88,39,49,0,0,0
2025-05-15 19:30,77,37,40,0,0,0
2025-05-15 19:45,89,39,50,0,0,0
2025-05-15 20:00,90,37,53,0,0,0
2025-05-15 20:15,76,32,44,0,0,0
2025-05-15 20:30,54,26,28,0,0,0
2025-05-15 20:45,68,26,42,0,0,0
2025-05-15 21:00,60,29,31,0,0,0
2025-05-15 21:15,46,15,31,0,0,0
2025-05-15 21:30,55,20,35,0,0,0
2025-05-15 21:45,57,24,33,0,0,0
2025-05-15 22:00,44,22,22,0,0,0
2025-05-15 22:15,43,22,21,0,0,0
2025-05-15 22:30,44,11,33,0,0,0
2025-05-15 22:45,36,11,25,0,0,0
2025-05-15 23:00,13,1,12,0,0,0
2025-05-15 23:15,24,11,13,0,0,0
2025-05-15 23:30,15,7,8,0,0,0
2025-05-15 23:45,7,2,5,0,0,0
2025-05-16 00:00,12,2,10,0,0,0
2025-05-16 00:15,5,1,4,0,0,0
2025-05-16 00:30,7,3,4,0,0,0
2025-05-16 00:45,4,0,4,0,0,0
2025-05-16 01:00,1,0,1,0,0,0
2025-05-16 01:15,2,1,1,0,0,0
2025-05-16 01:30,0,0,0,0,0,0
2025-05-16 01:45,3,2,1,0,0,0
2025-05-16 02:00,2,0,2,0,0,0
2025-05-16 02:15,0,0,0,0,0,0
2025-05-16 02:30,1,0,1,0,0,0
2025-05-16 02:45,1,1,0,0,0,0
2025-05-16 03:00,1,0,1,0,0,0
2025-05-16 03:15,0,0,0,0,0,0
2025-05-16 03:30,0,0,0,0,0,0
2025-05-16 03:45,1,0,1,0,0,0
2025-05-16 04:00,1,0,1,0,0,0
2025-05-16 04:15,1,1,0,0,0,0
2025-05-16 04:30,4,2,2,0,0,0
2025-05-16 04:45,0,0,0,0,0,0
2025-05-16 05:00,1,1,0,0,0,0
2025-05-16 05:15,3,3,0,0,0,0
2025-05-16 05:30,11,7,4,0,0,0
2025-05-16 05:45,16,11,5,0,0,0
2025-05-16 06:00,14,12,2,0,0,0
2025-05-16 06:15,20,13,7,0,0,0
2025-05-16 06:30,39,31,8,0,0,0
2025-05-16 06:45,45,32,13,0,0,0
2025-05-16 07:00,66,52,14,0,0,0
2025-05-16 07:15,116,82,34,0,0,0
2025-05-16 07:30,195,151,44,0,0,0
2025-05-16 07:45,176,138,38,0,0,0
2025-05-16 08:00,130,110,20,0,0,0
2025-05-16 08:15,120,87,33,0,0,0
2025-05-16 08:30,133,109,24,0,0,0
2025-05-16 08:45,131,105,26,0,0,0
2025-05-16 09:00,83,60,23,0,0,0
2025-05-16 09:15,106,81,25,0,0,0
2025-05-16 09:30,91,72,19,0,0,0
2025-05-16 09:45,134,96,38,0,0,0
2025-05-16 10:00,106,72,34,0,0,0
2025-05-16 10:15,79,60,19,0,0,0
2025-05-16 10:30,102,66,36,0,0,0
2025-05-16 10:45,102,74,28,0,0,0
2025-05-16 11:00,92,65,27,0,0,0
2025-05-16 11:15,97,65,32,0,0,0
2025-05-16 11:30,111,72,39,0,0,0
2025-05-16 11:45,117,68,49,0,0,0
2025-05-16 12:00,117,68,49,0,0,0
2025-05-16 12:15,109,67,42,0,0,0
2025-05-16 12:30,129,62,67,0,0,0
2025-05-16 12:45,106,50,56,0,0,0
2025-05-16 13:00,145,71,74,0,0,0
2025-05-16 13:15,146,80,66,0,0,0
2025-05-16 13:30,130,71,59,0,0,0
2025-05-16 13:45,144,74,70,0,0,0
2025-05-16 14:00,151,77,74,0,0,0
2025-05-16 14:15,129,66,63,0,0,0
2025-05-16 14:30,134,60,74,0,0,0
2025-05-16 14:45,163,84,79,0,0,0
2025-05-16 15:00,127,59,68,0,0,0
2025-05-16 15:15,131,81,50,0,0,0
2025-05-16 15:30,140,68,72,0,0,0
2025-05-16 15:45,130,78,52,0,0,0
2025-05-16 16:00,111,65,46,0,0,0
2025-05-16 16:15,123,57,66,0,0,0
2025-05-16 16:30,128,64,64,0,0,0
2025-05-16 16:45,134,68,66,0,0,0
2025-05-16 17:00,138,73,65,0,0,0
2025-05-16 17:15,126,62,64,0,0,0
2025-05-16 17:30,135,73,62,0,0,0
2025-05-16 17:45,136,72,64,0,0,0
2025-05-16 18:00,129,63,66,0,0,0
2025-05-16 18:15,122,67,55,0,0,0
2025-05-16 18:30,115,55,60,0,0,0
2025-05-16 18:45,122,59,63,0,0,0
2025-05-16 19:00,102,59,43,0,0,0
2025-05-16 19:15,97,37,60,0,0,0
2025-05-16 19:30,82,42,40,0,0,0
2025-05-16 19:45,94,44,50,0,0,0
2025-05-16 20:00,61,30,31,0,0,0
2025-05-16 20:15,73,38,35,0,0,0
2025-05-16 20:30,52,22,30,0,0,0
2025-05-16 20:45,54,20,34,0,0,0
2025-05-16 21:00,55,27,28,0,0,0
2025-05-16 21:15,57,14,43,0,0,0
2025-05-16 21:30,49,15,34,0,0,0
2025-05-16 21:45,52,16,36,0,0,0
2025-05-16 22:00,33,15,18,0,0,0
2025-05-16 22:15,51,17,34,0,0,0
2025-05-16 22:30,44,19,25,0,0,0
2025-05-16 22:45,34,12,22,0,0,0
2025-05-16 23:00,31,14,17,0,0,0
2025-05-16 23:15,31,17,14,0,0,0
2025-05-16 23:30,30,11,19,0,0,0
2025-05-16 23:45,32,7,25,0,0,0
2025-05-17 00:00,35,9,26,0,0,0
2025-05-17 00:15,27,13,14,0,0,0
2025-05-17 00:30,17,7,10,0,0,0
2025-05-17 00:45,20,6,14,0,0,0
2025-05-17 01:00,25,14,11,0,0,0
2025-05-17 01:15,8,3,5,0,0,0
2025-05-17 01:30,8,2,6,0,0,0
2025-05-17 01:45,11,2,9,0,0,0
2025-05-17 02:00,9,3,6,0,0,0
2025-05-17 02:15,10,4,6,0,0,0
2025-05-17 02:30,11,1,10,0,0,0
2025-05-17 02:45,5,1,4,0,0,0
2025-05-17 03:00,6,0,6,0,0,0
2025-05-17 03:15,4,0,4,0,0,0
2025-05-17 03:30,6,1,5,0,0,0
2025-05-17 03:45,5,2,3,0,0,0
2025-05-17 04:00,2,0,2,0,0,0
2025-05-17 04:15,3,3,0,0,0,0
2025-05-17 04:30,8,4,4,0,0,0
2025-05-17 04:45,2,2,0,0,0,0
2025-05-17 05:00,1,0,1,0,0,0
2025-05-17 05:15,5,4,1,0,0,0
2025-05-17 05:30,4,2,2,0,0,0
2025-05-17 05:45,10,5,5,0,0,0
2025-05-17 06:00,6,5,1,0,0,0
2025-05-17 06:15,4,3,1,0,0,0
2025-05-17 06:30,9,7,2,0,0,0
2025-05-17 06:45,23,16,7,0,0,0
2025-05-17 07:00,23,19,4,0,0,0
2025-05-17 07:15,26,18,8,0,0,0
2025-05-17 07:30,25,17,8,0,0,0
2025-05-17 07:45,51,38,13,0,0,0
2025-05-17 08:00,43,29,14,0,0,0
2025-05-17 08:15,56,49,7,0,0,0
2025-05-17 08:30,60,49,11,0,0,0
2025-05-17 08:45,64,42,22,0,0,0
2025-05-17 09:00,68,52,16,0,0,0
2025-05-17 09:15,105,85,20,0,0,0
2025-05-17 09:30,97,73,24,0,0,0
2025-05-17 09:45,128,101,27,0,0,0
2025-05-17 10:00,118,88,30,0,0,0
2025-05-17 10:15,126,92,34,0,0,0
2025-05-17 10:30,111,89,22,0,0,0
2025-05-17 10:45,146,110,36,0,0,0
2025-05-17 11:00,169,109,60,0,0,0
2025-05-17 11:15,148,100,48,0,0,0
2025-05-17 11:30,169,112,57,0,0,0
2025-05-17 11:45,138,88,50,0,0,0
2025-05-17 12:00,127,76,51,0,0,0
2025-05-17 12:15,151,99,52,0,0,0
2025-05-17 12:30,133,71,62,0,0,0
2025-05-17 12:45,153,81,72,0,0,0
2025-05-17 13:00,156,84,72,0,0,0
2025-05-17 13:15,128,64,64,0,0,0
2025-05-17 13:30,133,67,66,0,0,0
2025-05-17 13:45,132,73,59,0,0,0
2025-05-17 14:00,132,56,76,0,0,0
2025-05-17 14:15,148,41,107,0,0,0
2025-05-17 14:30,119,57,62,0,0,0
2025-05-17 14:45,127,53,74,0,0,0
2025-05-17 15:00,123,60,63,0,0,0
2025-05-17 15:15,107,54,53,0,0,0
2025-05-17 15:30,100,54,46,0,0,0
2025-05-17 15:45,130,51,79,0,0,0
2025-05-17 16:00,112,48,64,0,0,0
2025-05-17 16:15,93,52,41,0,0,0
2025-05-17 16:30,81,47,34,0,0,0
2025-05-17 16:45,94,49,45,0,0,0
2025-05-17 17:00,89,35,54,0,0,0
2025-05-17 17:15,89,41,48,0,0,0
2025-05-17 17:30,84,32,52,0,0,0
2025-05-17 17:45,104,52,52,0,0,0
2025-05-17 18:00,91,35,56,0,0,0
2025-05-17 18:15,87,44,43,0,0,0
2025-05-17 18:30,71,35,36,0,0,0
2025-05-17 18:45,98,58,40,0,0,0
2025-05-17 19:00,87,43,44,0,0,0
2025-05-17 19:15,66,35,31,0,0,0
2025-05-17 19:30,59,34,25,0,0,0
2025-05-17 19:45,66,26,40,0,0,0
2025-05-17 20:00,56,30,26,0,0,0
2025-05-17 20:15,44,24,20,0,0,0
2025-05-17 20:30,54,21,33,0,0,0
2025-05-17 20:45,35,18,17,0,0,0
2025-05-17 21:00,35,15,20,0,0,0
2025-05-17 21:15,42,8,34,0,0,0
2025-05-17 21:30,38,19,19,0,0,0
2025-05-17 21:45,39,14,25,0,0,0
2025-05-17 22:00,38,18,20,0,0,0
2025-05-17 22:15,28,9,19,0,0,0
2025-05-17 22:30,33,9,24,0,0,0
2025-05-17 22:45,37,19,18,0,0,0
2025-05-17 23:00,41,19,22,0,0,0
2025-05-17 23:15,15,7,8,0,0,0
2025-05-17 23:30,14,7,7,0,0,0
2025-05-17 23:45,37,10,27,0,0,0
2025-05-18 00:00,28,6,22,0,0,0
2025-05-18 00:15,26,13,13,0,0,0
2025-05-18 00:30,22,9,13,0,0,0
2025-05-18 00:45,20,9,11,0,0,0
2025-05-18 01:00,15,2,13,0,0,0
2025-05-18 01:15,34,16,18,0,0,0
2025-05-18 01:30,21,5,16,0,0,0
2025-05-18 01:45,20,5,15,0,0,0
2025-05-18 02:00,13,4,9,0,0,0
2025-05-18 02:15,12,4,8,0,0,0
2025-05-18 02:30,10,3,7,0,0,0
2025-05-18 02:45,7,4,3,0,0,0
2025-05-18 03:00,6,0,6,0,0,0
2025-05-18 03:15,7,1,6,0,0,0
2025-05-18 03:30,2,0,2,0,0,0
2025-05-18 03:45,9,3,6,0,0,0
2025-05-18 04:00,2,0,2,0,0,0
2025-05-18 04:15,1,1,0,0,0,0
2025-05-18 04:30,1,0,1,0,0,0
2025-05-18 04:45,0,0,0,0,0,0
2025-05-18 05:00,0,0,0,0,0,0
2025-05-18 05:15,4,2,2,0,0,0
2025-05-18 05:30,8,1,7,0,0,0
2025-05-18 05:45,8,3,5,0,0,0
2025-05-18 06:00,3,3,0,0,0,0
2025-05-18 06:15,4,2,2,0,0,0
2025-05-18 06:30,5,3,2,0,0,0
2025-05-18 06:45,3,2,1,0,0,0
2025-05-18 07:00,4,4,0,0,0,0
2025-05-18 07:15,2,1,1,0,0,0
2025-05-18 07:30,8,8,0,0,0,0
2025-05-18 07:45,6,4,2,0,0,0
2025-05-18 08:00,4,4,0,0,0,0
2025-05-18 08:15,18,13,5,0,0,0
2025-05-18 08:30,14,10,4,0,0,0
2025-05-18 08:45,13,8,5,0,0,0
2025-05-18 09:00,16,5,11,0,0,0
2025-05-18 09:15,23,13,10,0,0,0
2025-05-18 09:30,23,9,14,0,0,0
2025-05-18 09:45,40,23,17,0,0,0
2025-05-18 10:00,28,21,7,0,0,0
2025-05-18 10:15,29,16,13,0,0,0
2025-05-18 10:30,45,30,15,0,0,0
2025-05-18 10:45,44,24,20,0,0,0
2025-05-18 11:00,34,26,8,0,0,0
2025-05-18 11:15,31,18,13,0,0,0
2025-05-18 11:30,36,25,11,0,0,0
2025-05-18 11:45,32,21,11,0,0,0
2025-05-18 12:00,46,29,17,0,0,0
2025-05-18 12:15,46,28,18,0,0,0
2025-05-18 12:30,55,33,22,0,0,0
2025-05-18 12:45,59,41,18,0,0,0
2025-05-18 13:00,49,27,22,0,0,0
2025-05-18 13:15,61,38,23,0,0,0
2025-05-18 13:30,43,21,22,0,0,0
2025-05-18 13:45,57,37,20,0,0,0
2025-05-18 14:00,64,35,29,0,0,0
2025-05-18 14:15,60,33,27,0,0,0
2025-05-18 14:30,59,35,24,0,0,0
2025-05-18 14:45,103,57,46,0,0,0
2025-05-18 15:00,74,46,28,0,0,0
2025-05-18 15:15,63,35,28,0,0,0
2025-05-18 15:30,62,41,21,0,0,0
2025-05-18 15:45,46,20,26,0,0,0
2025-05-18 16:00,42,13,29,0,0,0
2025-05-18 16:15,39,17,22,0,0,0
2025-05-18 16:30,56,29,27,0,0,0
2025-05-18 16:45,42,25,17,0,0,0
2025-05-18 17:00,58,35,23,0,0,0
2025-05-18 17:15,53,29,24,0,0,0
2025-05-18 17:30,69,22,47,0,0,0
2025-05-18 17:45,82,38,44,0,0,0
2025-05-18 18:00,46,27,19,0,0,0
2025-05-18 18:15,48,24,24,0,0,0
2025-05-18 18:30,55,21,34,0,0,0
2025-05-18 18:45,59,25,34,0,0,0
2025-05-18 19:00,45,16,29,0,0,0
2025-05-18 19:15,50,24,26,0,0,0
2025-05-18 19:30,58,31,27,0,0,0
2025-05-18 19:45,58,29,29,0,0,0
2025-05-18 20:00,53,21,32,0,0,0
2025-05-18 20:15,30,13,17,0,0,0
2025-05-18 20:30,24,8,16,0,0,0
2025-05-18 20:45,31,11,20,0,0,0
2025-05-18 21:00,23,8,15,0,0,0
2025-05-18 21:15,26,14,12,0,0,0
2025-05-18 21:30,9,5,4,0,0,0
2025-05-18 21:45,21,10,11,0,0,0
2025-05-18 22:00,14,6,8,0,0,0
2025-05-18 22:15,21,15,6,0,0,0
2025-05-18 22:30,22,7,15,0,0,0
2025-05-18 22:45,8,4,4,0,0,0
2025-05-18 23:00,5,3,2,0,0,0
2025-05-18 23:15,11,5,6,0,0,0
2025-05-18 23:30,6,1,5,0,0,0
2025-05-18 23:45,3,2,1,0,0,0
2025-05-19 00:00,4,3,1,0,0,0
2025-05-19 00:15,6,3,3,0,0,0
2025-05-19 00:30,4,1,3,0,0,0
2025-05-19 00:45,2,1,1,0,0,0
2025-05-19 01:00,3,3,0,0,0,0
2025-05-19 01:15,2,1,1,0,0,0
2025-05-19 01:30,1,0,1,0,0,0
2025-05-19 01:45,0,0,0,0,0,0
2025-05-19 02:00,1,1,0,0,0,0
2025-05-19 02:15,0,0,0,0,0,0
2025-05-19 02:30,0,0,0,0,0,0
2025-05-19 02:45,4,2,2,0,0,0
2025-05-19 03:00,0,0,0,0,0,0
2025-05-19 03:15,1,1,0,0,0,0
2025-05-19 03:30,1,0,1,0,0,0
2025-05-19 03:45,1,0,1,0,0,0
2025-05-19 04:00,1,1,0,0,0,0
2025-05-19 04:15,1,1,0,0,0,0
2025-05-19 04:30,1,1,0,0,0,0
2025-05-19 04:45,1,1,0,0,0,0
2025-05-19 05:00,4,4,0,0,0,0
2025-05-19 05:15,8,5,3,0,0,0
2025-05-19 05:30,17,7,10,0,0,0
2025-05-19 05:45,15,9,6,0,0,0
2025-05-19 06:00,11,8,3,0,0,0
2025-05-19 06:15,27,15,12,0,0,0
2025-05-19 06:30,40,28,12,0,0,0
2025-05-19 06:45,53,39,14,0,0,0
2025-05-19 07:00,88,61,27,0,0,0
2025-05-19 07:15,137,90,47,0,0,0
2025-05-19 07:30,200,155,45,0,0,0
2025-05-19 07:45,180,123,57,0,0,0
2025-05-19 08:00,136,97,39,0,0,0
2025-05-19 08:15,130,101,29,0,0,0
2025-05-19 08:30,132,97,35,0,0,0
2025-05-19 08:45,132,106,26,0,0,0
2025-05-19 09:00,99,69,30,0,0,0
2025-05-19 09:15,91,66,25,0,0,0
2025-05-19 09:30,90,66,24,0,0,0
2025-05-19 09:45,115,93,22,0,0,0
2025-05-19 10:00,97,72,25,0,0,0
2025-05-19 10:15,76,52,24,0,0,0
2025-05-19 10:30,82,51,31,0,0,0
2025-05-19 10:45,84,57,27,0,0,0
2025-05-19 11:00,86,51,35,0,0,0
2025-05-19 11:15,86,67,19,0,0,0
2025-05-19 11:30,100,58,42,0,0,0
2025-05-19 11:45,137,89,48,0,0,0
2025-05-19 12:00,128,76,52,0,0,0
2025-05-19 12:15,111,70,41,0,0,0
2025-05-19 12:30,102,43,59,0,0,0
2025-05-19 12:45,133,80,53,0,0,0
2025-05-19 13:00,125,60,65,0,0,0
2025-05-19 13:15,97,43,54,0,0,0
2025-05-19 13:30,106,63,43,0,0,0
2025-05-19 13:45,108,60,48,0,0,0
2025-05-19 14:00,123,52,71,0,0,0
2025-05-19 14:15,92,48,44,0,0,0
2025-05-19 14:30,113,51,62,0,0,0
2025-05-19 14:45,113,59,54,0,0,0
2025-05-19 15:00,140,65,75,0,0,0
2025-05-19 15:15,105,57,48,0,0,0
2025-05-19 15:30,135,70,65,0,0,0
2025-05-19 15:45,147,81,66,0,0,0
2025-05-19 16:00,157,83,74,0,0,0
2025-05-19 16:15,151,74,77,0,0,0
2025-05-19 16:30,162,80,82,0,0,0
2025-05-19 16:45,143,58,85,0,0,0
2025-05-19 17:00,152,71,81,0,0,0
2025-05-19 17:15,141,66,75,0,0,0
2025-05-19 17:30,135,54,81,0,0,0
2025-05-19 17:45,163,87,76,0,0,0
2025-05-19 18:00,143,54,89,0,0,0
2025-05-19 18:15,150,67,83,0,0,0
2025-05-19 18:30,115,54,61,0,0,0
2025-05-19 18:45,120,59,61,0,0,0
2025-05-19 19:00,91,36,55,0,0,0
2025-05-19 19:15,50,8,42,0,0,0
2025-05-19 19:30,57,4,53,0,0,0
2025-05-19 19:45,89,31,58,0,0,0
2025-05-19 20:00,68,23,45,0,0,0
2025-05-19 20:15,52,25,27,0,0,0
2025-05-19 20:30,49,17,32,0,0,0
2025-05-19 20:45,42,21,21,0,0,0
2025-05-19 21:00,43,16,27,0,0,0
2025-05-19 21:15,49,22,27,0,0,0
2025-05-19 21:30,54,27,27,0,0,0
2025-05-19 21:45,41,17,24,0,0,0
2025-05-19 22:00,43,12,31,0,0,0
2025-05-19 22:15,36,12,24,0,0,0
2025-05-19 22:30,28,13,15,0,0,0
2025-05-19 22:45,31,13,18,0,0,0
2025-05-19 23:00,23,5,18,0,0,0
2025-05-19 23:15,15,6,9,0,0,0
2025-05-19 23:30,8,3,5,0,0,0
2025-05-19 23:45,9,2,7,0,0,0
2025-05-20 00:00,7,4,3,0,0,0
2025-05-20 00:15,2,0,2,0,0,0
2025-05-20 00:30,3,0,3,0,0,0
2025-05-20 00:45,4,3,1,0,0,0
2025-05-20 01:00,2,2,0,0,0,0
2025-05-20 01:15,2,1,1,0,0,0
2025-05-20 01:30,1,0,1,0,0,0
2025-05-20 01:45,1,0,1,0,0,0
2025-05-20 02:00,0,0,0,0,0,0
2025-05-20 02:15,0,0,0,0,0,0
2025-05-20 02:30,1,1,0,0,0,0
2025-05-20 02:45,0,0,0,0,0,0
2025-05-20 03:00,0,0,0,0,0,0
2025-05-20 03:15,1,0,1,0,0,0
2025-05-20 03:30,0,0,0,0,0,0
2025-05-20 03:45,0,0,0,0,0,0
2025-05-20 04:00,0,0,0,0,0,0
2025-05-20 04:15,2,1,1,0,0,0
2025-05-20 04:30,0,0,0,0,0,0
2025-05-20 04:45,2,1,1,0,0,0
2025-05-20 05:00,1,1,0,0,0,0
2025-05-20 05:15,7,4,3,0,0,0
2025-05-20 05:30,20,7,13,0,0,0
2025-05-20 05:45,17,7,10,0,0,0
2025-05-20 06:00,15,11,4,0,0,0
2025-05-20 06:15,23,15,8,0,0,0
2025-05-20 06:30,58,42,16,0,0,0
2025-05-20 06:45,53,36,17,0,0,0
2025-05-20 07:00,82,52,30,0,0,0
2025-05-20 07:15,140,96,44,0,0,0
2025-05-20 07:30,206,157,49,0,0,0
2025-05-20 07:45,210,158,52,0,0,0
2025-05-20 08:00,149,108,41,0,0,0
2025-05-20 08:15,194,136,58,0,0,0
2025-05-20 08:30,151,111,40,0,0,0
2025-05-20 08:45,153,103,50,0,0,0
2025-05-20 09:00,102,82,20,0,0,0
2025-05-20 09:15,95,69,26,0,0,0
2025-05-20 09:30,123,91,32,0,0,0
2025-05-20 09:45,146,121,25,0,0,0
2025-05-20 10:00,119,78,41,0,0,0
2025-05-20 10:15,81,49,32,0,0,0
2025-05-20 10:30,100,69,31,0,0,0
2025-05-20 10:45,76,47,29,0,0,0
2025-05-20 11:00,86,55,31,0,0,0
2025-05-20 11:15,102,60,42,0,0,0
2025-05-20 11:30,104,63,41,0,0,0
2025-05-20 11:45,118,65,53,0,0,0
2025-05-20 12:00,106,64,42,0,0,0
2025-05-20 12:15,107,66,41,0,0,0
2025-05-20 12:30,130,66,64,0,0,0
2025-05-20 12:45,112,60,52,0,0,0
2025-05-20 13:00,132,65,67,0,0,0
2025-05-20 13:15,116,61,55,0,0,0
2025-05-20 13:30,114,60,54,0,0,0
2025-05-20 13:45,149,67,82,0,0,0
2025-05-20 14:00,140,69,71,0,0,0
2025-05-20 14:15,111,62,49,0,0,0
2025-05-20 14:30,117,54,63,0,0,0
2025-05-20 14:45,136,79,57,0,0,0
2025-05-20 15:00,143,72,71,0,0,0
2025-05-20 15:15,123,58,65,0,0,0
2025-05-20 15:30,144,76,68,0,0,0
2025-05-20 15:45,173,81,92,0,0,0
2025-05-20 16:00,159,83,76,0,0,0
2025-05-20 16:15,168,79,89,0,0,0
2025-05-20 16:30,147,81,66,0,0,0
2025-05-20 16:45,146,77,69,0,0,0
2025-05-20 17:00,164,67,97,0,0,0
2025-05-20 17:15,163,70,93,0,0,0
2025-05-20 17:30,145,71,74,0,0,0
2025-05-20 17:45,195,84,111,0,0,0
2025-05-20 18:00,168,75,93,0,0,0
2025-05-20 18:15,129,55,74,0,0,0
2025-05-20 18:30,163,87,76,0,0,0
2025-05-20 18:45,140,56,84,0,0,0
2025-05-20 19:00,108,44,64,0,0,0
2025-05-20 19:15,88,45,43,0,0,0
2025-05-20 19:30,84,41,43,0,0,0
2025-05-20 19:45,92,44,48,0,0,0
2025-05-20 20:00,87,38,49,0,0,0
2025-05-20 20:15,60,21,39,0,0,0
2025-05-20 20:30,59,21,38,0,0,0
2025-05-20 20:45,41,13,28,0,0,0
2025-05-20 21:00,52,24,28,0,0,0
2025-05-20 21:15,55,16,39,0,0,0
2025-05-20 21:30,60,22,38,0,0,0
2025-05-20 21:45,49,24,25,0,0,0
2025-05-20 22:00,59,30,29,0,0,0
2025-05-20 22:15,52,17,35,0,0,0
2025-05-20 22:30,42,18,24,0,0,0
2025-05-20 22:45,27,10,17,0,0,0
2025-05-20 23:00,29,14,15,0,0,0
2025-05-20 23:15,14,5,9,0,0,0
2025-05-20 23:30,10,5,5,0,0,0
2025-05-20 23:45,5,1,4,0,0,0
2025-05-21 00:00,10,2,8,0,0,0
2025-05-21 00:15,5,2,3,0,0,0
2025-05-21 00:30,4,2,2,0,0,0
2025-05-21 00:45,3,1,2,0,0,0
2025-05-21 01:00,7,3,4,0,0,0
2025-05-21 01:15,0,0,0,0,0,0
2025-05-21 01:30,0,0,0,0,0,0
2025-05-21 01:45,0,0,0,0,0,0
2025-05-21 02:00,5,2,3,0,0,0
2025-05-21 02:15,0,0,0,0,0,0
2025-05-21 02:30,3,0,3,0,0,0
2025-05-21 02:45,1,0,1,0,0,0
2025-05-21 03:00,0,0,0,0,0,0
2025-05-21 03:15,4,1,3,0,0,0
2025-05-21 03:30,2,0,2,0,0,0
2025-05-21 03:45,1,1,0,0,0,0
2025-05-21 04:00,2,1,1,0,0,0
2025-05-21 04:15,1,1,0,0,0,0
2025-05-21 04:30,0,0,0,0,0,0
2025-05-21 04:45,2,1,1,0,0,0
2025-05-21 05:00,4,2,2,0,0,0
2025-05-21 05:15,8,4,4,0,0,0
2025-05-21 05:30,12,6,6,0,0,0
2025-05-21 05:45,15,8,7,0,0,0
2025-05-21 06:00,8,6,2,0,0,0
2025-05-21 06:15,22,15,7,0,0,0
2025-05-21 06:30,48,31,17,0,0,0
2025-05-21 06:45,51,38,13,0,0,0
2025-05-21 07:00,97,60,37,0,0,0
2025-05-21 07:15,135,92,43,0,0,0
2025-05-21 07:30,237,177,60,0,0,0
2025-05-21 07:45,209,151,58,0,0,0
2025-05-21 08:00,161,116,45,0,0,0
2025-05-21 08:15,162,115,47,0,0,0
2025-05-21 08:30,155,126,29,0,0,0
2025-05-21 08:45,161,128,33,0,0,0
2025-05-21 09:00,105,88,17,0,0,0
2025-05-21 09:15,127,89,38,0,0,0
2025-05-21 09:30,137,92,45,0,0,0
2025-05-21 09:45,151,117,34,0,0,0
2025-05-21 10:00,118,86,32,0,0,0
2025-05-21 10:15,107,75,32,0,0,0
2025-05-21 10:30,91,55,36,0,0,0
2025-05-21 10:45,112,79,33,0,0,0
2025-05-21 11:00,93,58,35,0,0,0
2025-05-21 11:15,104,68,36,0,0,0
2025-05-21 11:30,130,83,47,0,0,0
2025-05-21 11:45,141,89,52,0,0,0
2025-05-21 12:00,120,59,61,0,0,0
2025-05-21 12:15,143,83,60,0,0,0
2025-05-21 12:30,110,59,51,0,0,0
2025-05-21 12:45,135,75,60,0,0,0
2025-05-21 13:00,140,69,71,0,0,0
2025-05-21 13:15,127,58,69,0,0,0
2025-05-21 13:30,114,51,63,0,0,0
2025-05-21 13:45,144,73,71,0,0,0
2025-05-21 14:00,144,67,77,0,0,0
2025-05-21 14:15,115,55,60,0,0,0
2025-05-21 14:30,109,52,57,0,0,0
2025-05-21 14:45,138,67,71,0,0,0
2025-05-21 15:00,136,75,61,0,0,0
2025-05-21 15:15,122,58,64,0,0,0
2025-05-21 15:30,157,68,89,0,0,0
2025-05-21 15:45,154,81,73,0,0,0
2025-05-21 16:00,168,81,87,0,0,0
2025-05-21 16:15,180,110,70,0,0,0
2025-05-21 16:30,147,71,76,0,0,0
2025-05-21 16:45,147,77,70,0,0,0
2025-05-21 17:00,159,77,82,0,0,0
2025-05-21 17:15,168,86,82,0,0,0
2025-05-21 17:30,150,70,80,0,0,0
2025-05-21 17:45,158,80,78,0,0,0
2025-05-21 18:00,115,47,68,0,0,0
2025-05-21 18:15,160,77,83,0,0,0
2025-05-21 18:30,138,76,62,0,0,0
2025-05-21 18:45,110,53,57,0,0,0
2025-05-21 19:00,96,45,51,0,0,0
2025-05-21 19:15,100,46,54,0,0,0
2025-05-21 19:30,73,31,42,0,0,0
2025-05-21 19:45,98,54,44,0,0,0
2025-05-21 20:00,79,31,48,0,0,0
2025-05-21 20:15,63,22,41,0,0,0
2025-05-21 20:30,41,15,26,0,0,0
2025-05-21 20:45,46,18,28,0,0,0
2025-05-21 21:00,62,34,28,0,0,0
2025-05-21 21:15,66,24,42,0,0,0
2025-05-21 21:30,49,21,28,0,0,0
2025-05-21 21:45,49,22,27,0,0,0
2025-05-21 22:00,56,18,38,0,0,0
2025-05-21 22:15,73,26,47,0,0,0
2025-05-21 22:30,42,13,29,0,0,0
2025-05-21 22:45,37,8,29,0,0,0
2025-05-21 23:00,23,9,14,0,0,0
2025-05-21 23:15,23,7,16,0,0,0
2025-05-21 23:30,19,8,11,0,0,0
2025-05-21 23:45,18,10,8,0,0,0
2025-05-22 00:00,15,1,14,0,0,0
2025-05-22 00:15,17,12,5,0,0,0
2025-05-22 00:30,10,5,5,0,0,0
2025-05-22 00:45,6,2,4,0,0,0
2025-05-22 01:00,6,0,6,0,0,0
2025-05-22 01:15,3,0,3,0,0,0
2025-05-22 01:30,1,0,1,0,0,0
2025-05-22 01:45,0,0,0,0,0,0
2025-05-22 02:00,5,0,5,0,0,0
2025-05-22 02:15,3,0,3,0,0,0
2025-05-22 02:30,1,1,0,0,0,0
2025-05-22 02:45,0,0,0,0,0,0
2025-05-22 03:00,4,0,4,0,0,0
2025-05-22 03:15,2,0,2,0,0,0
2025-05-22 03:30,1,1,0,0,0,0
2025-05-22 03:45,2,0,2,0,0,0
2025-05-22 04:00,3,1,2,0,0,0
2025-05-22 04:15,0,0,0,0,0,0
2025-05-22 04:30,2,1,1,0,0,0
2025-05-22 04:45,3,2,1,0,0,0
2025-05-22 05:00,2,1,1,0,0,0
2025-05-22 05:15,6,2,4,0,0,0
2025-05-22 05:30,14,11,3,0,0,0
2025-05-22 05:45,16,6,10,0,0,0
2025-05-22 06:00,14,10,4,0,0,0
2025-05-22 06:15,25,18,7,0,0,0
2025-05-22 06:30,45,32,13,0,0,0
2025-05-22 06:45,61,34,27,0,0,0
2025-05-22 07:00,68,49,19,0,0,0
2025-05-22 07:15,113,83,30,0,0,0
2025-05-22 07:30,216,166,50,0,0,0
2025-05-22 07:45,201,149,52,0,0,0
2025-05-22 08:00,134,106,28,0,0,0
2025-05-22 08:15,129,98,31,0,0,0
2025-05-22 08:30,142,115,27,0,0,0
2025-05-22 08:45,129,97,32,0,0,0
2025-05-22 09:00,91,66,25,0,0,0
2025-05-22 09:15,82,63,19,0,0,0
2025-05-22 09:30,110,77,33,0,0,0
2025-05-22 09:45,125,94,31,0,0,0
2025-05-22 10:00,108,78,30,0,0,0
2025-05-22 10:15,70,53,17,0,0,0
2025-05-22 10:30,73,52,21,0,0,0
2025-05-22 10:45,93,59,34,0,0,0
2025-05-22 11:00,80,58,22,0,0,0
2025-05-22 11:15,95,55,40,0,0,0
2025-05-22 11:30,88,63,25,0,0,0
2025-05-22 11:45,121,78,43,0,0,0
2025-05-22 12:00,105,70,35,0,0,0
2025-05-22 12:15,95,57,38,0,0,0
2025-05-22 12:30,108,55,53,0,0,0
2025-05-22 12:45,103,60,43,0,0,0
2025-05-22 13:00,110,55,55,0,0,0
2025-05-22 13:15,127,59,68,0,0,0
2025-05-22 13:30,109,47,62,0,0,0
2025-05-22 13:45,131,80,51,0,0,0
2025-05-22 14:00,100,42,58,0,0,0
2025-05-22 14:15,93,40,53,0,0,0
2025-05-22 14:30,99,47,52,0,0,0
2025-05-22 14:45,144,81,63,0,0,0
2025-05-22 15:00,119,61,58,0,0,0
2025-05-22 15:15,129,74,55,0,0,0
2025-05-22 15:30,143,79,64,0,0,0
2025-05-22 15:45,157,83,74,0,0,0
2025-05-22 16:00,146,71,75,0,0,0
2025-05-22 16:15,171,83,88,0,0,0
2025-05-22 16:30,144,72,72,0,0,0
2025-05-22 16:45,164,89,75,0,0,0
2025-05-22 17:00,137,55,82,0,0,0
2025-05-22 17:15,104,20,84,0,0,0
2025-05-22 17:30,141,72,69,0,0,0
2025-05-22 17:45,178,90,88,0,0,0
2025-05-22 18:00,152,61,91,0,0,0
2025-05-22 18:15,156,66,90,0,0,0
2025-05-22 18:30,113,59,54,0,0,0
2025-05-22 18:45,136,73,63,0,0,0
2025-05-22 19:00,95,46,49,0,0,0
2025-05-22 19:15,74,36,38,0,0,0
2025-05-22 19:30,72,33,39,0,0,0
2025-05-22 19:45,89,36,53,0,0,0
2025-05-22 20:00,67,32,35,0,0,0
2025-05-22 20:15,59,30,29,0,0,0
2025-05-22 20:30,51,23,28,0,0,0
2025-05-22 20:45,58,28,30,0,0,0
2025-05-22 21:00,44,19,25,0,0,0
2025-05-22 21:15,50,27,23,0,0,0
2025-05-22 21:30,45,19,26,0,0,0
2025-05-22 21:45,61,27,34,0,0,0
2025-05-22 22:00,58,23,35,0,0,0
2025-05-22 22:15,40,14,26,0,0,0
2025-05-22 22:30,28,5,23,0,0,0
2025-05-22 22:45,35,15,20,0,0,0
2025-05-22 23:00,21,6,15,0,0,0
2025-05-22 23:15,29,15,14,0,0,0
2025-05-22 23:30,17,6,11,0,0,0
2025-05-22 23:45,8,4,4,0,0,0
2025-05-23 00:00,12,3,9,0,0,0
2025-05-23 00:15,8,2,6,0,0,0
2025-05-23 00:30,2,0,2,0,0,0
2025-05-23 00:45,5,1,4,0,0,0
2025-05-23 01:00,3,1,2,0,0,0
2025-05-23 01:15,3,1,2,0,0,0
2025-05-23 01:30,3,0,3,0,0,0
2025-05-23 01:45,1,0,1,0,0,0
2025-05-23 02:00,0,0,0,0,0,0
2025-05-23 02:15,1,0,1,0,0,0
2025-05-23 02:30,6,2,4,0,0,0
2025-05-23 02:45,3,0,3,0,0,0
2025-05-23 03:00,2,1,1,0,0,0
2025-05-23 03:15,1,0,1,0,0,0
2025-05-23 03:30,1,1,0,0,0,0
2025-05-23 03:45,1,1,0,0,0,0
2025-05-23 04:00,0,0,0,0,0,0
2025-05-23 04:15,0,0,0,0,0,0
2025-05-23 04:30,0,0,0,0,0,0
2025-05-23 04:45,0,0,0,0,0,0
2025-05-23 05:00,4,2,2,0,0,0
2025-05-23 05:15,7,6,1,0,0,0
2025-05-23 05:30,11,6,5,0,0,0
2025-05-23 05:45,19,10,9,0,0,0
2025-05-23 06:00,13,10,3,0,0,0
2025-05-23 06:15,19,13,6,0,0,0
2025-05-23 06:30,28,17,11,0,0,0
2025-05-23 06:45,51,31,20,0,0,0
2025-05-23 07:00,65,45,20,0,0,0
2025-05-23 07:15,88,69,19,0,0,0
2025-05-23 07:30,160,122,38,0,0,0
2025-05-23 07:45,160,123,37,0,0,0
2025-05-23 08:00,105,81,24,0,0,0
2025-05-23 08:15,110,78,32,0,0,0
2025-05-23 08:30,101,82,19,0,0,0
2025-05-23 08:45,124,106,18,0,0,0
2025-05-23 09:00,87,65,22,0,0,0
2025-05-23 09:15,67,53,14,0,0,0
2025-05-23 09:30,94,71,23,0,0,0
2025-05-23 09:45,102,79,23,0,0,0
2025-05-23 10:00,82,57,25,0,0,0
2025-05-23 10:15,66,46,20,0,0,0
2025-05-23 10:30,71,43,28,0,0,0
2025-05-23 10:45,103,70,33,0,0,0
2025-05-23 11:00,91,56,35,0,0,0
2025-05-23 11:15,81,56,25,0,0,0
2025-05-23 11:30,76,43,33,0,0,0
2025-05-23 11:45,119,71,48,0,0,0
2025-05-23 12:00,108,67,41,0,0,0
2025-05-23 12:15,113,75,38,0,0,0
2025-05-23 12:30,105,45,60,0,0,0
2025-05-23 12:45,104,61,43,0,0,0
2025-05-23 13:00,124,55,69,0,0,0
2025-05-23 13:15,132,60,72,0,0,0
2025-05-23 13:30,102,56,46,0,0,0
2025-05-23 13:45,79,50,29,0,0,0
2025-05-23 14:00,116,46,70,0,0,0
2025-05-23 14:15,86,43,43,0,0,0
2025-05-23 14:30,77,41,36,0,0,0
2025-05-23 14:45,104,51,53,0,0,0
2025-05-23 15:00,95,47,48,0,0,0
2025-05-23 15:15,93,58,35,0,0,0
2025-05-23 15:30,98,37,61,0,0,0
2025-05-23 15:45,87,38,49,0,0,0
2025-05-23 16:00,112,55,57,0,0,0
2025-05-23 16:15,104,53,51,0,0,0
2025-05-23 16:30,101,47,54,0,0,0
2025-05-23 16:45,65,37,28,0,0,0
2025-05-23 17:00,63,26,37,0,0,0
2025-05-23 17:15,87,38,49,0,0,0
2025-05-23 17:30,98,55,43,0,0,0
2025-05-23 17:45,123,58,65,0,0,0
2025-05-23 18:00,113,50,63,0,0,0
2025-05-23 18:15,98,44,54,0,0,0
2025-05-23 18:30,73,32,41,0,0,0
2025-05-23 18:45,77,37,40,0,0,0
2025-05-23 19:00,84,40,44,0,0,0
2025-05-23 19:15,64,43,21,0,0,0
2025-05-23 19:30,68,45,23,0,0,0
2025-05-23 19:45,65,42,23,0,0,0
2025-05-23 20:00,53,32,21,0,0,0
2025-05-23 20:15,53,31,22,0,0,0
2025-05-23 20:30,47,30,17,0,0,0
2025-05-23 20:45,35,23,12,0,0,0
2025-05-23 21:00,36,20,16,0,0,0
2025-05-23 21:15,31,13,18,0,0,0
2025-05-23 21:30,49,23,26,0,0,0
2025-05-23 21:45,28,14,14,0,0,0
2025-05-23 22:00,37,16,21,0,0,0
2025-05-23 22:15,33,12,21,0,0,0
2025-05-23 22:30,41,12,29,0,0,0
2025-05-23 22:45,31,12,19,0,0,0
2025-05-23 23:00,28,12,16,0,0,0
2025-05-23 23:15,32,10,22,0,0,0
2025-05-23 23:30,27,11,16,0,0,0
2025-05-23 23:45,26,13,13,0,0,0
