Datetime,300037926 (Bohlweg),353413831 (Bohlweg [Bike Stadteinwärts]),353413832 (Bohlweg [Bike Stadtauswärts]),300037926-status,353413831-status,353413832-status
2024-03-01 00:00,5,0,5,0,0,0
2024-03-01 00:15,4,1,3,0,0,0
2024-03-01 00:30,2,1,1,0,0,0
2024-03-01 00:45,5,0,5,0,0,0
2024-03-01 01:00,4,3,1,0,0,0
2024-03-01 01:15,4,2,2,0,0,0
2024-03-01 01:30,0,0,0,0,0,0
2024-03-01 01:45,0,0,0,0,0,0
2024-03-01 02:00,0,0,0,0,0,0
2024-03-01 02:15,1,0,1,0,0,0
2024-03-01 02:30,1,0,1,0,0,0
2024-03-01 02:45,0,0,0,0,0,0
2024-03-01 03:00,2,2,0,0,0,0
2024-03-01 03:15,0,0,0,0,0,0
2024-03-01 03:30,1,1,0,0,0,0
2024-03-01 03:45,2,1,1,0,0,0
2024-03-01 04:00,0,0,0,0,0,0
2024-03-01 04:15,1,1,0,0,0,0
2024-03-01 04:30,1,1,0,0,0,0
2024-03-01 04:45,0,0,0,0,0,0
2024-03-01 05:00,2,1,1,0,0,0
2024-03-01 05:15,9,5,4,0,0,0
2024-03-01 05:30,9,5,4,0,0,0
2024-03-01 05:45,9,8,1,0,0,0
2024-03-01 06:00,11,7,4,0,0,0
2024-03-01 06:15,14,12,2,0,0,0
2024-03-01 06:30,31,20,11,0,0,0
2024-03-01 06:45,26,20,6,0,0,0
2024-03-01 07:00,53,32,21,0,0,0
2024-03-01 07:15,96,69,27,0,0,0
2024-03-01 07:30,169,113,56,0,0,0
2024-03-01 07:45,122,83,39,0,0,0
2024-03-01 08:00,66,47,19,0,0,0
2024-03-01 08:15,82,58,24,0,0,0
2024-03-01 08:30,87,61,26,0,0,0
2024-03-01 08:45,79,52,27,0,0,0
2024-03-01 09:00,54,40,14,0,0,0
2024-03-01 09:15,53,35,18,0,0,0
2024-03-01 09:30,75,48,27,0,0,0
2024-03-01 09:45,76,52,24,0,0,0
2024-03-01 10:00,51,32,19,0,0,0
2024-03-01 10:15,41,29,12,0,0,0
2024-03-01 10:30,55,31,24,0,0,0
2024-03-01 10:45,68,35,33,0,0,0
2024-03-01 11:00,58,38,20,0,0,0
2024-03-01 11:15,60,28,32,0,0,0
2024-03-01 11:30,47,28,19,0,0,0
2024-03-01 11:45,66,33,33,0,0,0
2024-03-01 12:00,69,37,32,0,0,0
2024-03-01 12:15,74,39,35,0,0,0
2024-03-01 12:30,59,28,31,0,0,0
2024-03-01 12:45,83,44,39,0,0,0
2024-03-01 13:00,126,69,57,0,0,0
2024-03-01 13:15,90,48,42,0,0,0
2024-03-01 13:30,100,38,62,0,0,0
2024-03-01 13:45,86,38,48,0,0,0
2024-03-01 14:00,86,28,58,0,0,0
2024-03-01 14:15,81,38,43,0,0,0
2024-03-01 14:30,85,48,37,0,0,0
2024-03-01 14:45,90,47,43,0,0,0
2024-03-01 15:00,90,40,50,0,0,0
2024-03-01 15:15,98,48,50,0,0,0
2024-03-01 15:30,94,37,57,0,0,0
2024-03-01 15:45,102,54,48,0,0,0
2024-03-01 16:00,77,37,40,0,0,0
2024-03-01 16:15,80,33,47,0,0,0
2024-03-01 16:30,75,38,37,0,0,0
2024-03-01 16:45,80,40,40,0,0,0
2024-03-01 17:00,91,47,44,0,0,0
2024-03-01 17:15,104,54,50,0,0,0
2024-03-01 17:30,81,34,47,0,0,0
2024-03-01 17:45,98,46,52,0,0,0
2024-03-01 18:00,86,44,42,0,0,0
2024-03-01 18:15,81,35,46,0,0,0
2024-03-01 18:30,59,32,27,0,0,0
2024-03-01 18:45,71,40,31,0,0,0
2024-03-01 19:00,75,35,40,0,0,0
2024-03-01 19:15,83,44,39,0,0,0
2024-03-01 19:30,43,23,20,0,0,0
2024-03-01 19:45,56,29,27,0,0,0
2024-03-01 20:00,38,26,12,0,0,0
2024-03-01 20:15,34,14,20,0,0,0
2024-03-01 20:30,41,25,16,0,0,0
2024-03-01 20:45,25,13,12,0,0,0
2024-03-01 21:00,27,15,12,0,0,0
2024-03-01 21:15,31,12,19,0,0,0
2024-03-01 21:30,23,8,15,0,0,0
2024-03-01 21:45,42,10,32,0,0,0
2024-03-01 22:00,23,8,15,0,0,0
2024-03-01 22:15,16,6,10,0,0,0
2024-03-01 22:30,26,12,14,0,0,0
2024-03-01 22:45,18,5,13,0,0,0
2024-03-01 23:00,30,12,18,0,0,0
2024-03-01 23:15,23,6,17,0,0,0
2024-03-01 23:30,20,9,11,0,0,0
2024-03-01 23:45,29,14,15,0,0,0
2024-03-02 00:00,21,7,14,0,0,0
2024-03-02 00:15,18,7,11,0,0,0
2024-03-02 00:30,10,5,5,0,0,0
2024-03-02 00:45,18,9,9,0,0,0
2024-03-02 01:00,9,4,5,0,0,0
2024-03-02 01:15,17,4,13,0,0,0
2024-03-02 01:30,10,5,5,0,0,0
2024-03-02 01:45,11,4,7,0,0,0
2024-03-02 02:00,6,2,4,0,0,0
2024-03-02 02:15,14,5,9,0,0,0
2024-03-02 02:30,5,0,5,0,0,0
2024-03-02 02:45,9,2,7,0,0,0
2024-03-02 03:00,6,2,4,0,0,0
2024-03-02 03:15,5,2,3,0,0,0
2024-03-02 03:30,5,1,4,0,0,0
2024-03-02 03:45,2,1,1,0,0,0
2024-03-02 04:00,4,3,1,0,0,0
2024-03-02 04:15,5,3,2,0,0,0
2024-03-02 04:30,1,0,1,0,0,0
2024-03-02 04:45,3,0,3,0,0,0
2024-03-02 05:00,1,1,0,0,0,0
2024-03-02 05:15,3,2,1,0,0,0
2024-03-02 05:30,3,3,0,0,0,0
2024-03-02 05:45,6,3,3,0,0,0
2024-03-02 06:00,3,2,1,0,0,0
2024-03-02 06:15,4,2,2,0,0,0
2024-03-02 06:30,4,1,3,0,0,0
2024-03-02 06:45,12,10,2,0,0,0
2024-03-02 07:00,7,6,1,0,0,0
2024-03-02 07:15,10,5,5,0,0,0
2024-03-02 07:30,14,7,7,0,0,0
2024-03-02 07:45,24,18,6,0,0,0
2024-03-02 08:00,14,12,2,0,0,0
2024-03-02 08:15,32,20,12,0,0,0
2024-03-02 08:30,34,25,9,0,0,0
2024-03-02 08:45,43,25,18,0,0,0
2024-03-02 09:00,37,26,11,0,0,0
2024-03-02 09:15,45,32,13,0,0,0
2024-03-02 09:30,52,35,17,0,0,0
2024-03-02 09:45,85,62,23,0,0,0
2024-03-02 10:00,69,48,21,0,0,0
2024-03-02 10:15,74,51,23,0,0,0
2024-03-02 10:30,71,40,31,0,0,0
2024-03-02 10:45,80,47,33,0,0,0
2024-03-02 11:00,70,50,20,0,0,0
2024-03-02 11:15,75,51,24,0,0,0
2024-03-02 11:30,90,60,30,0,0,0
2024-03-02 11:45,87,47,40,0,0,0
2024-03-02 12:00,89,57,32,0,0,0
2024-03-02 12:15,91,51,40,0,0,0
2024-03-02 12:30,73,40,33,0,0,0
2024-03-02 12:45,108,66,42,0,0,0
2024-03-02 13:00,88,44,44,0,0,0
2024-03-02 13:15,92,55,37,0,0,0
2024-03-02 13:30,100,60,40,0,0,0
2024-03-02 13:45,110,53,57,0,0,0
2024-03-02 14:00,91,39,52,0,0,0
2024-03-02 14:15,71,27,44,0,0,0
2024-03-02 14:30,81,39,42,0,0,0
2024-03-02 14:45,62,28,34,0,0,0
2024-03-02 15:00,69,33,36,0,0,0
2024-03-02 15:15,66,38,28,0,0,0
2024-03-02 15:30,81,37,44,0,0,0
2024-03-02 15:45,63,34,29,0,0,0
2024-03-02 16:00,64,24,40,0,0,0
2024-03-02 16:15,71,31,40,0,0,0
2024-03-02 16:30,64,25,39,0,0,0
2024-03-02 16:45,65,40,25,0,0,0
2024-03-02 17:00,54,25,29,0,0,0
2024-03-02 17:15,59,30,29,0,0,0
2024-03-02 17:30,50,27,23,0,0,0
2024-03-02 17:45,70,38,32,0,0,0
2024-03-02 18:00,70,31,39,0,0,0
2024-03-02 18:15,72,34,38,0,0,0
2024-03-02 18:30,67,34,33,0,0,0
2024-03-02 18:45,63,35,28,0,0,0
2024-03-02 19:00,53,30,23,0,0,0
2024-03-02 19:15,51,26,25,0,0,0
2024-03-02 19:30,49,21,28,0,0,0
2024-03-02 19:45,51,34,17,0,0,0
2024-03-02 20:00,41,21,20,0,0,0
2024-03-02 20:15,29,13,16,0,0,0
2024-03-02 20:30,23,12,11,0,0,0
2024-03-02 20:45,24,11,13,0,0,0
2024-03-02 21:00,28,14,14,0,0,0
2024-03-02 21:15,28,13,15,0,0,0
2024-03-02 21:30,19,5,14,0,0,0
2024-03-02 21:45,21,7,14,0,0,0
2024-03-02 22:00,18,9,9,0,0,0
2024-03-02 22:15,17,13,4,0,0,0
2024-03-02 22:30,44,15,29,0,0,0
2024-03-02 22:45,23,8,15,0,0,0
2024-03-02 23:00,42,17,25,0,0,0
2024-03-02 23:15,25,4,21,0,0,0
2024-03-02 23:30,19,4,15,0,0,0
2024-03-02 23:45,20,2,18,0,0,0
2024-03-03 00:00,14,3,11,0,0,0
2024-03-03 00:15,20,8,12,0,0,0
2024-03-03 00:30,11,4,7,0,0,0
2024-03-03 00:45,10,4,6,0,0,0
2024-03-03 01:00,12,3,9,0,0,0
2024-03-03 01:15,19,4,15,0,0,0
2024-03-03 01:30,10,4,6,0,0,0
2024-03-03 01:45,9,2,7,0,0,0
2024-03-03 02:00,7,2,5,0,0,0
2024-03-03 02:15,6,3,3,0,0,0
2024-03-03 02:30,5,2,3,0,0,0
2024-03-03 02:45,5,2,3,0,0,0
2024-03-03 03:00,14,3,11,0,0,0
2024-03-03 03:15,3,0,3,0,0,0
2024-03-03 03:30,3,1,2,0,0,0
2024-03-03 03:45,4,2,2,0,0,0
2024-03-03 04:00,2,0,2,0,0,0
2024-03-03 04:15,1,0,1,0,0,0
2024-03-03 04:30,0,0,0,0,0,0
2024-03-03 04:45,3,1,2,0,0,0
2024-03-03 05:00,1,1,0,0,0,0
2024-03-03 05:15,1,0,1,0,0,0
2024-03-03 05:30,4,3,1,0,0,0
2024-03-03 05:45,1,0,1,0,0,0
2024-03-03 06:00,8,3,5,0,0,0
2024-03-03 06:15,2,2,0,0,0,0
2024-03-03 06:30,2,1,1,0,0,0
2024-03-03 06:45,6,4,2,0,0,0
2024-03-03 07:00,3,0,3,0,0,0
2024-03-03 07:15,6,6,0,0,0,0
2024-03-03 07:30,5,3,2,0,0,0
2024-03-03 07:45,0,0,0,0,0,0
2024-03-03 08:00,2,1,1,0,0,0
2024-03-03 08:15,10,1,9,0,0,0
2024-03-03 08:30,14,12,2,0,0,0
2024-03-03 08:45,9,6,3,0,0,0
2024-03-03 09:00,11,5,6,0,0,0
2024-03-03 09:15,15,5,10,0,0,0
2024-03-03 09:30,15,10,5,0,0,0
2024-03-03 09:45,33,20,13,0,0,0
2024-03-03 10:00,37,25,12,0,0,0
2024-03-03 10:15,27,20,7,0,0,0
2024-03-03 10:30,42,30,12,0,0,0
2024-03-03 10:45,46,26,20,0,0,0
2024-03-03 11:00,44,28,16,0,0,0
2024-03-03 11:15,35,15,20,0,0,0
2024-03-03 11:30,37,32,5,0,0,0
2024-03-03 11:45,61,28,33,0,0,0
2024-03-03 12:00,30,10,20,0,0,0
2024-03-03 12:15,41,27,14,0,0,0
2024-03-03 12:30,39,17,22,0,0,0
2024-03-03 12:45,59,30,29,0,0,0
2024-03-03 13:00,63,37,26,0,0,0
2024-03-03 13:15,53,35,18,0,0,0
2024-03-03 13:30,75,39,36,0,0,0
2024-03-03 13:45,102,56,46,0,0,0
2024-03-03 14:00,61,34,27,0,0,0
2024-03-03 14:15,85,52,33,0,0,0
2024-03-03 14:30,67,46,21,0,0,0
2024-03-03 14:45,90,50,40,0,0,0
2024-03-03 15:00,82,43,39,0,0,0
2024-03-03 15:15,92,54,38,0,0,0
2024-03-03 15:30,67,48,19,0,0,0
2024-03-03 15:45,78,56,22,0,0,0
2024-03-03 16:00,57,27,30,0,0,0
2024-03-03 16:15,82,52,30,0,0,0
2024-03-03 16:30,85,43,42,0,0,0
2024-03-03 16:45,79,44,35,0,0,0
2024-03-03 17:00,101,40,61,0,0,0
2024-03-03 17:15,65,29,36,0,0,0
2024-03-03 17:30,68,30,38,0,0,0
2024-03-03 17:45,75,37,38,0,0,0
2024-03-03 18:00,51,23,28,0,0,0
2024-03-03 18:15,67,44,23,0,0,0
2024-03-03 18:30,61,32,29,0,0,0
2024-03-03 18:45,51,16,35,0,0,0
2024-03-03 19:00,38,14,24,0,0,0
2024-03-03 19:15,46,22,24,0,0,0
2024-03-03 19:30,42,20,22,0,0,0
2024-03-03 19:45,32,16,16,0,0,0
2024-03-03 20:00,33,18,15,0,0,0
2024-03-03 20:15,19,5,14,0,0,0
2024-03-03 20:30,21,7,14,0,0,0
2024-03-03 20:45,22,11,11,0,0,0
2024-03-03 21:00,15,6,9,0,0,0
2024-03-03 21:15,19,7,12,0,0,0
2024-03-03 21:30,15,4,11,0,0,0
2024-03-03 21:45,20,4,16,0,0,0
2024-03-03 22:00,13,4,9,0,0,0
2024-03-03 22:15,10,6,4,0,0,0
2024-03-03 22:30,7,4,3,0,0,0
2024-03-03 22:45,14,7,7,0,0,0
2024-03-03 23:00,9,3,6,0,0,0
2024-03-03 23:15,2,2,0,0,0,0
2024-03-03 23:30,8,3,5,0,0,0
2024-03-03 23:45,2,1,1,0,0,0
2024-03-04 00:00,2,1,1,0,0,0
2024-03-04 00:15,0,0,0,0,0,0
2024-03-04 00:30,4,1,3,0,0,0
2024-03-04 00:45,2,1,1,0,0,0
2024-03-04 01:00,2,1,1,0,0,0
2024-03-04 01:15,1,0,1,0,0,0
2024-03-04 01:30,0,0,0,0,0,0
2024-03-04 01:45,0,0,0,0,0,0
2024-03-04 02:00,0,0,0,0,0,0
2024-03-04 02:15,0,0,0,0,0,0
2024-03-04 02:30,2,0,2,0,0,0
2024-03-04 02:45,0,0,0,0,0,0
2024-03-04 03:00,1,1,0,0,0,0
2024-03-04 03:15,2,1,1,0,0,0
2024-03-04 03:30,0,0,0,0,0,0
2024-03-04 03:45,1,1,0,0,0,0
2024-03-04 04:00,0,0,0,0,0,0
2024-03-04 04:15,1,1,0,0,0,0
2024-03-04 04:30,0,0,0,0,0,0
2024-03-04 04:45,2,1,1,0,0,0
2024-03-04 05:00,3,0,3,0,0,0
2024-03-04 05:15,5,3,2,0,0,0
2024-03-04 05:30,8,5,3,0,0,0
2024-03-04 05:45,12,8,4,0,0,0
2024-03-04 06:00,20,14,6,0,0,0
2024-03-04 06:15,18,13,5,0,0,0
2024-03-04 06:30,28,22,6,0,0,0
2024-03-04 06:45,28,21,7,0,0,0
2024-03-04 07:00,52,37,15,0,0,0
2024-03-04 07:15,92,61,31,0,0,0
2024-03-04 07:30,183,121,62,0,0,0
2024-03-04 07:45,147,105,42,0,0,0
2024-03-04 08:00,106,85,21,0,0,0
2024-03-04 08:15,74,47,27,0,0,0
2024-03-04 08:30,88,65,23,0,0,0
2024-03-04 08:45,86,60,26,0,0,0
2024-03-04 09:00,64,40,24,0,0,0
2024-03-04 09:15,60,40,20,0,0,0
2024-03-04 09:30,51,41,10,0,0,0
2024-03-04 09:45,59,43,16,0,0,0
2024-03-04 10:00,45,20,25,0,0,0
2024-03-04 10:15,44,25,19,0,0,0
2024-03-04 10:30,42,33,9,0,0,0
2024-03-04 10:45,44,28,16,0,0,0
2024-03-04 11:00,41,24,17,0,0,0
2024-03-04 11:15,52,31,21,0,0,0
2024-03-04 11:30,54,32,22,0,0,0
2024-03-04 11:45,61,35,26,0,0,0
2024-03-04 12:00,54,25,29,0,0,0
2024-03-04 12:15,53,28,25,0,0,0
2024-03-04 12:30,41,14,27,0,0,0
2024-03-04 12:45,36,19,17,0,0,0
2024-03-04 13:00,105,56,49,0,0,0
2024-03-04 13:15,70,28,42,0,0,0
2024-03-04 13:30,59,26,33,0,0,0
2024-03-04 13:45,94,48,46,0,0,0
2024-03-04 14:00,54,21,33,0,0,0
2024-03-04 14:15,63,34,29,0,0,0
2024-03-04 14:30,57,29,28,0,0,0
2024-03-04 14:45,90,47,43,0,0,0
2024-03-04 15:00,58,26,32,0,0,0
2024-03-04 15:15,72,31,41,0,0,0
2024-03-04 15:30,119,56,63,0,0,0
2024-03-04 15:45,103,50,53,0,0,0
2024-03-04 16:00,90,39,51,0,0,0
2024-03-04 16:15,103,46,57,0,0,0
2024-03-04 16:30,105,48,57,0,0,0
2024-03-04 16:45,112,41,71,0,0,0
2024-03-04 17:00,97,49,48,0,0,0
2024-03-04 17:15,101,44,57,0,0,0
2024-03-04 17:30,117,52,65,0,0,0
2024-03-04 17:45,99,51,48,0,0,0
2024-03-04 18:00,87,26,61,0,0,0
2024-03-04 18:15,92,33,59,0,0,0
2024-03-04 18:30,73,32,41,0,0,0
2024-03-04 18:45,54,30,24,0,0,0
2024-03-04 19:00,69,16,53,0,0,0
2024-03-04 19:15,57,20,37,0,0,0
2024-03-04 19:30,61,26,35,0,0,0
2024-03-04 19:45,51,19,32,0,0,0
2024-03-04 20:00,33,15,18,0,0,0
2024-03-04 20:15,33,10,23,0,0,0
2024-03-04 20:30,25,12,13,0,0,0
2024-03-04 20:45,28,9,19,0,0,0
2024-03-04 21:00,28,12,16,0,0,0
2024-03-04 21:15,38,15,23,0,0,0
2024-03-04 21:30,22,11,11,0,0,0
2024-03-04 21:45,24,11,13,0,0,0
2024-03-04 22:00,18,3,15,0,0,0
2024-03-04 22:15,28,13,15,0,0,0
2024-03-04 22:30,23,10,13,0,0,0
2024-03-04 22:45,9,5,4,0,0,0
2024-03-04 23:00,7,5,2,0,0,0
2024-03-04 23:15,7,3,4,0,0,0
2024-03-04 23:30,7,4,3,0,0,0
2024-03-04 23:45,6,3,3,0,0,0
2024-03-05 00:00,4,1,3,0,0,0
2024-03-05 00:15,2,2,0,0,0,0
2024-03-05 00:30,3,1,2,0,0,0
2024-03-05 00:45,2,0,2,0,0,0
2024-03-05 01:00,0,0,0,0,0,0
2024-03-05 01:15,1,1,0,0,0,0
2024-03-05 01:30,0,0,0,0,0,0
2024-03-05 01:45,2,1,1,0,0,0
2024-03-05 02:00,1,0,1,0,0,0
2024-03-05 02:15,1,1,0,0,0,0
2024-03-05 02:30,1,0,1,0,0,0
2024-03-05 02:45,0,0,0,0,0,0
2024-03-05 03:00,1,1,0,0,0,0
2024-03-05 03:15,0,0,0,0,0,0
2024-03-05 03:30,0,0,0,0,0,0
2024-03-05 03:45,2,1,1,0,0,0
2024-03-05 04:00,0,0,0,0,0,0
2024-03-05 04:15,1,1,0,0,0,0
2024-03-05 04:30,0,0,0,0,0,0
2024-03-05 04:45,0,0,0,0,0,0
2024-03-05 05:00,3,2,1,0,0,0
2024-03-05 05:15,9,6,3,0,0,0
2024-03-05 05:30,7,5,2,0,0,0
2024-03-05 05:45,14,6,8,0,0,0
2024-03-05 06:00,17,10,7,0,0,0
2024-03-05 06:15,17,10,7,0,0,0
2024-03-05 06:30,35,27,8,0,0,0
2024-03-05 06:45,35,23,12,0,0,0
2024-03-05 07:00,56,39,17,0,0,0
2024-03-05 07:15,93,63,30,0,0,0
2024-03-05 07:30,179,130,49,0,0,0
2024-03-05 07:45,134,92,42,0,0,0
2024-03-05 08:00,94,67,27,0,0,0
2024-03-05 08:15,116,79,37,0,0,0
2024-03-05 08:30,95,69,26,0,0,0
2024-03-05 08:45,91,64,27,0,0,0
2024-03-05 09:00,63,43,20,0,0,0
2024-03-05 09:15,70,43,27,0,0,0
2024-03-05 09:30,85,56,29,0,0,0
2024-03-05 09:45,67,50,17,0,0,0
2024-03-05 10:00,62,34,28,0,0,0
2024-03-05 10:15,51,30,21,0,0,0
2024-03-05 10:30,57,30,27,0,0,0
2024-03-05 10:45,59,40,19,0,0,0
2024-03-05 11:00,49,34,15,0,0,0
2024-03-05 11:15,78,42,36,0,0,0
2024-03-05 11:30,54,29,25,0,0,0
2024-03-05 11:45,48,23,25,0,0,0
2024-03-05 12:00,52,26,26,0,0,0
2024-03-05 12:15,65,36,29,0,0,0
2024-03-05 12:30,63,32,31,0,0,0
2024-03-05 12:45,55,25,30,0,0,0
2024-03-05 13:00,138,73,65,0,0,0
2024-03-05 13:15,69,29,40,0,0,0
2024-03-05 13:30,63,40,23,0,0,0
2024-03-05 13:45,93,49,44,0,0,0
2024-03-05 14:00,75,27,48,0,0,0
2024-03-05 14:15,75,33,42,0,0,0
2024-03-05 14:30,69,31,38,0,0,0
2024-03-05 14:45,61,31,30,0,0,0
2024-03-05 15:00,86,39,47,0,0,0
2024-03-05 15:15,70,32,38,0,0,0
2024-03-05 15:30,111,49,62,0,0,0
2024-03-05 15:45,103,41,62,0,0,0
2024-03-05 16:00,94,53,41,0,0,0
2024-03-05 16:15,98,37,61,0,0,0
2024-03-05 16:30,98,39,59,0,0,0
2024-03-05 16:45,93,49,44,0,0,0
2024-03-05 17:00,80,29,51,0,0,0
2024-03-05 17:15,105,43,62,0,0,0
2024-03-05 17:30,101,49,52,0,0,0
2024-03-05 17:45,108,45,63,0,0,0
2024-03-05 18:00,76,31,45,0,0,0
2024-03-05 18:15,85,42,43,0,0,0
2024-03-05 18:30,71,32,39,0,0,0
2024-03-05 18:45,85,35,50,0,0,0
2024-03-05 19:00,73,33,40,0,0,0
2024-03-05 19:15,62,29,33,0,0,0
2024-03-05 19:30,50,22,28,0,0,0
2024-03-05 19:45,56,27,29,0,0,0
2024-03-05 20:00,51,18,33,0,0,0
2024-03-05 20:15,44,16,28,0,0,0
2024-03-05 20:30,27,12,15,0,0,0
2024-03-05 20:45,25,4,21,0,0,0
2024-03-05 21:00,22,4,18,0,0,0
2024-03-05 21:15,33,9,24,0,0,0
2024-03-05 21:30,20,8,12,0,0,0
2024-03-05 21:45,36,11,25,0,0,0
2024-03-05 22:00,37,14,23,0,0,0
2024-03-05 22:15,35,17,18,0,0,0
2024-03-05 22:30,32,12,20,0,0,0
2024-03-05 22:45,11,5,6,0,0,0
2024-03-05 23:00,13,6,7,0,0,0
2024-03-05 23:15,6,4,2,0,0,0
2024-03-05 23:30,3,1,2,0,0,0
2024-03-05 23:45,10,6,4,0,0,0
2024-03-06 00:00,4,1,3,0,0,0
2024-03-06 00:15,2,0,2,0,0,0
2024-03-06 00:30,4,2,2,0,0,0
2024-03-06 00:45,4,1,3,0,0,0
2024-03-06 01:00,1,0,1,0,0,0
2024-03-06 01:15,0,0,0,0,0,0
2024-03-06 01:30,3,3,0,0,0,0
2024-03-06 01:45,2,2,0,0,0,0
2024-03-06 02:00,0,0,0,0,0,0
2024-03-06 02:15,2,0,2,0,0,0
2024-03-06 02:30,0,0,0,0,0,0
2024-03-06 02:45,0,0,0,0,0,0
2024-03-06 03:00,2,2,0,0,0,0
2024-03-06 03:15,1,0,1,0,0,0
2024-03-06 03:30,0,0,0,0,0,0
2024-03-06 03:45,0,0,0,0,0,0
2024-03-06 04:00,1,0,1,0,0,0
2024-03-06 04:15,1,1,0,0,0,0
2024-03-06 04:30,0,0,0,0,0,0
2024-03-06 04:45,1,1,0,0,0,0
2024-03-06 05:00,1,0,1,0,0,0
2024-03-06 05:15,5,3,2,0,0,0
2024-03-06 05:30,6,3,3,0,0,0
2024-03-06 05:45,12,6,6,0,0,0
2024-03-06 06:00,18,12,6,0,0,0
2024-03-06 06:15,24,19,5,0,0,0
2024-03-06 06:30,34,26,8,0,0,0
2024-03-06 06:45,39,26,13,0,0,0
2024-03-06 07:00,62,44,18,0,0,0
2024-03-06 07:15,101,66,35,0,0,0
2024-03-06 07:30,178,120,58,0,0,0
2024-03-06 07:45,160,112,48,0,0,0
2024-03-06 08:00,86,71,15,0,0,0
2024-03-06 08:15,111,81,30,0,0,0
2024-03-06 08:30,91,63,28,0,0,0
2024-03-06 08:45,98,77,21,0,0,0
2024-03-06 09:00,64,47,17,0,0,0
2024-03-06 09:15,70,51,19,0,0,0
2024-03-06 09:30,87,60,27,0,0,0
2024-03-06 09:45,78,60,18,0,0,0
2024-03-06 10:00,63,45,18,0,0,0
2024-03-06 10:15,61,41,20,0,0,0
2024-03-06 10:30,57,38,19,0,0,0
2024-03-06 10:45,65,44,21,0,0,0
2024-03-06 11:00,54,27,27,0,0,0
2024-03-06 11:15,77,41,36,0,0,0
2024-03-06 11:30,71,39,32,0,0,0
2024-03-06 11:45,75,46,29,0,0,0
2024-03-06 12:00,83,37,46,0,0,0
2024-03-06 12:15,78,36,42,0,0,0
2024-03-06 12:30,80,49,31,0,0,0
2024-03-06 12:45,58,36,22,0,0,0
2024-03-06 13:00,121,55,66,0,0,0
2024-03-06 13:15,91,30,61,0,0,0
2024-03-06 13:30,73,35,38,0,0,0
2024-03-06 13:45,84,40,44,0,0,0
2024-03-06 14:00,75,38,37,0,0,0
2024-03-06 14:15,78,33,45,0,0,0
2024-03-06 14:30,67,39,28,0,0,0
2024-03-06 14:45,112,66,46,0,0,0
2024-03-06 15:00,79,31,48,0,0,0
2024-03-06 15:15,79,36,43,0,0,0
2024-03-06 15:30,111,64,47,0,0,0
2024-03-06 15:45,111,51,60,0,0,0
2024-03-06 16:00,110,45,65,0,0,0
2024-03-06 16:15,106,37,69,0,0,0
2024-03-06 16:30,106,43,63,0,0,0
2024-03-06 16:45,99,35,64,0,0,0
2024-03-06 17:00,112,61,51,0,0,0
2024-03-06 17:15,101,38,63,0,0,0
2024-03-06 17:30,95,38,57,0,0,0
2024-03-06 17:45,131,61,70,0,0,0
2024-03-06 18:00,101,43,58,0,0,0
2024-03-06 18:15,97,36,61,0,0,0
2024-03-06 18:30,82,42,40,0,0,0
2024-03-06 18:45,89,46,43,0,0,0
2024-03-06 19:00,87,40,47,0,0,0
2024-03-06 19:15,73,33,40,0,0,0
2024-03-06 19:30,56,21,35,0,0,0
2024-03-06 19:45,63,30,33,0,0,0
2024-03-06 20:00,51,23,28,0,0,0
2024-03-06 20:15,32,14,18,0,0,0
2024-03-06 20:30,41,13,28,0,0,0
2024-03-06 20:45,31,6,25,0,0,0
2024-03-06 21:00,32,12,20,0,0,0
2024-03-06 21:15,37,14,23,0,0,0
2024-03-06 21:30,25,6,19,0,0,0
2024-03-06 21:45,28,6,22,0,0,0
2024-03-06 22:00,35,12,23,0,0,0
2024-03-06 22:15,34,8,26,0,0,0
2024-03-06 22:30,28,9,19,0,0,0
2024-03-06 22:45,28,14,14,0,0,0
2024-03-06 23:00,31,17,14,0,0,0
2024-03-06 23:15,18,7,11,0,0,0
2024-03-06 23:30,5,0,5,0,0,0
2024-03-06 23:45,8,4,4,0,0,0
2024-03-07 00:00,5,2,3,0,0,0
2024-03-07 00:15,7,2,5,0,0,0
2024-03-07 00:30,4,3,1,0,0,0
2024-03-07 00:45,3,3,0,0,0,0
2024-03-07 01:00,2,0,2,0,0,0
2024-03-07 01:15,0,0,0,0,0,0
2024-03-07 01:30,2,0,2,0,0,0
2024-03-07 01:45,1,1,0,0,0,0
2024-03-07 02:00,0,0,0,0,0,0
2024-03-07 02:15,6,0,6,0,0,0
2024-03-07 02:30,1,0,1,0,0,0
2024-03-07 02:45,4,0,4,0,0,0
2024-03-07 03:00,2,1,1,0,0,0
2024-03-07 03:15,3,2,1,0,0,0
2024-03-07 03:30,0,0,0,0,0,0
2024-03-07 03:45,3,2,1,0,0,0
2024-03-07 04:00,0,0,0,0,0,0
2024-03-07 04:15,2,1,1,0,0,0
2024-03-07 04:30,0,0,0,0,0,0
2024-03-07 04:45,1,1,0,0,0,0
2024-03-07 05:00,2,0,2,0,0,0
2024-03-07 05:15,7,5,2,0,0,0
2024-03-07 05:30,7,5,2,0,0,0
2024-03-07 05:45,8,4,4,0,0,0
2024-03-07 06:00,23,13,10,0,0,0
2024-03-07 06:15,22,17,5,0,0,0
2024-03-07 06:30,29,20,9,0,0,0
2024-03-07 06:45,37,26,11,0,0,0
2024-03-07 07:00,51,36,15,0,0,0
2024-03-07 07:15,99,69,30,0,0,0
2024-03-07 07:30,181,128,53,0,0,0
2024-03-07 07:45,163,122,41,0,0,0
2024-03-07 08:00,103,81,22,0,0,0
2024-03-07 08:15,90,58,32,0,0,0
2024-03-07 08:30,93,72,21,0,0,0
2024-03-07 08:45,70,51,19,0,0,0
2024-03-07 09:00,63,39,24,0,0,0
2024-03-07 09:15,73,53,20,0,0,0
2024-03-07 09:30,70,46,24,0,0,0
2024-03-07 09:45,68,45,23,0,0,0
2024-03-07 10:00,32,22,10,0,0,0
2024-03-07 10:15,38,23,15,0,0,0
2024-03-07 10:30,50,30,20,0,0,0
2024-03-07 10:45,63,39,24,0,0,0
2024-03-07 11:00,47,24,23,0,0,0
2024-03-07 11:15,63,35,28,0,0,0
2024-03-07 11:30,54,33,21,0,0,0
2024-03-07 11:45,55,27,28,0,0,0
2024-03-07 12:00,44,25,19,0,0,0
2024-03-07 12:15,64,35,29,0,0,0
2024-03-07 12:30,58,23,35,0,0,0
2024-03-07 12:45,71,35,36,0,0,0
2024-03-07 13:00,95,46,49,0,0,0
2024-03-07 13:15,77,25,52,0,0,0
2024-03-07 13:30,66,28,38,0,0,0
2024-03-07 13:45,82,44,38,0,0,0
2024-03-07 14:00,79,39,40,0,0,0
2024-03-07 14:15,68,26,42,0,0,0
2024-03-07 14:30,69,35,34,0,0,0
2024-03-07 14:45,111,59,52,0,0,0
2024-03-07 15:00,78,38,40,0,0,0
2024-03-07 15:15,92,44,48,0,0,0
2024-03-07 15:30,129,67,62,0,0,0
2024-03-07 15:45,116,58,58,0,0,0
2024-03-07 16:00,125,57,68,0,0,0
2024-03-07 16:15,128,55,73,0,0,0
2024-03-07 16:30,123,63,60,0,0,0
2024-03-07 16:45,118,50,68,0,0,0
2024-03-07 17:00,106,44,62,0,0,0
2024-03-07 17:15,129,57,72,0,0,0
2024-03-07 17:30,100,36,64,0,0,0
2024-03-07 17:45,114,56,58,0,0,0
2024-03-07 18:00,103,41,62,0,0,0
2024-03-07 18:15,109,56,53,0,0,0
2024-03-07 18:30,106,34,72,0,0,0
2024-03-07 18:45,120,56,64,0,0,0
2024-03-07 19:00,85,47,38,0,0,0
2024-03-07 19:15,67,32,35,0,0,0
2024-03-07 19:30,56,32,24,0,0,0
2024-03-07 19:45,51,23,28,0,0,0
2024-03-07 20:00,59,19,40,0,0,0
2024-03-07 20:15,44,17,27,0,0,0
2024-03-07 20:30,40,14,26,0,0,0
2024-03-07 20:45,26,9,17,0,0,0
2024-03-07 21:00,20,6,14,0,0,0
2024-03-07 21:15,31,7,24,0,0,0
2024-03-07 21:30,30,8,22,0,0,0
2024-03-07 21:45,31,10,21,0,0,0
2024-03-07 22:00,32,11,21,0,0,0
2024-03-07 22:15,31,10,21,0,0,0
2024-03-07 22:30,25,7,18,0,0,0
2024-03-07 22:45,18,9,9,0,0,0
2024-03-07 23:00,18,6,12,0,0,0
2024-03-07 23:15,20,7,13,0,0,0
2024-03-07 23:30,11,5,6,0,0,0
2024-03-07 23:45,4,2,2,0,0,0
2024-03-08 00:00,2,1,1,0,0,0
2024-03-08 00:15,2,1,1,0,0,0
2024-03-08 00:30,1,1,0,0,0,0
2024-03-08 00:45,7,1,6,0,0,0
2024-03-08 01:00,6,0,6,0,0,0
2024-03-08 01:15,2,1,1,0,0,0
2024-03-08 01:30,2,1,1,0,0,0
2024-03-08 01:45,3,0,3,0,0,0
2024-03-08 02:00,2,0,2,0,0,0
2024-03-08 02:15,1,0,1,0,0,0
2024-03-08 02:30,0,0,0,0,0,0
2024-03-08 02:45,0,0,0,0,0,0
2024-03-08 03:00,1,1,0,0,0,0
2024-03-08 03:15,0,0,0,0,0,0
2024-03-08 03:30,0,0,0,0,0,0
2024-03-08 03:45,2,1,1,0,0,0
2024-03-08 04:00,0,0,0,0,0,0
2024-03-08 04:15,1,0,1,0,0,0
2024-03-08 04:30,0,0,0,0,0,0
2024-03-08 04:45,1,0,1,0,0,0
2024-03-08 05:00,5,3,2,0,0,0
2024-03-08 05:15,4,2,2,0,0,0
2024-03-08 05:30,7,5,2,0,0,0
2024-03-08 05:45,14,11,3,0,0,0
2024-03-08 06:00,15,10,5,0,0,0
2024-03-08 06:15,15,10,5,0,0,0
2024-03-08 06:30,18,14,4,0,0,0
2024-03-08 06:45,36,28,8,0,0,0
2024-03-08 07:00,43,27,16,0,0,0
2024-03-08 07:15,83,61,22,0,0,0
2024-03-08 07:30,173,135,38,0,0,0
2024-03-08 07:45,149,100,49,0,0,0
2024-03-08 08:00,74,57,17,0,0,0
2024-03-08 08:15,89,62,27,0,0,0
2024-03-08 08:30,71,50,21,0,0,0
2024-03-08 08:45,78,59,19,0,0,0
2024-03-08 09:00,57,39,18,0,0,0
2024-03-08 09:15,55,36,19,0,0,0
2024-03-08 09:30,72,48,24,0,0,0
2024-03-08 09:45,81,57,24,0,0,0
2024-03-08 10:00,58,34,24,0,0,0
2024-03-08 10:15,55,30,25,0,0,0
2024-03-08 10:30,55,35,20,0,0,0
2024-03-08 10:45,55,31,24,0,0,0
2024-03-08 11:00,72,44,28,0,0,0
2024-03-08 11:15,62,39,23,0,0,0
2024-03-08 11:30,57,31,26,0,0,0
2024-03-08 11:45,53,33,20,0,0,0
2024-03-08 12:00,64,37,27,0,0,0
2024-03-08 12:15,77,44,33,0,0,0
2024-03-08 12:30,74,38,36,0,0,0
2024-03-08 12:45,75,45,30,0,0,0
2024-03-08 13:00,135,74,61,0,0,0
2024-03-08 13:15,111,52,59,0,0,0
2024-03-08 13:30,98,44,54,0,0,0
2024-03-08 13:45,95,50,45,0,0,0
2024-03-08 14:00,88,35,53,0,0,0
2024-03-08 14:15,83,34,49,0,0,0
2024-03-08 14:30,80,37,43,0,0,0
2024-03-08 14:45,84,40,44,0,0,0
2024-03-08 15:00,82,35,47,0,0,0
2024-03-08 15:15,95,38,57,0,0,0
2024-03-08 15:30,101,58,43,0,0,0
2024-03-08 15:45,105,54,51,0,0,0
2024-03-08 16:00,103,64,39,0,0,0
2024-03-08 16:15,90,42,48,0,0,0
2024-03-08 16:30,88,38,50,0,0,0
2024-03-08 16:45,105,47,58,0,0,0
2024-03-08 17:00,85,43,42,0,0,0
2024-03-08 17:15,100,48,52,0,0,0
2024-03-08 17:30,90,40,50,0,0,0
2024-03-08 17:45,100,58,42,0,0,0
2024-03-08 18:00,82,40,42,0,0,0
2024-03-08 18:15,86,40,46,0,0,0
2024-03-08 18:30,84,45,39,0,0,0
2024-03-08 18:45,107,60,47,0,0,0
2024-03-08 19:00,94,53,41,0,0,0
2024-03-08 19:15,76,42,34,0,0,0
2024-03-08 19:30,56,30,26,0,0,0
2024-03-08 19:45,50,28,22,0,0,0
2024-03-08 20:00,35,16,19,0,0,0
2024-03-08 20:15,56,30,26,0,0,0
2024-03-08 20:30,44,26,18,0,0,0
2024-03-08 20:45,37,23,14,0,0,0
2024-03-08 21:00,31,12,19,0,0,0
2024-03-08 21:15,25,6,19,0,0,0
2024-03-08 21:30,29,10,19,0,0,0
2024-03-08 21:45,49,8,41,0,0,0
2024-03-08 22:00,53,9,44,0,0,0
2024-03-08 22:15,38,9,29,0,0,0
2024-03-08 22:30,34,9,25,0,0,0
2024-03-08 22:45,28,5,23,0,0,0
2024-03-08 23:00,33,5,28,0,0,0
2024-03-08 23:15,29,5,24,0,0,0
2024-03-08 23:30,25,11,14,0,0,0
2024-03-08 23:45,25,6,19,0,0,0
2024-03-09 00:00,16,8,8,0,0,0
2024-03-09 00:15,18,5,13,0,0,0
2024-03-09 00:30,18,6,12,0,0,0
2024-03-09 00:45,15,8,7,0,0,0
2024-03-09 01:00,12,4,8,0,0,0
2024-03-09 01:15,12,2,10,0,0,0
2024-03-09 01:30,9,7,2,0,0,0
2024-03-09 01:45,3,1,2,0,0,0
2024-03-09 02:00,6,3,3,0,0,0
2024-03-09 02:15,8,1,7,0,0,0
2024-03-09 02:30,12,6,6,0,0,0
2024-03-09 02:45,7,0,7,0,0,0
2024-03-09 03:00,12,1,11,0,0,0
2024-03-09 03:15,2,0,2,0,0,0
2024-03-09 03:30,2,1,1,0,0,0
2024-03-09 03:45,1,1,0,0,0,0
2024-03-09 04:00,3,1,2,0,0,0
2024-03-09 04:15,4,3,1,0,0,0
2024-03-09 04:30,2,1,1,0,0,0
2024-03-09 04:45,3,1,2,0,0,0
2024-03-09 05:00,3,3,0,0,0,0
2024-03-09 05:15,5,2,3,0,0,0
2024-03-09 05:30,1,0,1,0,0,0
2024-03-09 05:45,2,0,2,0,0,0
2024-03-09 06:00,4,2,2,0,0,0
2024-03-09 06:15,5,4,1,0,0,0
2024-03-09 06:30,4,4,0,0,0,0
2024-03-09 06:45,12,11,1,0,0,0
2024-03-09 07:00,14,14,0,0,0,0
2024-03-09 07:15,7,5,2,0,0,0
2024-03-09 07:30,20,16,4,0,0,0
2024-03-09 07:45,23,16,7,0,0,0
2024-03-09 08:00,15,11,4,0,0,0
2024-03-09 08:15,25,15,10,0,0,0
2024-03-09 08:30,41,27,14,0,0,0
2024-03-09 08:45,45,30,15,0,0,0
2024-03-09 09:00,29,17,12,0,0,0
2024-03-09 09:15,38,25,13,0,0,0
2024-03-09 09:30,48,37,11,0,0,0
2024-03-09 09:45,62,44,18,0,0,0
2024-03-09 10:00,47,32,15,0,0,0
2024-03-09 10:15,68,47,21,0,0,0
2024-03-09 10:30,43,27,16,0,0,0
2024-03-09 10:45,82,61,21,0,0,0
2024-03-09 11:00,65,41,24,0,0,0
2024-03-09 11:15,62,36,26,0,0,0
2024-03-09 11:30,75,52,23,0,0,0
2024-03-09 11:45,67,41,26,0,0,0
2024-03-09 12:00,75,42,33,0,0,0
2024-03-09 12:15,82,54,28,0,0,0
2024-03-09 12:30,73,43,30,0,0,0
2024-03-09 12:45,89,54,35,0,0,0
2024-03-09 13:00,85,52,33,0,0,0
2024-03-09 13:15,61,36,25,0,0,0
2024-03-09 13:30,78,41,37,0,0,0
2024-03-09 13:45,73,42,31,0,0,0
2024-03-09 14:00,69,27,42,0,0,0
2024-03-09 14:15,87,40,47,0,0,0
2024-03-09 14:30,56,23,33,0,0,0
2024-03-09 14:45,85,43,42,0,0,0
2024-03-09 15:00,91,56,35,0,0,0
2024-03-09 15:15,89,47,42,0,0,0
2024-03-09 15:30,80,50,30,0,0,0
2024-03-09 15:45,67,34,33,0,0,0
2024-03-09 16:00,71,29,42,0,0,0
2024-03-09 16:15,76,40,36,0,0,0
2024-03-09 16:30,61,31,30,0,0,0
2024-03-09 16:45,56,32,24,0,0,0
2024-03-09 17:00,70,33,37,0,0,0
2024-03-09 17:15,75,38,37,0,0,0
2024-03-09 17:30,77,42,35,0,0,0
2024-03-09 17:45,86,42,44,0,0,0
2024-03-09 18:00,62,38,24,0,0,0
2024-03-09 18:15,68,36,32,0,0,0
2024-03-09 18:30,65,23,42,0,0,0
2024-03-09 18:45,51,34,17,0,0,0
2024-03-09 19:00,58,23,35,0,0,0
2024-03-09 19:15,54,27,27,0,0,0
2024-03-09 19:30,48,21,27,0,0,0
2024-03-09 19:45,37,21,16,0,0,0
2024-03-09 20:00,39,14,25,0,0,0
2024-03-09 20:15,40,28,12,0,0,0
2024-03-09 20:30,34,17,17,0,0,0
2024-03-09 20:45,31,15,16,0,0,0
2024-03-09 21:00,17,6,11,0,0,0
2024-03-09 21:15,24,10,14,0,0,0
2024-03-09 21:30,24,4,20,0,0,0
2024-03-09 21:45,18,1,17,0,0,0
2024-03-09 22:00,31,17,14,0,0,0
2024-03-09 22:15,27,7,20,0,0,0
2024-03-09 22:30,24,9,15,0,0,0
2024-03-09 22:45,29,5,24,0,0,0
2024-03-09 23:00,30,10,20,0,0,0
2024-03-09 23:15,17,3,14,0,0,0
2024-03-09 23:30,24,11,13,0,0,0
2024-03-09 23:45,19,7,12,0,0,0
2024-03-10 00:00,21,6,15,0,0,0
2024-03-10 00:15,12,7,5,0,0,0
2024-03-10 00:30,12,3,9,0,0,0
2024-03-10 00:45,23,7,16,0,0,0
2024-03-10 01:00,11,3,8,0,0,0
2024-03-10 01:15,6,3,3,0,0,0
2024-03-10 01:30,13,3,10,0,0,0
2024-03-10 01:45,3,0,3,0,0,0
2024-03-10 02:00,9,2,7,0,0,0
2024-03-10 02:15,16,4,12,0,0,0
2024-03-10 02:30,8,4,4,0,0,0
2024-03-10 02:45,9,2,7,0,0,0
2024-03-10 03:00,4,1,3,0,0,0
2024-03-10 03:15,6,2,4,0,0,0
2024-03-10 03:30,5,2,3,0,0,0
2024-03-10 03:45,5,1,4,0,0,0
2024-03-10 04:00,2,1,1,0,0,0
2024-03-10 04:15,0,0,0,0,0,0
2024-03-10 04:30,0,0,0,0,0,0
2024-03-10 04:45,3,2,1,0,0,0
2024-03-10 05:00,0,0,0,0,0,0
2024-03-10 05:15,3,3,0,0,0,0
2024-03-10 05:30,3,2,1,0,0,0
2024-03-10 05:45,2,1,1,0,0,0
2024-03-10 06:00,5,2,3,0,0,0
2024-03-10 06:15,2,2,0,0,0,0
2024-03-10 06:30,2,1,1,0,0,0
2024-03-10 06:45,3,3,0,0,0,0
2024-03-10 07:00,1,1,0,0,0,0
2024-03-10 07:15,4,3,1,0,0,0
2024-03-10 07:30,8,6,2,0,0,0
2024-03-10 07:45,7,5,2,0,0,0
2024-03-10 08:00,5,2,3,0,0,0
2024-03-10 08:15,5,5,0,0,0,0
2024-03-10 08:30,7,5,2,0,0,0
2024-03-10 08:45,16,11,5,0,0,0
2024-03-10 09:00,4,2,2,0,0,0
2024-03-10 09:15,13,6,7,0,0,0
2024-03-10 09:30,16,11,5,0,0,0
2024-03-10 09:45,28,19,9,0,0,0
2024-03-10 10:00,24,12,12,0,0,0
2024-03-10 10:15,33,23,10,0,0,0
2024-03-10 10:30,25,13,12,0,0,0
2024-03-10 10:45,33,24,9,0,0,0
2024-03-10 11:00,30,16,14,0,0,0
2024-03-10 11:15,36,22,14,0,0,0
2024-03-10 11:30,42,26,16,0,0,0
2024-03-10 11:45,33,15,18,0,0,0
2024-03-10 12:00,38,20,18,0,0,0
2024-03-10 12:15,51,36,15,0,0,0
2024-03-10 12:30,51,24,27,0,0,0
2024-03-10 12:45,56,36,20,0,0,0
2024-03-10 13:00,36,22,14,0,0,0
2024-03-10 13:15,56,36,20,0,0,0
2024-03-10 13:30,55,28,27,0,0,0
2024-03-10 13:45,55,21,34,0,0,0
2024-03-10 14:00,57,29,28,0,0,0
2024-03-10 14:15,45,26,19,0,0,0
2024-03-10 14:30,52,25,27,0,0,0
2024-03-10 14:45,77,51,26,0,0,0
2024-03-10 15:00,57,31,26,0,0,0
2024-03-10 15:15,56,33,23,0,0,0
2024-03-10 15:30,61,28,33,0,0,0
2024-03-10 15:45,71,36,35,0,0,0
2024-03-10 16:00,56,32,24,0,0,0
2024-03-10 16:15,70,42,28,0,0,0
2024-03-10 16:30,57,31,26,0,0,0
2024-03-10 16:45,78,36,42,0,0,0
2024-03-10 17:00,56,25,31,0,0,0
2024-03-10 17:15,58,34,24,0,0,0
2024-03-10 17:30,53,24,29,0,0,0
2024-03-10 17:45,68,28,40,0,0,0
2024-03-10 18:00,59,25,34,0,0,0
2024-03-10 18:15,50,18,32,0,0,0
2024-03-10 18:30,57,18,39,0,0,0
2024-03-10 18:45,43,24,19,0,0,0
2024-03-10 19:00,24,11,13,0,0,0
2024-03-10 19:15,34,22,12,0,0,0
2024-03-10 19:30,22,7,15,0,0,0
2024-03-10 19:45,22,8,14,0,0,0
2024-03-10 20:00,39,14,25,0,0,0
2024-03-10 20:15,26,10,16,0,0,0
2024-03-10 20:30,18,5,13,0,0,0
2024-03-10 20:45,26,6,20,0,0,0
2024-03-10 21:00,20,9,11,0,0,0
2024-03-10 21:15,20,5,15,0,0,0
2024-03-10 21:30,19,7,12,0,0,0
2024-03-10 21:45,17,4,13,0,0,0
2024-03-10 22:00,15,2,13,0,0,0
2024-03-10 22:15,9,1,8,0,0,0
2024-03-10 22:30,14,6,8,0,0,0
2024-03-10 22:45,8,3,5,0,0,0
2024-03-10 23:00,7,2,5,0,0,0
2024-03-10 23:15,6,1,5,0,0,0
2024-03-10 23:30,7,1,6,0,0,0
2024-03-10 23:45,2,1,1,0,0,0
2024-03-11 00:00,0,0,0,0,0,0
2024-03-11 00:15,3,1,2,0,0,0
2024-03-11 00:30,1,1,0,0,0,0
2024-03-11 00:45,1,0,1,0,0,0
2024-03-11 01:00,1,1,0,0,0,0
2024-03-11 01:15,0,0,0,0,0,0
2024-03-11 01:30,1,0,1,0,0,0
2024-03-11 01:45,2,2,0,0,0,0
2024-03-11 02:00,2,2,0,0,0,0
2024-03-11 02:15,2,1,1,0,0,0
2024-03-11 02:30,1,0,1,0,0,0
2024-03-11 02:45,1,0,1,0,0,0
2024-03-11 03:00,0,0,0,0,0,0
2024-03-11 03:15,0,0,0,0,0,0
2024-03-11 03:30,0,0,0,0,0,0
2024-03-11 03:45,1,1,0,0,0,0
2024-03-11 04:00,0,0,0,0,0,0
2024-03-11 04:15,0,0,0,0,0,0
2024-03-11 04:30,2,1,1,0,0,0
2024-03-11 04:45,2,1,1,0,0,0
2024-03-11 05:00,3,2,1,0,0,0
2024-03-11 05:15,5,4,1,0,0,0
2024-03-11 05:30,8,6,2,0,0,0
2024-03-11 05:45,10,4,6,0,0,0
2024-03-11 06:00,12,8,4,0,0,0
2024-03-11 06:15,18,11,7,0,0,0
2024-03-11 06:30,27,20,7,0,0,0
2024-03-11 06:45,29,21,8,0,0,0
2024-03-11 07:00,52,40,12,0,0,0
2024-03-11 07:15,74,52,22,0,0,0
2024-03-11 07:30,164,123,41,0,0,0
2024-03-11 07:45,144,101,43,0,0,0
2024-03-11 08:00,82,60,22,0,0,0
2024-03-11 08:15,73,56,17,0,0,0
2024-03-11 08:30,81,56,25,0,0,0
2024-03-11 08:45,67,45,22,0,0,0
2024-03-11 09:00,45,33,12,0,0,0
2024-03-11 09:15,56,37,19,0,0,0
2024-03-11 09:30,80,52,28,0,0,0
2024-03-11 09:45,55,44,11,0,0,0
2024-03-11 10:00,30,24,6,0,0,0
2024-03-11 10:15,37,30,7,0,0,0
2024-03-11 10:30,46,27,19,0,0,0
2024-03-11 10:45,47,26,21,0,0,0
2024-03-11 11:00,40,29,11,0,0,0
2024-03-11 11:15,59,35,24,0,0,0
2024-03-11 11:30,43,24,19,0,0,0
2024-03-11 11:45,52,28,24,0,0,0
2024-03-11 12:00,44,21,23,0,0,0
2024-03-11 12:15,45,24,21,0,0,0
2024-03-11 12:30,56,26,30,0,0,0
2024-03-11 12:45,61,23,38,0,0,0
2024-03-11 13:00,75,40,35,0,0,0
2024-03-11 13:15,60,29,31,0,0,0
2024-03-11 13:30,45,19,26,0,0,0
2024-03-11 13:45,60,26,34,0,0,0
2024-03-11 14:00,57,25,32,0,0,0
2024-03-11 14:15,62,26,36,0,0,0
2024-03-11 14:30,60,27,33,0,0,0
2024-03-11 14:45,84,42,42,0,0,0
2024-03-11 15:00,61,28,33,0,0,0
2024-03-11 15:15,58,24,34,0,0,0
2024-03-11 15:30,103,60,43,0,0,0
2024-03-11 15:45,70,39,31,0,0,0
2024-03-11 16:00,94,36,58,0,0,0
2024-03-11 16:15,80,33,47,0,0,0
2024-03-11 16:30,74,29,45,0,0,0
2024-03-11 16:45,80,34,46,0,0,0
2024-03-11 17:00,66,26,40,0,0,0
2024-03-11 17:15,84,35,49,0,0,0
2024-03-11 17:30,114,37,77,0,0,0
2024-03-11 17:45,83,38,45,0,0,0
2024-03-11 18:00,95,45,50,0,0,0
2024-03-11 18:15,83,33,50,0,0,0
2024-03-11 18:30,64,24,40,0,0,0
2024-03-11 18:45,58,18,40,0,0,0
2024-03-11 19:00,57,24,33,0,0,0
2024-03-11 19:15,55,30,25,0,0,0
2024-03-11 19:30,49,24,25,0,0,0
2024-03-11 19:45,50,18,32,0,0,0
2024-03-11 20:00,47,27,20,0,0,0
2024-03-11 20:15,33,18,15,0,0,0
2024-03-11 20:30,28,11,17,0,0,0
2024-03-11 20:45,19,9,10,0,0,0
2024-03-11 21:00,23,9,14,0,0,0
2024-03-11 21:15,22,6,16,0,0,0
2024-03-11 21:30,22,7,15,0,0,0
2024-03-11 21:45,26,9,17,0,0,0
2024-03-11 22:00,16,2,14,0,0,0
2024-03-11 22:15,17,6,11,0,0,0
2024-03-11 22:30,24,14,10,0,0,0
2024-03-11 22:45,22,13,9,0,0,0
2024-03-11 23:00,7,2,5,0,0,0
2024-03-11 23:15,12,2,10,0,0,0
2024-03-11 23:30,9,5,4,0,0,0
2024-03-11 23:45,5,1,4,0,0,0
2024-03-12 00:00,1,0,1,0,0,0
2024-03-12 00:15,3,1,2,0,0,0
2024-03-12 00:30,3,0,3,0,0,0
2024-03-12 00:45,2,1,1,0,0,0
2024-03-12 01:00,1,0,1,0,0,0
2024-03-12 01:15,1,1,0,0,0,0
2024-03-12 01:30,0,0,0,0,0,0
2024-03-12 01:45,0,0,0,0,0,0
2024-03-12 02:00,0,0,0,0,0,0
2024-03-12 02:15,1,0,1,0,0,0
2024-03-12 02:30,0,0,0,0,0,0
2024-03-12 02:45,3,1,2,0,0,0
2024-03-12 03:00,0,0,0,0,0,0
2024-03-12 03:15,1,1,0,0,0,0
2024-03-12 03:30,1,1,0,0,0,0
2024-03-12 03:45,1,1,0,0,0,0
2024-03-12 04:00,0,0,0,0,0,0
2024-03-12 04:15,0,0,0,0,0,0
2024-03-12 04:30,1,1,0,0,0,0
2024-03-12 04:45,1,0,1,0,0,0
2024-03-12 05:00,4,1,3,0,0,0
2024-03-12 05:15,4,3,1,0,0,0
2024-03-12 05:30,10,7,3,0,0,0
2024-03-12 05:45,11,7,4,0,0,0
2024-03-12 06:00,12,7,5,0,0,0
2024-03-12 06:15,19,13,6,0,0,0
2024-03-12 06:30,32,23,9,0,0,0
2024-03-12 06:45,41,30,11,0,0,0
2024-03-12 07:00,48,34,14,0,0,0
2024-03-12 07:15,96,66,30,0,0,0
2024-03-12 07:30,201,154,47,0,0,0
2024-03-12 07:45,168,122,46,0,0,0
2024-03-12 08:00,88,64,24,0,0,0
2024-03-12 08:15,101,67,34,0,0,0
2024-03-12 08:30,73,53,20,0,0,0
2024-03-12 08:45,69,52,17,0,0,0
2024-03-12 09:00,70,48,22,0,0,0
2024-03-12 09:15,54,35,19,0,0,0
2024-03-12 09:30,78,46,32,0,0,0
2024-03-12 09:45,55,32,23,0,0,0
2024-03-12 10:00,44,31,13,0,0,0
2024-03-12 10:15,38,24,14,0,0,0
2024-03-12 10:30,38,25,13,0,0,0
2024-03-12 10:45,63,36,27,0,0,0
2024-03-12 11:00,35,22,13,0,0,0
2024-03-12 11:15,69,41,28,0,0,0
2024-03-12 11:30,46,23,23,0,0,0
2024-03-12 11:45,48,28,20,0,0,0
2024-03-12 12:00,45,24,21,0,0,0
2024-03-12 12:15,44,25,19,0,0,0
2024-03-12 12:30,55,27,28,0,0,0
2024-03-12 12:45,51,26,25,0,0,0
2024-03-12 13:00,125,66,59,0,0,0
2024-03-12 13:15,78,40,38,0,0,0
2024-03-12 13:30,60,32,28,0,0,0
2024-03-12 13:45,77,41,36,0,0,0
2024-03-12 14:00,47,23,24,0,0,0
2024-03-12 14:15,69,31,38,0,0,0
2024-03-12 14:30,56,30,26,0,0,0
2024-03-12 14:45,79,41,38,0,0,0
2024-03-12 15:00,74,31,43,0,0,0
2024-03-12 15:15,68,29,39,0,0,0
2024-03-12 15:30,102,43,59,0,0,0
2024-03-12 15:45,79,35,44,0,0,0
2024-03-12 16:00,92,43,49,0,0,0
2024-03-12 16:15,97,42,55,0,0,0
2024-03-12 16:30,94,34,60,0,0,0
2024-03-12 16:45,105,44,61,0,0,0
2024-03-12 17:00,90,30,60,0,0,0
2024-03-12 17:15,96,50,46,0,0,0
2024-03-12 17:30,102,51,51,0,0,0
2024-03-12 17:45,107,43,64,0,0,0
2024-03-12 18:00,98,38,60,0,0,0
2024-03-12 18:15,106,43,63,0,0,0
2024-03-12 18:30,87,33,54,0,0,0
2024-03-12 18:45,73,30,43,0,0,0
2024-03-12 19:00,71,30,41,0,0,0
2024-03-12 19:15,65,30,35,0,0,0
2024-03-12 19:30,50,18,32,0,0,0
2024-03-12 19:45,57,25,32,0,0,0
2024-03-12 20:00,47,16,31,0,0,0
2024-03-12 20:15,50,21,29,0,0,0
2024-03-12 20:30,21,8,13,0,0,0
2024-03-12 20:45,24,3,21,0,0,0
2024-03-12 21:00,30,10,20,0,0,0
2024-03-12 21:15,37,10,27,0,0,0
2024-03-12 21:30,43,15,28,0,0,0
2024-03-12 21:45,27,8,19,0,0,0
2024-03-12 22:00,22,6,16,0,0,0
2024-03-12 22:15,25,9,16,0,0,0
2024-03-12 22:30,23,7,16,0,0,0
2024-03-12 22:45,24,9,15,0,0,0
2024-03-12 23:00,24,8,16,0,0,0
2024-03-12 23:15,10,8,2,0,0,0
2024-03-12 23:30,13,4,9,0,0,0
2024-03-12 23:45,2,1,1,0,0,0
2024-03-13 00:00,6,3,3,0,0,0
2024-03-13 00:15,4,0,4,0,0,0
2024-03-13 00:30,4,2,2,0,0,0
2024-03-13 00:45,4,2,2,0,0,0
2024-03-13 01:00,1,1,0,0,0,0
2024-03-13 01:15,4,2,2,0,0,0
2024-03-13 01:30,0,0,0,0,0,0
2024-03-13 01:45,0,0,0,0,0,0
2024-03-13 02:00,1,0,1,0,0,0
2024-03-13 02:15,1,0,1,0,0,0
2024-03-13 02:30,1,1,0,0,0,0
2024-03-13 02:45,1,1,0,0,0,0
2024-03-13 03:00,0,0,0,0,0,0
2024-03-13 03:15,3,2,1,0,0,0
2024-03-13 03:30,1,1,0,0,0,0
2024-03-13 03:45,0,0,0,0,0,0
2024-03-13 04:00,0,0,0,0,0,0
2024-03-13 04:15,1,1,0,0,0,0
2024-03-13 04:30,0,0,0,0,0,0
2024-03-13 04:45,3,2,1,0,0,0
2024-03-13 05:00,2,2,0,0,0,0
2024-03-13 05:15,9,5,4,0,0,0
2024-03-13 05:30,10,7,3,0,0,0
2024-03-13 05:45,10,4,6,0,0,0
2024-03-13 06:00,20,13,7,0,0,0
2024-03-13 06:15,25,21,4,0,0,0
2024-03-13 06:30,31,24,7,0,0,0
2024-03-13 06:45,43,29,14,0,0,0
2024-03-13 07:00,44,29,15,0,0,0
2024-03-13 07:15,91,72,19,0,0,0
2024-03-13 07:30,166,124,42,0,0,0
2024-03-13 07:45,160,110,50,0,0,0
2024-03-13 08:00,90,70,20,0,0,0
2024-03-13 08:15,77,53,24,0,0,0
2024-03-13 08:30,82,64,18,0,0,0
2024-03-13 08:45,91,61,30,0,0,0
2024-03-13 09:00,75,55,20,0,0,0
2024-03-13 09:15,57,41,16,0,0,0
2024-03-13 09:30,86,62,24,0,0,0
2024-03-13 09:45,63,42,21,0,0,0
2024-03-13 10:00,69,46,23,0,0,0
2024-03-13 10:15,45,24,21,0,0,0
2024-03-13 10:30,42,27,15,0,0,0
2024-03-13 10:45,57,33,24,0,0,0
2024-03-13 11:00,49,26,23,0,0,0
2024-03-13 11:15,61,38,23,0,0,0
2024-03-13 11:30,52,32,20,0,0,0
2024-03-13 11:45,60,28,32,0,0,0
2024-03-13 12:00,82,46,36,0,0,0
2024-03-13 12:15,70,34,36,0,0,0
2024-03-13 12:30,70,32,38,0,0,0
2024-03-13 12:45,67,30,37,0,0,0
2024-03-13 13:00,95,41,54,0,0,0
2024-03-13 13:15,63,34,29,0,0,0
2024-03-13 13:30,71,28,43,0,0,0
2024-03-13 13:45,83,32,51,0,0,0
2024-03-13 14:00,71,24,47,0,0,0
2024-03-13 14:15,68,27,41,0,0,0
2024-03-13 14:30,87,39,48,0,0,0
2024-03-13 14:45,90,48,42,0,0,0
2024-03-13 15:00,79,28,51,0,0,0
2024-03-13 15:15,74,31,43,0,0,0
2024-03-13 15:30,102,46,56,0,0,0
2024-03-13 15:45,104,38,66,0,0,0
2024-03-13 16:00,79,39,40,0,0,0
2024-03-13 16:15,87,34,53,0,0,0
2024-03-13 16:30,83,29,54,0,0,0
2024-03-13 16:45,90,41,49,0,0,0
2024-03-13 17:00,81,33,48,0,0,0
2024-03-13 17:15,88,37,51,0,0,0
2024-03-13 17:30,84,38,46,0,0,0
2024-03-13 17:45,109,48,61,0,0,0
2024-03-13 18:00,80,34,46,0,0,0
2024-03-13 18:15,88,29,59,0,0,0
2024-03-13 18:30,69,32,37,0,0,0
2024-03-13 18:45,89,47,42,0,0,0
2024-03-13 19:00,65,29,36,0,0,0
2024-03-13 19:15,67,38,29,0,0,0
2024-03-13 19:30,56,32,24,0,0,0
2024-03-13 19:45,73,34,39,0,0,0
2024-03-13 20:00,47,24,23,0,0,0
2024-03-13 20:15,48,20,28,0,0,0
2024-03-13 20:30,36,8,28,0,0,0
2024-03-13 20:45,33,17,16,0,0,0
2024-03-13 21:00,28,11,17,0,0,0
2024-03-13 21:15,37,15,22,0,0,0
2024-03-13 21:30,28,15,13,0,0,0
2024-03-13 21:45,28,12,16,0,0,0
2024-03-13 22:00,29,10,19,0,0,0
2024-03-13 22:15,27,10,17,0,0,0
2024-03-13 22:30,24,6,18,0,0,0
2024-03-13 22:45,20,8,12,0,0,0
2024-03-13 23:00,28,12,16,0,0,0
2024-03-13 23:15,19,5,14,0,0,0
2024-03-13 23:30,13,5,8,0,0,0
2024-03-13 23:45,16,8,8,0,0,0
2024-03-14 00:00,11,5,6,0,0,0
2024-03-14 00:15,5,0,5,0,0,0
2024-03-14 00:30,5,2,3,0,0,0
2024-03-14 00:45,4,3,1,0,0,0
2024-03-14 01:00,4,0,4,0,0,0
2024-03-14 01:15,6,1,5,0,0,0
2024-03-14 01:30,2,1,1,0,0,0
2024-03-14 01:45,5,1,4,0,0,0
2024-03-14 02:00,2,1,1,0,0,0
2024-03-14 02:15,2,0,2,0,0,0
2024-03-14 02:30,4,3,1,0,0,0
2024-03-14 02:45,1,0,1,0,0,0
2024-03-14 03:00,1,0,1,0,0,0
2024-03-14 03:15,3,1,2,0,0,0
2024-03-14 03:30,1,0,1,0,0,0
2024-03-14 03:45,2,1,1,0,0,0
2024-03-14 04:00,2,1,1,0,0,0
2024-03-14 04:15,0,0,0,0,0,0
2024-03-14 04:30,2,0,2,0,0,0
2024-03-14 04:45,1,1,0,0,0,0
2024-03-14 05:00,2,2,0,0,0,0
2024-03-14 05:15,4,2,2,0,0,0
2024-03-14 05:30,5,3,2,0,0,0
2024-03-14 05:45,14,7,7,0,0,0
2024-03-14 06:00,15,9,6,0,0,0
2024-03-14 06:15,17,11,6,0,0,0
2024-03-14 06:30,41,29,12,0,0,0
2024-03-14 06:45,36,24,12,0,0,0
2024-03-14 07:00,44,33,11,0,0,0
2024-03-14 07:15,95,64,31,0,0,0
2024-03-14 07:30,173,131,42,0,0,0
2024-03-14 07:45,144,110,34,0,0,0
2024-03-14 08:00,98,72,26,0,0,0
2024-03-14 08:15,105,68,37,0,0,0
2024-03-14 08:30,74,52,22,0,0,0
2024-03-14 08:45,85,63,22,0,0,0
2024-03-14 09:00,69,53,16,0,0,0
2024-03-14 09:15,55,39,16,0,0,0
2024-03-14 09:30,109,77,32,0,0,0
2024-03-14 09:45,68,51,17,0,0,0
2024-03-14 10:00,61,41,20,0,0,0
2024-03-14 10:15,52,27,25,0,0,0
2024-03-14 10:30,56,32,24,0,0,0
2024-03-14 10:45,58,40,18,0,0,0
2024-03-14 11:00,52,35,17,0,0,0
2024-03-14 11:15,79,56,23,0,0,0
2024-03-14 11:30,69,39,30,0,0,0
2024-03-14 11:45,59,34,25,0,0,0
2024-03-14 12:00,63,34,29,0,0,0
2024-03-14 12:15,56,34,22,0,0,0
2024-03-14 12:30,78,42,36,0,0,0
2024-03-14 12:45,72,23,49,0,0,0
2024-03-14 13:00,103,45,58,0,0,0
2024-03-14 13:15,86,36,50,0,0,0
2024-03-14 13:30,73,33,40,0,0,0
2024-03-14 13:45,81,39,42,0,0,0
2024-03-14 14:00,75,29,46,0,0,0
2024-03-14 14:15,90,36,54,0,0,0
2024-03-14 14:30,101,53,48,0,0,0
2024-03-14 14:45,122,60,62,0,0,0
2024-03-14 15:00,90,50,40,0,0,0
2024-03-14 15:15,79,34,45,0,0,0
2024-03-14 15:30,144,76,68,0,0,0
2024-03-14 15:45,105,43,62,0,0,0
2024-03-14 16:00,121,55,66,0,0,0
2024-03-14 16:15,117,55,62,0,0,0
2024-03-14 16:30,115,48,67,0,0,0
2024-03-14 16:45,125,66,59,0,0,0
2024-03-14 17:00,133,59,74,0,0,0
2024-03-14 17:15,111,55,56,0,0,0
2024-03-14 17:30,98,44,54,0,0,0
2024-03-14 17:45,101,38,63,0,0,0
2024-03-14 18:00,117,53,64,0,0,0
2024-03-14 18:15,115,51,64,0,0,0
2024-03-14 18:30,90,40,50,0,0,0
2024-03-14 18:45,81,36,45,0,0,0
2024-03-14 19:00,78,34,44,0,0,0
2024-03-14 19:15,75,33,42,0,0,0
2024-03-14 19:30,67,38,29,0,0,0
2024-03-14 19:45,61,25,36,0,0,0
2024-03-14 20:00,41,14,27,0,0,0
2024-03-14 20:15,39,20,19,0,0,0
2024-03-14 20:30,31,10,21,0,0,0
2024-03-14 20:45,34,21,13,0,0,0
2024-03-14 21:00,20,5,15,0,0,0
2024-03-14 21:15,27,9,18,0,0,0
2024-03-14 21:30,27,12,15,0,0,0
2024-03-14 21:45,36,12,24,0,0,0
2024-03-14 22:00,31,9,22,0,0,0
2024-03-14 22:15,32,9,23,0,0,0
2024-03-14 22:30,29,9,20,0,0,0
2024-03-14 22:45,29,9,20,0,0,0
2024-03-14 23:00,13,9,4,0,0,0
2024-03-14 23:15,14,8,6,0,0,0
2024-03-14 23:30,14,4,10,0,0,0
2024-03-14 23:45,11,2,9,0,0,0
2024-03-15 00:00,7,1,6,0,0,0
2024-03-15 00:15,1,1,0,0,0,0
2024-03-15 00:30,5,4,1,0,0,0
2024-03-15 00:45,2,1,1,0,0,0
2024-03-15 01:00,4,0,4,0,0,0
2024-03-15 01:15,3,1,2,0,0,0
2024-03-15 01:30,2,1,1,0,0,0
2024-03-15 01:45,2,0,2,0,0,0
2024-03-15 02:00,0,0,0,0,0,0
2024-03-15 02:15,1,0,1,0,0,0
2024-03-15 02:30,1,0,1,0,0,0
2024-03-15 02:45,0,0,0,0,0,0
2024-03-15 03:00,1,0,1,0,0,0
2024-03-15 03:15,1,0,1,0,0,0
2024-03-15 03:30,1,0,1,0,0,0
2024-03-15 03:45,0,0,0,0,0,0
2024-03-15 04:00,0,0,0,0,0,0
2024-03-15 04:15,2,1,1,0,0,0
2024-03-15 04:30,3,2,1,0,0,0
2024-03-15 04:45,1,0,1,0,0,0
2024-03-15 05:00,3,2,1,0,0,0
2024-03-15 05:15,2,1,1,0,0,0
2024-03-15 05:30,14,11,3,0,0,0
2024-03-15 05:45,7,3,4,0,0,0
2024-03-15 06:00,9,4,5,0,0,0
2024-03-15 06:15,13,9,4,0,0,0
2024-03-15 06:30,26,17,9,0,0,0
2024-03-15 06:45,40,27,13,0,0,0
2024-03-15 07:00,31,19,12,0,0,0
2024-03-15 07:15,77,59,18,0,0,0
2024-03-15 07:30,155,109,46,0,0,0
2024-03-15 07:45,143,103,40,0,0,0
2024-03-15 08:00,73,52,21,0,0,0
2024-03-15 08:15,88,61,27,0,0,0
2024-03-15 08:30,72,53,19,0,0,0
2024-03-15 08:45,78,57,21,0,0,0
2024-03-15 09:00,56,40,16,0,0,0
2024-03-15 09:15,54,42,12,0,0,0
2024-03-15 09:30,84,55,29,0,0,0
2024-03-15 09:45,71,51,20,0,0,0
2024-03-15 10:00,51,29,22,0,0,0
2024-03-15 10:15,52,36,16,0,0,0
2024-03-15 10:30,52,29,23,0,0,0
2024-03-15 10:45,54,32,22,0,0,0
2024-03-15 11:00,59,33,26,0,0,0
2024-03-15 11:15,71,36,35,0,0,0
2024-03-15 11:30,64,35,29,0,0,0
2024-03-15 11:45,58,26,32,0,0,0
2024-03-15 12:00,62,32,30,0,0,0
2024-03-15 12:15,61,31,30,0,0,0
2024-03-15 12:30,62,28,34,0,0,0
2024-03-15 12:45,86,45,41,0,0,0
2024-03-15 13:00,118,52,66,0,0,0
2024-03-15 13:15,71,27,44,0,0,0
2024-03-15 13:30,76,33,43,0,0,0
2024-03-15 13:45,78,34,44,0,0,0
2024-03-15 14:00,73,31,42,0,0,0
2024-03-15 14:15,76,39,37,0,0,0
2024-03-15 14:30,66,34,32,0,0,0
2024-03-15 14:45,85,29,56,0,0,0
2024-03-15 15:00,81,38,43,0,0,0
2024-03-15 15:15,76,34,42,0,0,0
2024-03-15 15:30,79,43,36,0,0,0
2024-03-15 15:45,80,36,44,0,0,0
2024-03-15 16:00,67,35,32,0,0,0
2024-03-15 16:15,75,36,39,0,0,0
2024-03-15 16:30,67,29,38,0,0,0
2024-03-15 16:45,64,24,40,0,0,0
2024-03-15 17:00,68,30,38,0,0,0
2024-03-15 17:15,64,37,27,0,0,0
2024-03-15 17:30,72,33,39,0,0,0
2024-03-15 17:45,69,28,41,0,0,0
2024-03-15 18:00,65,32,33,0,0,0
2024-03-15 18:15,70,28,42,0,0,0
2024-03-15 18:30,53,25,28,0,0,0
2024-03-15 18:45,65,34,31,0,0,0
2024-03-15 19:00,75,24,51,0,0,0
2024-03-15 19:15,62,31,31,0,0,0
2024-03-15 19:30,68,43,25,0,0,0
2024-03-15 19:45,40,25,15,0,0,0
2024-03-15 20:00,34,20,14,0,0,0
2024-03-15 20:15,43,28,15,0,0,0
2024-03-15 20:30,27,12,15,0,0,0
2024-03-15 20:45,29,7,22,0,0,0
2024-03-15 21:00,25,11,14,0,0,0
2024-03-15 21:15,22,9,13,0,0,0
2024-03-15 21:30,20,8,12,0,0,0
2024-03-15 21:45,29,13,16,0,0,0
2024-03-15 22:00,25,8,17,0,0,0
2024-03-15 22:15,19,8,11,0,0,0
2024-03-15 22:30,23,4,19,0,0,0
2024-03-15 22:45,23,5,18,0,0,0
2024-03-15 23:00,30,11,19,0,0,0
2024-03-15 23:15,16,6,10,0,0,0
2024-03-15 23:30,30,13,17,0,0,0
2024-03-15 23:45,25,11,14,0,0,0
2024-03-16 00:00,19,6,13,0,0,0
2024-03-16 00:15,12,5,7,0,0,0
2024-03-16 00:30,19,5,14,0,0,0
2024-03-16 00:45,17,4,13,0,0,0
2024-03-16 01:00,16,6,10,0,0,0
2024-03-16 01:15,15,3,12,0,0,0
2024-03-16 01:30,12,9,3,0,0,0
2024-03-16 01:45,11,4,7,0,0,0
2024-03-16 02:00,6,3,3,0,0,0
2024-03-16 02:15,6,0,6,0,0,0
2024-03-16 02:30,4,3,1,0,0,0
2024-03-16 02:45,7,3,4,0,0,0
2024-03-16 03:00,5,0,5,0,0,0
2024-03-16 03:15,1,0,1,0,0,0
2024-03-16 03:30,2,0,2,0,0,0
2024-03-16 03:45,3,1,2,0,0,0
2024-03-16 04:00,2,1,1,0,0,0
2024-03-16 04:15,2,1,1,0,0,0
2024-03-16 04:30,0,0,0,0,0,0
2024-03-16 04:45,4,3,1,0,0,0
2024-03-16 05:00,4,2,2,0,0,0
2024-03-16 05:15,3,2,1,0,0,0
2024-03-16 05:30,6,2,4,0,0,0
2024-03-16 05:45,7,3,4,0,0,0
2024-03-16 06:00,2,1,1,0,0,0
2024-03-16 06:15,6,6,0,0,0,0
2024-03-16 06:30,2,2,0,0,0,0
2024-03-16 06:45,7,6,1,0,0,0
2024-03-16 07:00,8,7,1,0,0,0
2024-03-16 07:15,8,3,5,0,0,0
2024-03-16 07:30,8,5,3,0,0,0
2024-03-16 07:45,16,15,1,0,0,0
2024-03-16 08:00,21,14,7,0,0,0
2024-03-16 08:15,17,11,6,0,0,0
2024-03-16 08:30,30,19,11,0,0,0
2024-03-16 08:45,38,22,16,0,0,0
2024-03-16 09:00,31,22,9,0,0,0
2024-03-16 09:15,33,25,8,0,0,0
2024-03-16 09:30,46,36,10,0,0,0
2024-03-16 09:45,64,41,23,0,0,0
2024-03-16 10:00,55,37,18,0,0,0
2024-03-16 10:15,44,29,15,0,0,0
2024-03-16 10:30,45,37,8,0,0,0
2024-03-16 10:45,76,53,23,0,0,0
2024-03-16 11:00,59,37,22,0,0,0
2024-03-16 11:15,41,28,13,0,0,0
2024-03-16 11:30,64,41,23,0,0,0
2024-03-16 11:45,53,31,22,0,0,0
2024-03-16 12:00,63,44,19,0,0,0
2024-03-16 12:15,76,41,35,0,0,0
2024-03-16 12:30,64,36,28,0,0,0
2024-03-16 12:45,72,42,30,0,0,0
2024-03-16 13:00,72,37,35,0,0,0
2024-03-16 13:15,92,48,44,0,0,0
2024-03-16 13:30,77,48,29,0,0,0
2024-03-16 13:45,81,45,36,0,0,0
2024-03-16 14:00,77,42,35,0,0,0
2024-03-16 14:15,68,35,33,0,0,0
2024-03-16 14:30,79,37,42,0,0,0
2024-03-16 14:45,69,25,44,0,0,0
2024-03-16 15:00,64,31,33,0,0,0
2024-03-16 15:15,59,29,30,0,0,0
2024-03-16 15:30,52,15,37,0,0,0
2024-03-16 15:45,54,28,26,0,0,0
2024-03-16 16:00,70,33,37,0,0,0
2024-03-16 16:15,67,29,38,0,0,0
2024-03-16 16:30,74,32,42,0,0,0
2024-03-16 16:45,58,29,29,0,0,0
2024-03-16 17:00,44,21,23,0,0,0
2024-03-16 17:15,54,33,21,0,0,0
2024-03-16 17:30,66,25,41,0,0,0
2024-03-16 17:45,51,26,25,0,0,0
2024-03-16 18:00,64,31,33,0,0,0
2024-03-16 18:15,57,29,28,0,0,0
2024-03-16 18:30,42,21,21,0,0,0
2024-03-16 18:45,60,42,18,0,0,0
2024-03-16 19:00,57,32,25,0,0,0
2024-03-16 19:15,53,27,26,0,0,0
2024-03-16 19:30,47,26,21,0,0,0
2024-03-16 19:45,56,25,31,0,0,0
2024-03-16 20:00,39,19,20,0,0,0
2024-03-16 20:15,35,15,20,0,0,0
2024-03-16 20:30,28,9,19,0,0,0
2024-03-16 20:45,25,14,11,0,0,0
2024-03-16 21:00,31,9,22,0,0,0
2024-03-16 21:15,16,5,11,0,0,0
2024-03-16 21:30,15,4,11,0,0,0
2024-03-16 21:45,35,11,24,0,0,0
2024-03-16 22:00,26,11,15,0,0,0
2024-03-16 22:15,31,13,18,0,0,0
2024-03-16 22:30,21,4,17,0,0,0
2024-03-16 22:45,17,3,14,0,0,0
2024-03-16 23:00,17,4,13,0,0,0
2024-03-16 23:15,29,19,10,0,0,0
2024-03-16 23:30,28,8,20,0,0,0
2024-03-16 23:45,15,6,9,0,0,0
2024-03-17 00:00,15,9,6,0,0,0
2024-03-17 00:15,22,10,12,0,0,0
2024-03-17 00:30,18,4,14,0,0,0
2024-03-17 00:45,10,2,8,0,0,0
2024-03-17 01:00,7,2,5,0,0,0
2024-03-17 01:15,14,8,6,0,0,0
2024-03-17 01:30,4,3,1,0,0,0
2024-03-17 01:45,12,8,4,0,0,0
2024-03-17 02:00,6,0,6,0,0,0
2024-03-17 02:15,11,1,10,0,0,0
2024-03-17 02:30,4,2,2,0,0,0
2024-03-17 02:45,4,2,2,0,0,0
2024-03-17 03:00,5,0,5,0,0,0
2024-03-17 03:15,4,3,1,0,0,0
2024-03-17 03:30,2,0,2,0,0,0
2024-03-17 03:45,3,0,3,0,0,0
2024-03-17 04:00,1,0,1,0,0,0
2024-03-17 04:15,3,2,1,0,0,0
2024-03-17 04:30,2,0,2,0,0,0
2024-03-17 04:45,1,1,0,0,0,0
2024-03-17 05:00,2,2,0,0,0,0
2024-03-17 05:15,1,1,0,0,0,0
2024-03-17 05:30,2,2,0,0,0,0
2024-03-17 05:45,4,2,2,0,0,0
2024-03-17 06:00,3,1,2,0,0,0
2024-03-17 06:15,1,1,0,0,0,0
2024-03-17 06:30,2,2,0,0,0,0
2024-03-17 06:45,1,1,0,0,0,0
2024-03-17 07:00,1,0,1,0,0,0
2024-03-17 07:15,0,0,0,0,0,0
2024-03-17 07:30,5,4,1,0,0,0
2024-03-17 07:45,6,2,4,0,0,0
2024-03-17 08:00,8,8,0,0,0,0
2024-03-17 08:15,8,3,5,0,0,0
2024-03-17 08:30,10,9,1,0,0,0
2024-03-17 08:45,9,5,4,0,0,0
2024-03-17 09:00,16,12,4,0,0,0
2024-03-17 09:15,12,5,7,0,0,0
2024-03-17 09:30,18,12,6,0,0,0
2024-03-17 09:45,42,31,11,0,0,0
2024-03-17 10:00,37,23,14,0,0,0
2024-03-17 10:15,23,18,5,0,0,0
2024-03-17 10:30,41,29,12,0,0,0
2024-03-17 10:45,35,21,14,0,0,0
2024-03-17 11:00,35,14,21,0,0,0
2024-03-17 11:15,36,19,17,0,0,0
2024-03-17 11:30,42,28,14,0,0,0
2024-03-17 11:45,31,22,9,0,0,0
2024-03-17 12:00,45,28,17,0,0,0
2024-03-17 12:15,39,16,23,0,0,0
2024-03-17 12:30,45,25,20,0,0,0
2024-03-17 12:45,59,27,32,0,0,0
2024-03-17 13:00,47,24,23,0,0,0
2024-03-17 13:15,48,33,15,0,0,0
2024-03-17 13:30,41,21,20,0,0,0
2024-03-17 13:45,71,42,29,0,0,0
2024-03-17 14:00,48,25,23,0,0,0
2024-03-17 14:15,59,33,26,0,0,0
2024-03-17 14:30,60,33,27,0,0,0
2024-03-17 14:45,55,32,23,0,0,0
2024-03-17 15:00,43,20,23,0,0,0
2024-03-17 15:15,36,16,20,0,0,0
2024-03-17 15:30,47,24,23,0,0,0
2024-03-17 15:45,50,29,21,0,0,0
2024-03-17 16:00,54,35,19,0,0,0
2024-03-17 16:15,46,29,17,0,0,0
2024-03-17 16:30,71,43,28,0,0,0
2024-03-17 16:45,53,25,28,0,0,0
2024-03-17 17:00,46,23,23,0,0,0
2024-03-17 17:15,49,20,29,0,0,0
2024-03-17 17:30,58,28,30,0,0,0
2024-03-17 17:45,49,24,25,0,0,0
2024-03-17 18:00,41,20,21,0,0,0
2024-03-17 18:15,55,26,29,0,0,0
2024-03-17 18:30,38,21,17,0,0,0
2024-03-17 18:45,40,29,11,0,0,0
2024-03-17 19:00,19,10,9,0,0,0
2024-03-17 19:15,28,16,12,0,0,0
2024-03-17 19:30,33,11,22,0,0,0
2024-03-17 19:45,35,14,21,0,0,0
2024-03-17 20:00,36,12,24,0,0,0
2024-03-17 20:15,27,11,16,0,0,0
2024-03-17 20:30,22,8,14,0,0,0
2024-03-17 20:45,18,4,14,0,0,0
2024-03-17 21:00,20,5,15,0,0,0
2024-03-17 21:15,16,5,11,0,0,0
2024-03-17 21:30,12,4,8,0,0,0
2024-03-17 21:45,19,4,15,0,0,0
2024-03-17 22:00,10,3,7,0,0,0
2024-03-17 22:15,14,6,8,0,0,0
2024-03-17 22:30,11,6,5,0,0,0
2024-03-17 22:45,15,7,8,0,0,0
2024-03-17 23:00,6,4,2,0,0,0
2024-03-17 23:15,3,2,1,0,0,0
2024-03-17 23:30,3,3,0,0,0,0
2024-03-17 23:45,3,0,3,0,0,0
2024-03-18 00:00,3,0,3,0,0,0
2024-03-18 00:15,2,1,1,0,0,0
2024-03-18 00:30,6,0,6,0,0,0
2024-03-18 00:45,1,0,1,0,0,0
2024-03-18 01:00,1,0,1,0,0,0
2024-03-18 01:15,0,0,0,0,0,0
2024-03-18 01:30,5,1,4,0,0,0
2024-03-18 01:45,1,0,1,0,0,0
2024-03-18 02:00,1,0,1,0,0,0
2024-03-18 02:15,1,1,0,0,0,0
2024-03-18 02:30,0,0,0,0,0,0
2024-03-18 02:45,0,0,0,0,0,0
2024-03-18 03:00,1,0,1,0,0,0
2024-03-18 03:15,0,0,0,0,0,0
2024-03-18 03:30,0,0,0,0,0,0
2024-03-18 03:45,1,1,0,0,0,0
2024-03-18 04:00,1,1,0,0,0,0
2024-03-18 04:15,0,0,0,0,0,0
2024-03-18 04:30,3,3,0,0,0,0
2024-03-18 04:45,0,0,0,0,0,0
2024-03-18 05:00,6,4,2,0,0,0
2024-03-18 05:15,6,4,2,0,0,0
2024-03-18 05:30,3,2,1,0,0,0
2024-03-18 05:45,16,9,7,0,0,0
2024-03-18 06:00,20,15,5,0,0,0
2024-03-18 06:15,20,13,7,0,0,0
2024-03-18 06:30,33,21,12,0,0,0
2024-03-18 06:45,33,20,13,0,0,0
2024-03-18 07:00,41,27,14,0,0,0
2024-03-18 07:15,111,79,32,0,0,0
2024-03-18 07:30,180,137,43,0,0,0
2024-03-18 07:45,163,109,54,0,0,0
2024-03-18 08:00,106,85,21,0,0,0
2024-03-18 08:15,85,55,30,0,0,0
2024-03-18 08:30,92,74,18,0,0,0
2024-03-18 08:45,84,61,23,0,0,0
2024-03-18 09:00,46,32,14,0,0,0
2024-03-18 09:15,54,43,11,0,0,0
2024-03-18 09:30,62,45,17,0,0,0
2024-03-18 09:45,82,56,26,0,0,0
2024-03-18 10:00,42,24,18,0,0,0
2024-03-18 10:15,49,34,15,0,0,0
2024-03-18 10:30,53,36,17,0,0,0
2024-03-18 10:45,53,31,22,0,0,0
2024-03-18 11:00,41,23,18,0,0,0
2024-03-18 11:15,60,39,21,0,0,0
2024-03-18 11:30,51,29,22,0,0,0
2024-03-18 11:45,54,26,28,0,0,0
2024-03-18 12:00,62,26,36,0,0,0
2024-03-18 12:15,66,38,28,0,0,0
2024-03-18 12:30,78,41,37,0,0,0
2024-03-18 12:45,62,31,31,0,0,0
2024-03-18 13:00,81,38,43,0,0,0
2024-03-18 13:15,62,30,32,0,0,0
2024-03-18 13:30,56,24,32,0,0,0
2024-03-18 13:45,77,33,44,0,0,0
2024-03-18 14:00,63,31,32,0,0,0
2024-03-18 14:15,46,18,28,0,0,0
2024-03-18 14:30,61,35,26,0,0,0
2024-03-18 14:45,98,47,51,0,0,0
2024-03-18 15:00,72,33,39,0,0,0
2024-03-18 15:15,97,46,51,0,0,0
2024-03-18 15:30,99,42,57,0,0,0
2024-03-18 15:45,104,53,51,0,0,0
2024-03-18 16:00,98,47,51,0,0,0
2024-03-18 16:15,125,55,70,0,0,0
2024-03-18 16:30,109,38,71,0,0,0
2024-03-18 16:45,108,42,66,0,0,0
2024-03-18 17:00,90,46,44,0,0,0
2024-03-18 17:15,101,37,64,0,0,0
2024-03-18 17:30,122,39,83,0,0,0
2024-03-18 17:45,107,45,62,0,0,0
2024-03-18 18:00,102,35,67,0,0,0
2024-03-18 18:15,97,39,58,0,0,0
2024-03-18 18:30,83,33,50,0,0,0
2024-03-18 18:45,68,30,38,0,0,0
2024-03-18 19:00,66,37,29,0,0,0
2024-03-18 19:15,59,28,31,0,0,0
2024-03-18 19:30,56,26,30,0,0,0
2024-03-18 19:45,55,33,22,0,0,0
2024-03-18 20:00,50,25,25,0,0,0
2024-03-18 20:15,42,19,23,0,0,0
2024-03-18 20:30,23,8,15,0,0,0
2024-03-18 20:45,23,8,15,0,0,0
2024-03-18 21:00,25,3,22,0,0,0
2024-03-18 21:15,26,11,15,0,0,0
2024-03-18 21:30,32,11,21,0,0,0
2024-03-18 21:45,28,11,17,0,0,0
2024-03-18 22:00,29,7,22,0,0,0
2024-03-18 22:15,24,12,12,0,0,0
2024-03-18 22:30,21,11,10,0,0,0
2024-03-18 22:45,9,2,7,0,0,0
2024-03-18 23:00,11,5,6,0,0,0
2024-03-18 23:15,9,3,6,0,0,0
2024-03-18 23:30,8,2,6,0,0,0
2024-03-18 23:45,5,0,5,0,0,0
2024-03-19 00:00,9,5,4,0,0,0
2024-03-19 00:15,2,1,1,0,0,0
2024-03-19 00:30,6,1,5,0,0,0
2024-03-19 00:45,1,0,1,0,0,0
2024-03-19 01:00,1,1,0,0,0,0
2024-03-19 01:15,3,0,3,0,0,0
2024-03-19 01:30,2,0,2,0,0,0
2024-03-19 01:45,1,1,0,0,0,0
2024-03-19 02:00,0,0,0,0,0,0
2024-03-19 02:15,2,1,1,0,0,0
2024-03-19 02:30,1,0,1,0,0,0
2024-03-19 02:45,4,0,4,0,0,0
2024-03-19 03:00,0,0,0,0,0,0
2024-03-19 03:15,0,0,0,0,0,0
2024-03-19 03:30,2,2,0,0,0,0
2024-03-19 03:45,1,1,0,0,0,0
2024-03-19 04:00,0,0,0,0,0,0
2024-03-19 04:15,0,0,0,0,0,0
2024-03-19 04:30,3,2,1,0,0,0
2024-03-19 04:45,1,1,0,0,0,0
2024-03-19 05:00,3,2,1,0,0,0
2024-03-19 05:15,5,3,2,0,0,0
2024-03-19 05:30,7,6,1,0,0,0
2024-03-19 05:45,18,12,6,0,0,0
2024-03-19 06:00,19,11,8,0,0,0
2024-03-19 06:15,21,14,7,0,0,0
2024-03-19 06:30,36,25,11,0,0,0
2024-03-19 06:45,45,32,13,0,0,0
2024-03-19 07:00,50,30,20,0,0,0
2024-03-19 07:15,97,69,28,0,0,0
2024-03-19 07:30,193,146,47,0,0,0
2024-03-19 07:45,153,110,43,0,0,0
2024-03-19 08:00,98,75,23,0,0,0
2024-03-19 08:15,84,65,19,0,0,0
2024-03-19 08:30,88,66,22,0,0,0
2024-03-19 08:45,98,61,37,0,0,0
2024-03-19 09:00,71,47,24,0,0,0
2024-03-19 09:15,80,55,25,0,0,0
2024-03-19 09:30,79,47,32,0,0,0
2024-03-19 09:45,74,57,17,0,0,0
2024-03-19 10:00,50,33,17,0,0,0
2024-03-19 10:15,41,26,15,0,0,0
2024-03-19 10:30,61,36,25,0,0,0
2024-03-19 10:45,60,34,26,0,0,0
2024-03-19 11:00,51,26,25,0,0,0
2024-03-19 11:15,54,35,19,0,0,0
2024-03-19 11:30,56,32,24,0,0,0
2024-03-19 11:45,71,33,38,0,0,0
2024-03-19 12:00,60,36,24,0,0,0
2024-03-19 12:15,70,35,35,0,0,0
2024-03-19 12:30,71,40,31,0,0,0
2024-03-19 12:45,77,33,44,0,0,0
2024-03-19 13:00,136,72,64,0,0,0
2024-03-19 13:15,72,36,36,0,0,0
2024-03-19 13:30,82,43,39,0,0,0
2024-03-19 13:45,85,46,39,0,0,0
2024-03-19 14:00,63,25,38,0,0,0
2024-03-19 14:15,70,30,40,0,0,0
2024-03-19 14:30,68,30,38,0,0,0
2024-03-19 14:45,89,44,45,0,0,0
2024-03-19 15:00,83,41,42,0,0,0
2024-03-19 15:15,81,38,43,0,0,0
2024-03-19 15:30,99,43,56,0,0,0
2024-03-19 15:45,122,52,70,0,0,0
2024-03-19 16:00,100,39,61,0,0,0
2024-03-19 16:15,107,40,67,0,0,0
2024-03-19 16:30,119,55,64,0,0,0
2024-03-19 16:45,104,47,57,0,0,0
2024-03-19 17:00,119,55,64,0,0,0
2024-03-19 17:15,85,33,52,0,0,0
2024-03-19 17:30,126,50,76,0,0,0
2024-03-19 17:45,109,44,65,0,0,0
2024-03-19 18:00,110,51,59,0,0,0
2024-03-19 18:15,86,35,51,0,0,0
2024-03-19 18:30,96,43,53,0,0,0
2024-03-19 18:45,91,43,48,0,0,0
2024-03-19 19:00,62,22,40,0,0,0
2024-03-19 19:15,72,27,45,0,0,0
2024-03-19 19:30,66,29,37,0,0,0
2024-03-19 19:45,49,25,24,0,0,0
2024-03-19 20:00,50,17,33,0,0,0
2024-03-19 20:15,41,15,26,0,0,0
2024-03-19 20:30,25,11,14,0,0,0
2024-03-19 20:45,26,13,13,0,0,0
2024-03-19 21:00,28,14,14,0,0,0
2024-03-19 21:15,34,14,20,0,0,0
2024-03-19 21:30,34,11,23,0,0,0
2024-03-19 21:45,37,18,19,0,0,0
2024-03-19 22:00,30,6,24,0,0,0
2024-03-19 22:15,30,11,19,0,0,0
2024-03-19 22:30,24,9,15,0,0,0
2024-03-19 22:45,26,6,20,0,0,0
2024-03-19 23:00,14,8,6,0,0,0
2024-03-19 23:15,13,5,8,0,0,0
2024-03-19 23:30,19,6,13,0,0,0
2024-03-19 23:45,14,5,9,0,0,0
2024-03-20 00:00,6,3,3,0,0,0
2024-03-20 00:15,13,8,5,0,0,0
2024-03-20 00:30,1,0,1,0,0,0
2024-03-20 00:45,3,0,3,0,0,0
2024-03-20 01:00,2,0,2,0,0,0
2024-03-20 01:15,0,0,0,0,0,0
2024-03-20 01:30,1,0,1,0,0,0
2024-03-20 01:45,0,0,0,0,0,0
2024-03-20 02:00,2,1,1,0,0,0
2024-03-20 02:15,2,1,1,0,0,0
2024-03-20 02:30,0,0,0,0,0,0
2024-03-20 02:45,0,0,0,0,0,0
2024-03-20 03:00,0,0,0,0,0,0
2024-03-20 03:15,0,0,0,0,0,0
2024-03-20 03:30,3,1,2,0,0,0
2024-03-20 03:45,2,0,2,0,0,0
2024-03-20 04:00,0,0,0,0,0,0
2024-03-20 04:15,3,1,2,0,0,0
2024-03-20 04:30,5,3,2,0,0,0
2024-03-20 04:45,0,0,0,0,0,0
2024-03-20 05:00,3,2,1,0,0,0
2024-03-20 05:15,4,2,2,0,0,0
2024-03-20 05:30,12,10,2,0,0,0
2024-03-20 05:45,16,8,8,0,0,0
2024-03-20 06:00,18,12,6,0,0,0
2024-03-20 06:15,24,18,6,0,0,0
2024-03-20 06:30,38,25,13,0,0,0
2024-03-20 06:45,44,31,13,0,0,0
2024-03-20 07:00,51,36,15,0,0,0
2024-03-20 07:15,100,73,27,0,0,0
2024-03-20 07:30,179,131,48,0,0,0
2024-03-20 07:45,162,121,41,0,0,0
2024-03-20 08:00,102,73,29,0,0,0
2024-03-20 08:15,93,63,30,0,0,0
2024-03-20 08:30,110,74,36,0,0,0
2024-03-20 08:45,106,71,35,0,0,0
2024-03-20 09:00,69,44,25,0,0,0
2024-03-20 09:15,75,50,25,0,0,0
2024-03-20 09:30,95,69,26,0,0,0
2024-03-20 09:45,101,74,27,0,0,0
2024-03-20 10:00,71,50,21,0,0,0
2024-03-20 10:15,54,34,20,0,0,0
2024-03-20 10:30,65,41,24,0,0,0
2024-03-20 10:45,59,47,12,0,0,0
2024-03-20 11:00,50,28,22,0,0,0
2024-03-20 11:15,80,52,28,0,0,0
2024-03-20 11:30,78,40,38,0,0,0
2024-03-20 11:45,76,43,33,0,0,0
2024-03-20 12:00,85,40,45,0,0,0
2024-03-20 12:15,79,50,29,0,0,0
2024-03-20 12:30,81,39,42,0,0,0
2024-03-20 12:45,79,41,38,0,0,0
2024-03-20 13:00,112,57,55,0,0,0
2024-03-20 13:15,106,41,65,0,0,0
2024-03-20 13:30,77,38,39,0,0,0
2024-03-20 13:45,91,36,55,0,0,0
2024-03-20 14:00,91,42,49,0,0,0
2024-03-20 14:15,81,40,41,0,0,0
2024-03-20 14:30,91,48,43,0,0,0
2024-03-20 14:45,121,55,66,0,0,0
2024-03-20 15:00,88,48,40,0,0,0
2024-03-20 15:15,100,43,57,0,0,0
2024-03-20 15:30,133,69,64,0,0,0
2024-03-20 15:45,114,58,56,0,0,0
2024-03-20 16:00,108,47,61,0,0,0
2024-03-20 16:15,120,50,70,0,0,0
2024-03-20 16:30,99,51,48,0,0,0
2024-03-20 16:45,117,47,70,0,0,0
2024-03-20 17:00,86,41,45,0,0,0
2024-03-20 17:15,94,38,56,0,0,0
2024-03-20 17:30,114,49,65,0,0,0
2024-03-20 17:45,125,59,66,0,0,0
2024-03-20 18:00,86,40,46,0,0,0
2024-03-20 18:15,94,35,59,0,0,0
2024-03-20 18:30,80,24,56,0,0,0
2024-03-20 18:45,79,41,38,0,0,0
2024-03-20 19:00,79,42,37,0,0,0
2024-03-20 19:15,77,44,33,0,0,0
2024-03-20 19:30,70,26,44,0,0,0
2024-03-20 19:45,64,21,43,0,0,0
2024-03-20 20:00,61,26,35,0,0,0
2024-03-20 20:15,49,19,30,0,0,0
2024-03-20 20:30,46,18,28,0,0,0
2024-03-20 20:45,48,21,27,0,0,0
2024-03-20 21:00,35,17,18,0,0,0
2024-03-20 21:15,26,11,15,0,0,0
2024-03-20 21:30,32,11,21,0,0,0
2024-03-20 21:45,24,5,19,0,0,0
2024-03-20 22:00,34,20,14,0,0,0
2024-03-20 22:15,31,14,17,0,0,0
2024-03-20 22:30,26,9,17,0,0,0
2024-03-20 22:45,32,16,16,0,0,0
2024-03-20 23:00,22,9,13,0,0,0
2024-03-20 23:15,21,8,13,0,0,0
2024-03-20 23:30,11,6,5,0,0,0
2024-03-20 23:45,8,4,4,0,0,0
2024-03-21 00:00,15,4,11,0,0,0
2024-03-21 00:15,6,2,4,0,0,0
2024-03-21 00:30,5,2,3,0,0,0
2024-03-21 00:45,12,4,8,0,0,0
2024-03-21 01:00,5,2,3,0,0,0
2024-03-21 01:15,2,0,2,0,0,0
2024-03-21 01:30,0,0,0,0,0,0
2024-03-21 01:45,5,2,3,0,0,0
2024-03-21 02:00,6,1,5,0,0,0
2024-03-21 02:15,6,1,5,0,0,0
2024-03-21 02:30,3,0,3,0,0,0
2024-03-21 02:45,1,0,1,0,0,0
2024-03-21 03:00,1,0,1,0,0,0
2024-03-21 03:15,3,0,3,0,0,0
2024-03-21 03:30,3,1,2,0,0,0
2024-03-21 03:45,2,0,2,0,0,0
2024-03-21 04:00,3,0,3,0,0,0
2024-03-21 04:15,2,2,0,0,0,0
2024-03-21 04:30,3,1,2,0,0,0
2024-03-21 04:45,3,2,1,0,0,0
2024-03-21 05:00,4,2,2,0,0,0
2024-03-21 05:15,3,3,0,0,0,0
2024-03-21 05:30,7,5,2,0,0,0
2024-03-21 05:45,17,8,9,0,0,0
2024-03-21 06:00,16,11,5,0,0,0
2024-03-21 06:15,22,16,6,0,0,0
2024-03-21 06:30,31,19,12,0,0,0
2024-03-21 06:45,40,27,13,0,0,0
2024-03-21 07:00,60,37,23,0,0,0
2024-03-21 07:15,93,67,26,0,0,0
2024-03-21 07:30,197,152,45,0,0,0
2024-03-21 07:45,164,116,48,0,0,0
2024-03-21 08:00,107,81,26,0,0,0
2024-03-21 08:15,97,64,33,0,0,0
2024-03-21 08:30,92,68,24,0,0,0
2024-03-21 08:45,76,52,24,0,0,0
2024-03-21 09:00,58,44,14,0,0,0
2024-03-21 09:15,73,54,19,0,0,0
2024-03-21 09:30,81,51,30,0,0,0
2024-03-21 09:45,86,60,26,0,0,0
2024-03-21 10:00,44,30,14,0,0,0
2024-03-21 10:15,52,29,23,0,0,0
2024-03-21 10:30,50,29,21,0,0,0
2024-03-21 10:45,64,35,29,0,0,0
2024-03-21 11:00,47,32,15,0,0,0
2024-03-21 11:15,49,27,22,0,0,0
2024-03-21 11:30,71,36,35,0,0,0
2024-03-21 11:45,54,27,27,0,0,0
2024-03-21 12:00,52,20,32,0,0,0
2024-03-21 12:15,53,25,28,0,0,0
2024-03-21 12:30,57,24,33,0,0,0
2024-03-21 12:45,65,35,30,0,0,0
2024-03-21 13:00,110,53,57,0,0,0
2024-03-21 13:15,77,36,41,0,0,0
2024-03-21 13:30,65,24,41,0,0,0
2024-03-21 13:45,73,31,42,0,0,0
2024-03-21 14:00,79,32,47,0,0,0
2024-03-21 14:15,75,29,46,0,0,0
2024-03-21 14:30,82,49,33,0,0,0
2024-03-21 14:45,102,57,45,0,0,0
2024-03-21 15:00,107,48,59,0,0,0
2024-03-21 15:15,96,36,60,0,0,0
2024-03-21 15:30,131,61,70,0,0,0
2024-03-21 15:45,123,51,72,0,0,0
2024-03-21 16:00,122,55,67,0,0,0
2024-03-21 16:15,125,55,70,0,0,0
2024-03-21 16:30,118,49,69,0,0,0
2024-03-21 16:45,112,60,52,0,0,0
2024-03-21 17:00,112,52,60,0,0,0
2024-03-21 17:15,106,43,63,0,0,0
2024-03-21 17:30,116,48,68,0,0,0
2024-03-21 17:45,114,61,53,0,0,0
2024-03-21 18:00,100,49,51,0,0,0
2024-03-21 18:15,93,44,49,0,0,0
2024-03-21 18:30,98,47,51,0,0,0
2024-03-21 18:45,76,38,38,0,0,0
2024-03-21 19:00,76,30,46,0,0,0
2024-03-21 19:15,81,34,47,0,0,0
2024-03-21 19:30,61,30,31,0,0,0
2024-03-21 19:45,64,34,30,0,0,0
2024-03-21 20:00,47,12,35,0,0,0
2024-03-21 20:15,42,12,30,0,0,0
2024-03-21 20:30,35,17,18,0,0,0
2024-03-21 20:45,24,11,13,0,0,0
2024-03-21 21:00,42,19,23,0,0,0
2024-03-21 21:15,25,6,19,0,0,0
2024-03-21 21:30,20,8,12,0,0,0
2024-03-21 21:45,48,27,21,0,0,0
2024-03-21 22:00,51,23,28,0,0,0
2024-03-21 22:15,35,12,23,0,0,0
2024-03-21 22:30,29,16,13,0,0,0
2024-03-21 22:45,26,8,18,0,0,0
2024-03-21 23:00,21,3,18,0,0,0
2024-03-21 23:15,25,11,14,0,0,0
2024-03-21 23:30,16,7,9,0,0,0
2024-03-21 23:45,5,3,2,0,0,0
2024-03-22 00:00,9,2,7,0,0,0
2024-03-22 00:15,6,2,4,0,0,0
2024-03-22 00:30,6,0,6,0,0,0
2024-03-22 00:45,7,1,6,0,0,0
2024-03-22 01:00,2,0,2,0,0,0
2024-03-22 01:15,5,1,4,0,0,0
2024-03-22 01:30,4,0,4,0,0,0
2024-03-22 01:45,7,0,7,0,0,0
2024-03-22 02:00,5,1,4,0,0,0
2024-03-22 02:15,2,0,2,0,0,0
2024-03-22 02:30,4,0,4,0,0,0
2024-03-22 02:45,1,0,1,0,0,0
2024-03-22 03:00,1,0,1,0,0,0
2024-03-22 03:15,0,0,0,0,0,0
2024-03-22 03:30,2,1,1,0,0,0
2024-03-22 03:45,3,0,3,0,0,0
2024-03-22 04:00,2,0,2,0,0,0
2024-03-22 04:15,0,0,0,0,0,0
2024-03-22 04:30,3,2,1,0,0,0
2024-03-22 04:45,1,1,0,0,0,0
2024-03-22 05:00,4,2,2,0,0,0
2024-03-22 05:15,4,4,0,0,0,0
2024-03-22 05:30,7,6,1,0,0,0
2024-03-22 05:45,7,4,3,0,0,0
2024-03-22 06:00,13,9,4,0,0,0
2024-03-22 06:15,20,14,6,0,0,0
2024-03-22 06:30,32,26,6,0,0,0
2024-03-22 06:45,34,21,13,0,0,0
2024-03-22 07:00,51,35,16,0,0,0
2024-03-22 07:15,83,55,28,0,0,0
2024-03-22 07:30,152,111,41,0,0,0
2024-03-22 07:45,126,101,25,0,0,0
2024-03-22 08:00,76,55,21,0,0,0
2024-03-22 08:15,74,49,25,0,0,0
2024-03-22 08:30,79,57,22,0,0,0
2024-03-22 08:45,85,60,25,0,0,0
2024-03-22 09:00,44,27,17,0,0,0
2024-03-22 09:15,68,51,17,0,0,0
2024-03-22 09:30,62,42,20,0,0,0
2024-03-22 09:45,63,42,21,0,0,0
2024-03-22 10:00,56,32,24,0,0,0
2024-03-22 10:15,45,28,17,0,0,0
2024-03-22 10:30,49,32,17,0,0,0
2024-03-22 10:45,53,34,19,0,0,0
2024-03-22 11:00,58,28,30,0,0,0
2024-03-22 11:15,64,31,33,0,0,0
2024-03-22 11:30,65,35,30,0,0,0
2024-03-22 11:45,68,43,25,0,0,0
2024-03-22 12:00,80,42,38,0,0,0
2024-03-22 12:15,85,44,41,0,0,0
2024-03-22 12:30,73,36,37,0,0,0
2024-03-22 12:45,71,40,31,0,0,0
2024-03-22 13:00,132,68,64,0,0,0
2024-03-22 13:15,88,41,47,0,0,0
2024-03-22 13:30,78,34,44,0,0,0
2024-03-22 13:45,87,43,44,0,0,0
2024-03-22 14:00,78,26,52,0,0,0
2024-03-22 14:15,69,24,45,0,0,0
2024-03-22 14:30,67,30,37,0,0,0
2024-03-22 14:45,78,33,45,0,0,0
2024-03-22 15:00,75,31,44,0,0,0
2024-03-22 15:15,67,26,41,0,0,0
2024-03-22 15:30,61,26,35,0,0,0
2024-03-22 15:45,65,36,29,0,0,0
2024-03-22 16:00,66,29,37,0,0,0
2024-03-22 16:15,51,24,27,0,0,0
2024-03-22 16:30,65,23,42,0,0,0
2024-03-22 16:45,76,35,41,0,0,0
2024-03-22 17:00,58,22,36,0,0,0
2024-03-22 17:15,49,28,21,0,0,0
2024-03-22 17:30,48,18,30,0,0,0
2024-03-22 17:45,64,30,34,0,0,0
2024-03-22 18:00,59,25,34,0,0,0
2024-03-22 18:15,52,25,27,0,0,0
2024-03-22 18:30,47,20,27,0,0,0
2024-03-22 18:45,53,27,26,0,0,0
2024-03-22 19:00,37,19,18,0,0,0
2024-03-22 19:15,36,11,25,0,0,0
2024-03-22 19:30,42,25,17,0,0,0
2024-03-22 19:45,29,12,17,0,0,0
2024-03-22 20:00,25,4,21,0,0,0
2024-03-22 20:15,40,22,18,0,0,0
2024-03-22 20:30,23,6,17,0,0,0
2024-03-22 20:45,21,13,8,0,0,0
2024-03-22 21:00,17,10,7,0,0,0
2024-03-22 21:15,23,8,15,0,0,0
2024-03-22 21:30,18,7,11,0,0,0
2024-03-22 21:45,13,7,6,0,0,0
2024-03-22 22:00,12,5,7,0,0,0
2024-03-22 22:15,16,5,11,0,0,0
2024-03-22 22:30,23,6,17,0,0,0
2024-03-22 22:45,18,3,15,0,0,0
2024-03-22 23:00,20,8,12,0,0,0
2024-03-22 23:15,5,3,2,0,0,0
2024-03-22 23:30,18,9,9,0,0,0
2024-03-22 23:45,15,6,9,0,0,0
2024-03-23 00:00,27,12,15,0,0,0
2024-03-23 00:15,11,2,9,0,0,0
2024-03-23 00:30,25,9,16,0,0,0
2024-03-23 00:45,15,7,8,0,0,0
2024-03-23 01:00,15,7,8,0,0,0
2024-03-23 01:15,4,1,3,0,0,0
2024-03-23 01:30,8,4,4,0,0,0
2024-03-23 01:45,8,1,7,0,0,0
2024-03-23 02:00,5,2,3,0,0,0
2024-03-23 02:15,7,4,3,0,0,0
2024-03-23 02:30,3,0,3,0,0,0
2024-03-23 02:45,5,1,4,0,0,0
2024-03-23 03:00,9,3,6,0,0,0
2024-03-23 03:15,4,0,4,0,0,0
2024-03-23 03:30,1,0,1,0,0,0
2024-03-23 03:45,3,1,2,0,0,0
2024-03-23 04:00,4,0,4,0,0,0
2024-03-23 04:15,2,1,1,0,0,0
2024-03-23 04:30,0,0,0,0,0,0
2024-03-23 04:45,3,1,2,0,0,0
2024-03-23 05:00,4,1,3,0,0,0
2024-03-23 05:15,1,1,0,0,0,0
2024-03-23 05:30,3,1,2,0,0,0
2024-03-23 05:45,4,2,2,0,0,0
2024-03-23 06:00,2,1,1,0,0,0
2024-03-23 06:15,5,4,1,0,0,0
2024-03-23 06:30,5,4,1,0,0,0
2024-03-23 06:45,9,7,2,0,0,0
2024-03-23 07:00,18,15,3,0,0,0
2024-03-23 07:15,9,7,2,0,0,0
2024-03-23 07:30,18,13,5,0,0,0
2024-03-23 07:45,17,12,5,0,0,0
2024-03-23 08:00,16,12,4,0,0,0
2024-03-23 08:15,24,12,12,0,0,0
2024-03-23 08:30,29,17,12,0,0,0
2024-03-23 08:45,42,29,13,0,0,0
2024-03-23 09:00,43,30,13,0,0,0
2024-03-23 09:15,40,32,8,0,0,0
2024-03-23 09:30,49,29,20,0,0,0
2024-03-23 09:45,76,54,22,0,0,0
2024-03-23 10:00,53,41,12,0,0,0
2024-03-23 10:15,52,31,21,0,0,0
2024-03-23 10:30,46,30,16,0,0,0
2024-03-23 10:45,51,36,15,0,0,0
2024-03-23 11:00,53,40,13,0,0,0
2024-03-23 11:15,63,43,20,0,0,0
2024-03-23 11:30,47,34,13,0,0,0
2024-03-23 11:45,65,33,32,0,0,0
2024-03-23 12:00,65,41,24,0,0,0
2024-03-23 12:15,60,35,25,0,0,0
2024-03-23 12:30,64,38,26,0,0,0
2024-03-23 12:45,52,29,23,0,0,0
2024-03-23 13:00,41,17,24,0,0,0
2024-03-23 13:15,67,36,31,0,0,0
2024-03-23 13:30,55,32,23,0,0,0
2024-03-23 13:45,77,52,25,0,0,0
2024-03-23 14:00,56,24,32,0,0,0
2024-03-23 14:15,54,19,35,0,0,0
2024-03-23 14:30,60,23,37,0,0,0
2024-03-23 14:45,49,22,27,0,0,0
2024-03-23 15:00,42,18,24,0,0,0
2024-03-23 15:15,46,26,20,0,0,0
2024-03-23 15:30,43,23,20,0,0,0
2024-03-23 15:45,38,14,24,0,0,0
2024-03-23 16:00,29,12,17,0,0,0
2024-03-23 16:15,44,21,23,0,0,0
2024-03-23 16:30,38,16,22,0,0,0
2024-03-23 16:45,35,9,26,0,0,0
2024-03-23 17:00,43,20,23,0,0,0
2024-03-23 17:15,34,13,21,0,0,0
2024-03-23 17:30,32,15,17,0,0,0
2024-03-23 17:45,54,25,29,0,0,0
2024-03-23 18:00,52,28,24,0,0,0
2024-03-23 18:15,42,23,19,0,0,0
2024-03-23 18:30,38,21,17,0,0,0
2024-03-23 18:45,41,23,18,0,0,0
2024-03-23 19:00,41,23,18,0,0,0
2024-03-23 19:15,49,30,19,0,0,0
2024-03-23 19:30,26,12,14,0,0,0
2024-03-23 19:45,31,19,12,0,0,0
2024-03-23 20:00,35,11,24,0,0,0
2024-03-23 20:15,32,18,14,0,0,0
2024-03-23 20:30,30,12,18,0,0,0
2024-03-23 20:45,19,10,9,0,0,0
2024-03-23 21:00,19,8,11,0,0,0
2024-03-23 21:15,10,2,8,0,0,0
2024-03-23 21:30,20,9,11,0,0,0
2024-03-23 21:45,15,5,10,0,0,0
2024-03-23 22:00,12,7,5,0,0,0
2024-03-23 22:15,16,6,10,0,0,0
2024-03-23 22:30,17,5,12,0,0,0
2024-03-23 22:45,20,8,12,0,0,0
2024-03-23 23:00,12,8,4,0,0,0
2024-03-23 23:15,15,6,9,0,0,0
2024-03-23 23:30,21,12,9,0,0,0
2024-03-23 23:45,21,8,13,0,0,0
2024-03-24 00:00,14,8,6,0,0,0
2024-03-24 00:15,17,6,11,0,0,0
2024-03-24 00:30,10,5,5,0,0,0
2024-03-24 00:45,14,8,6,0,0,0
2024-03-24 01:00,11,6,5,0,0,0
2024-03-24 01:15,12,3,9,0,0,0
2024-03-24 01:30,4,0,4,0,0,0
2024-03-24 01:45,3,2,1,0,0,0
2024-03-24 02:00,10,2,8,0,0,0
2024-03-24 02:15,9,2,7,0,0,0
2024-03-24 02:30,8,2,6,0,0,0
2024-03-24 02:45,5,0,5,0,0,0
2024-03-24 03:00,3,1,2,0,0,0
2024-03-24 03:15,9,5,4,0,0,0
2024-03-24 03:30,3,2,1,0,0,0
2024-03-24 03:45,0,0,0,0,0,0
2024-03-24 04:00,1,0,1,0,0,0
2024-03-24 04:15,3,0,3,0,0,0
2024-03-24 04:30,0,0,0,0,0,0
2024-03-24 04:45,0,0,0,0,0,0
2024-03-24 05:00,0,0,0,0,0,0
2024-03-24 05:15,2,1,1,0,0,0
2024-03-24 05:30,3,2,1,0,0,0
2024-03-24 05:45,0,0,0,0,0,0
2024-03-24 06:00,2,1,1,0,0,0
2024-03-24 06:15,2,2,0,0,0,0
2024-03-24 06:30,0,0,0,0,0,0
2024-03-24 06:45,3,1,2,0,0,0
2024-03-24 07:00,3,2,1,0,0,0
2024-03-24 07:15,4,2,2,0,0,0
2024-03-24 07:30,3,3,0,0,0,0
2024-03-24 07:45,4,2,2,0,0,0
2024-03-24 08:00,6,3,3,0,0,0
2024-03-24 08:15,7,5,2,0,0,0
2024-03-24 08:30,5,2,3,0,0,0
2024-03-24 08:45,7,5,2,0,0,0
2024-03-24 09:00,10,6,4,0,0,0
2024-03-24 09:15,12,8,4,0,0,0
2024-03-24 09:30,15,10,5,0,0,0
2024-03-24 09:45,20,15,5,0,0,0
2024-03-24 10:00,23,17,6,0,0,0
2024-03-24 10:15,24,15,9,0,0,0
2024-03-24 10:30,31,18,13,0,0,0
2024-03-24 10:45,24,17,7,0,0,0
2024-03-24 11:00,20,8,12,0,0,0
2024-03-24 11:15,21,10,11,0,0,0
2024-03-24 11:30,11,9,2,0,0,0
2024-03-24 11:45,19,11,8,0,0,0
2024-03-24 12:00,22,9,13,0,0,0
2024-03-24 12:15,15,10,5,0,0,0
2024-03-24 12:30,18,12,6,0,0,0
2024-03-24 12:45,21,9,12,0,0,0
2024-03-24 13:00,13,7,6,0,0,0
2024-03-24 13:15,21,10,11,0,0,0
2024-03-24 13:30,21,10,11,0,0,0
2024-03-24 13:45,15,7,8,0,0,0
2024-03-24 14:00,11,5,6,0,0,0
2024-03-24 14:15,14,10,4,0,0,0
2024-03-24 14:30,24,14,10,0,0,0
2024-03-24 14:45,26,14,12,0,0,0
2024-03-24 15:00,30,20,10,0,0,0
2024-03-24 15:15,23,16,7,0,0,0
2024-03-24 15:30,25,14,11,0,0,0
2024-03-24 15:45,28,15,13,0,0,0
2024-03-24 16:00,20,11,9,0,0,0
2024-03-24 16:15,19,8,11,0,0,0
2024-03-24 16:30,19,15,4,0,0,0
2024-03-24 16:45,11,5,6,0,0,0
2024-03-24 17:00,18,6,12,0,0,0
2024-03-24 17:15,15,11,4,0,0,0
2024-03-24 17:30,40,27,13,0,0,0
2024-03-24 17:45,32,16,16,0,0,0
2024-03-24 18:00,21,10,11,0,0,0
2024-03-24 18:15,15,7,8,0,0,0
2024-03-24 18:30,15,8,7,0,0,0
2024-03-24 18:45,20,8,12,0,0,0
2024-03-24 19:00,25,8,17,0,0,0
2024-03-24 19:15,21,9,12,0,0,0
2024-03-24 19:30,13,5,8,0,0,0
2024-03-24 19:45,11,7,4,0,0,0
2024-03-24 20:00,19,11,8,0,0,0
2024-03-24 20:15,13,9,4,0,0,0
2024-03-24 20:30,8,4,4,0,0,0
2024-03-24 20:45,7,3,4,0,0,0
2024-03-24 21:00,20,5,15,0,0,0
2024-03-24 21:15,11,3,8,0,0,0
2024-03-24 21:30,9,2,7,0,0,0
2024-03-24 21:45,16,3,13,0,0,0
2024-03-24 22:00,11,4,7,0,0,0
2024-03-24 22:15,10,4,6,0,0,0
2024-03-24 22:30,9,3,6,0,0,0
2024-03-24 22:45,5,1,4,0,0,0
2024-03-24 23:00,3,0,3,0,0,0
2024-03-24 23:15,8,4,4,0,0,0
2024-03-24 23:30,2,1,1,0,0,0
2024-03-24 23:45,1,0,1,0,0,0
2024-03-25 00:00,2,2,0,0,0,0
2024-03-25 00:15,3,1,2,0,0,0
2024-03-25 00:30,4,1,3,0,0,0
2024-03-25 00:45,0,0,0,0,0,0
2024-03-25 01:00,1,0,1,0,0,0
2024-03-25 01:15,0,0,0,0,0,0
2024-03-25 01:30,0,0,0,0,0,0
2024-03-25 01:45,1,0,1,0,0,0
2024-03-25 02:00,2,1,1,0,0,0
2024-03-25 02:15,1,1,0,0,0,0
2024-03-25 02:30,1,0,1,0,0,0
2024-03-25 02:45,0,0,0,0,0,0
2024-03-25 03:00,0,0,0,0,0,0
2024-03-25 03:15,0,0,0,0,0,0
2024-03-25 03:30,1,0,1,0,0,0
2024-03-25 03:45,1,0,1,0,0,0
2024-03-25 04:00,0,0,0,0,0,0
2024-03-25 04:15,0,0,0,0,0,0
2024-03-25 04:30,2,1,1,0,0,0
2024-03-25 04:45,1,1,0,0,0,0
2024-03-25 05:00,1,0,1,0,0,0
2024-03-25 05:15,5,1,4,0,0,0
2024-03-25 05:30,8,6,2,0,0,0
2024-03-25 05:45,7,3,4,0,0,0
2024-03-25 06:00,15,10,5,0,0,0
2024-03-25 06:15,12,11,1,0,0,0
2024-03-25 06:30,38,28,10,0,0,0
2024-03-25 06:45,22,13,9,0,0,0
2024-03-25 07:00,41,25,16,0,0,0
2024-03-25 07:15,51,35,16,0,0,0
2024-03-25 07:30,77,57,20,0,0,0
2024-03-25 07:45,77,51,26,0,0,0
2024-03-25 08:00,70,51,19,0,0,0
2024-03-25 08:15,60,47,13,0,0,0
2024-03-25 08:30,78,60,18,0,0,0
2024-03-25 08:45,80,60,20,0,0,0
2024-03-25 09:00,53,38,15,0,0,0
2024-03-25 09:15,50,33,17,0,0,0
2024-03-25 09:30,41,25,16,0,0,0
2024-03-25 09:45,70,51,19,0,0,0
2024-03-25 10:00,50,34,16,0,0,0
2024-03-25 10:15,40,30,10,0,0,0
2024-03-25 10:30,38,26,12,0,0,0
2024-03-25 10:45,51,32,19,0,0,0
2024-03-25 11:00,47,30,17,0,0,0
2024-03-25 11:15,45,30,15,0,0,0
2024-03-25 11:30,53,26,27,0,0,0
2024-03-25 11:45,43,21,22,0,0,0
2024-03-25 12:00,54,28,26,0,0,0
2024-03-25 12:15,49,29,20,0,0,0
2024-03-25 12:30,56,29,27,0,0,0
2024-03-25 12:45,59,33,26,0,0,0
2024-03-25 13:00,67,35,32,0,0,0
2024-03-25 13:15,60,27,33,0,0,0
2024-03-25 13:30,55,29,26,0,0,0
2024-03-25 13:45,70,37,33,0,0,0
2024-03-25 14:00,57,27,30,0,0,0
2024-03-25 14:15,48,24,24,0,0,0
2024-03-25 14:30,76,45,31,0,0,0
2024-03-25 14:45,64,32,32,0,0,0
2024-03-25 15:00,79,36,43,0,0,0
2024-03-25 15:15,76,38,38,0,0,0
2024-03-25 15:30,92,39,53,0,0,0
2024-03-25 15:45,75,37,38,0,0,0
2024-03-25 16:00,95,38,57,0,0,0
2024-03-25 16:15,101,42,59,0,0,0
2024-03-25 16:30,82,28,54,0,0,0
2024-03-25 16:45,101,51,50,0,0,0
2024-03-25 17:00,86,31,55,0,0,0
2024-03-25 17:15,74,31,43,0,0,0
2024-03-25 17:30,90,42,48,0,0,0
2024-03-25 17:45,92,32,60,0,0,0
2024-03-25 18:00,111,41,70,0,0,0
2024-03-25 18:15,76,32,44,0,0,0
2024-03-25 18:30,72,31,41,0,0,0
2024-03-25 18:45,66,34,32,0,0,0
2024-03-25 19:00,65,33,32,0,0,0
2024-03-25 19:15,47,25,22,0,0,0
2024-03-25 19:30,57,31,26,0,0,0
2024-03-25 19:45,44,16,28,0,0,0
2024-03-25 20:00,32,7,25,0,0,0
2024-03-25 20:15,27,12,15,0,0,0
2024-03-25 20:30,20,10,10,0,0,0
2024-03-25 20:45,24,8,16,0,0,0
2024-03-25 21:00,20,9,11,0,0,0
2024-03-25 21:15,25,15,10,0,0,0
2024-03-25 21:30,27,13,14,0,0,0
2024-03-25 21:45,21,5,16,0,0,0
2024-03-25 22:00,8,3,5,0,0,0
2024-03-25 22:15,21,11,10,0,0,0
2024-03-25 22:30,21,7,14,0,0,0
2024-03-25 22:45,14,4,10,0,0,0
2024-03-25 23:00,7,5,2,0,0,0
2024-03-25 23:15,11,2,9,0,0,0
2024-03-25 23:30,12,8,4,0,0,0
2024-03-25 23:45,9,1,8,0,0,0
2024-03-26 00:00,9,4,5,0,0,0
2024-03-26 00:15,7,0,7,0,0,0
2024-03-26 00:30,1,0,1,0,0,0
2024-03-26 00:45,3,0,3,0,0,0
2024-03-26 01:00,5,3,2,0,0,0
2024-03-26 01:15,3,1,2,0,0,0
2024-03-26 01:30,0,0,0,0,0,0
2024-03-26 01:45,0,0,0,0,0,0
2024-03-26 02:00,1,1,0,0,0,0
2024-03-26 02:15,0,0,0,0,0,0
2024-03-26 02:30,1,1,0,0,0,0
2024-03-26 02:45,1,0,1,0,0,0
2024-03-26 03:00,0,0,0,0,0,0
2024-03-26 03:15,1,0,1,0,0,0
2024-03-26 03:30,0,0,0,0,0,0
2024-03-26 03:45,0,0,0,0,0,0
2024-03-26 04:00,0,0,0,0,0,0
2024-03-26 04:15,1,0,1,0,0,0
2024-03-26 04:30,0,0,0,0,0,0
2024-03-26 04:45,2,2,0,0,0,0
2024-03-26 05:00,1,1,0,0,0,0
2024-03-26 05:15,10,5,5,0,0,0
2024-03-26 05:30,9,7,2,0,0,0
2024-03-26 05:45,10,5,5,0,0,0
2024-03-26 06:00,21,14,7,0,0,0
2024-03-26 06:15,21,15,6,0,0,0
2024-03-26 06:30,36,23,13,0,0,0
2024-03-26 06:45,20,14,6,0,0,0
2024-03-26 07:00,32,21,11,0,0,0
2024-03-26 07:15,64,44,20,0,0,0
2024-03-26 07:30,77,55,22,0,0,0
2024-03-26 07:45,91,64,27,0,0,0
2024-03-26 08:00,88,60,28,0,0,0
2024-03-26 08:15,78,62,16,0,0,0
2024-03-26 08:30,74,53,21,0,0,0
2024-03-26 08:45,77,48,29,0,0,0
2024-03-26 09:00,53,42,11,0,0,0
2024-03-26 09:15,52,36,16,0,0,0
2024-03-26 09:30,54,35,19,0,0,0
2024-03-26 09:45,71,53,18,0,0,0
2024-03-26 10:00,56,28,28,0,0,0
2024-03-26 10:15,48,34,14,0,0,0
2024-03-26 10:30,56,37,19,0,0,0
2024-03-26 10:45,37,27,10,0,0,0
2024-03-26 11:00,48,30,18,0,0,0
2024-03-26 11:15,53,33,20,0,0,0
2024-03-26 11:30,43,34,9,0,0,0
2024-03-26 11:45,53,33,20,0,0,0
2024-03-26 12:00,45,26,19,0,0,0
2024-03-26 12:15,71,39,32,0,0,0
2024-03-26 12:30,56,34,22,0,0,0
2024-03-26 12:45,65,34,31,0,0,0
2024-03-26 13:00,57,29,28,0,0,0
2024-03-26 13:15,49,20,29,0,0,0
2024-03-26 13:30,41,19,22,0,0,0
2024-03-26 13:45,66,26,40,0,0,0
2024-03-26 14:00,58,20,38,0,0,0
2024-03-26 14:15,76,41,35,0,0,0
2024-03-26 14:30,61,29,32,0,0,0
2024-03-26 14:45,74,38,36,0,0,0
2024-03-26 15:00,67,27,40,0,0,0
2024-03-26 15:15,81,38,43,0,0,0
2024-03-26 15:30,83,49,34,0,0,0
2024-03-26 15:45,86,33,53,0,0,0
2024-03-26 16:00,91,42,49,0,0,0
2024-03-26 16:15,99,35,64,0,0,0
2024-03-26 16:30,99,40,59,0,0,0
2024-03-26 16:45,98,47,51,0,0,0
2024-03-26 17:00,98,41,57,0,0,0
2024-03-26 17:15,82,32,50,0,0,0
2024-03-26 17:30,103,51,52,0,0,0
2024-03-26 17:45,93,41,52,0,0,0
2024-03-26 18:00,96,41,55,0,0,0
2024-03-26 18:15,92,40,52,0,0,0
2024-03-26 18:30,64,32,32,0,0,0
2024-03-26 18:45,79,38,41,0,0,0
2024-03-26 19:00,59,22,37,0,0,0
2024-03-26 19:15,76,29,47,0,0,0
2024-03-26 19:30,51,20,31,0,0,0
2024-03-26 19:45,41,15,26,0,0,0
2024-03-26 20:00,49,21,28,0,0,0
2024-03-26 20:15,39,12,27,0,0,0
2024-03-26 20:30,34,16,18,0,0,0
2024-03-26 20:45,20,9,11,0,0,0
2024-03-26 21:00,21,8,13,0,0,0
2024-03-26 21:15,21,5,16,0,0,0
2024-03-26 21:30,21,6,15,0,0,0
2024-03-26 21:45,23,8,15,0,0,0
2024-03-26 22:00,25,13,12,0,0,0
2024-03-26 22:15,14,3,11,0,0,0
2024-03-26 22:30,15,4,11,0,0,0
2024-03-26 22:45,25,13,12,0,0,0
2024-03-26 23:00,21,7,14,0,0,0
2024-03-26 23:15,15,8,7,0,0,0
2024-03-26 23:30,12,4,8,0,0,0
2024-03-26 23:45,9,5,4,0,0,0
2024-03-27 00:00,4,0,4,0,0,0
2024-03-27 00:15,6,2,4,0,0,0
2024-03-27 00:30,1,1,0,0,0,0
2024-03-27 00:45,5,2,3,0,0,0
2024-03-27 01:00,3,2,1,0,0,0
2024-03-27 01:15,4,1,3,0,0,0
2024-03-27 01:30,0,0,0,0,0,0
2024-03-27 01:45,1,0,1,0,0,0
2024-03-27 02:00,0,0,0,0,0,0
2024-03-27 02:15,0,0,0,0,0,0
2024-03-27 02:30,3,1,2,0,0,0
2024-03-27 02:45,1,0,1,0,0,0
2024-03-27 03:00,0,0,0,0,0,0
2024-03-27 03:15,0,0,0,0,0,0
2024-03-27 03:30,0,0,0,0,0,0
2024-03-27 03:45,0,0,0,0,0,0
2024-03-27 04:00,0,0,0,0,0,0
2024-03-27 04:15,2,1,1,0,0,0
2024-03-27 04:30,1,1,0,0,0,0
2024-03-27 04:45,2,1,1,0,0,0
2024-03-27 05:00,2,0,2,0,0,0
2024-03-27 05:15,3,0,3,0,0,0
2024-03-27 05:30,6,4,2,0,0,0
2024-03-27 05:45,8,5,3,0,0,0
2024-03-27 06:00,15,12,3,0,0,0
2024-03-27 06:15,25,21,4,0,0,0
2024-03-27 06:30,32,20,12,0,0,0
2024-03-27 06:45,33,25,8,0,0,0
2024-03-27 07:00,54,34,20,0,0,0
2024-03-27 07:15,56,40,16,0,0,0
2024-03-27 07:30,80,59,21,0,0,0
2024-03-27 07:45,106,86,20,0,0,0
2024-03-27 08:00,81,51,30,0,0,0
2024-03-27 08:15,80,55,25,0,0,0
2024-03-27 08:30,64,46,18,0,0,0
2024-03-27 08:45,81,61,20,0,0,0
2024-03-27 09:00,60,45,15,0,0,0
2024-03-27 09:15,54,37,17,0,0,0
2024-03-27 09:30,60,45,15,0,0,0
2024-03-27 09:45,76,55,21,0,0,0
2024-03-27 10:00,51,40,11,0,0,0
2024-03-27 10:15,62,35,27,0,0,0
2024-03-27 10:30,49,35,14,0,0,0
2024-03-27 10:45,65,44,21,0,0,0
2024-03-27 11:00,60,38,22,0,0,0
2024-03-27 11:15,72,44,28,0,0,0
2024-03-27 11:30,71,42,29,0,0,0
2024-03-27 11:45,66,40,26,0,0,0
2024-03-27 12:00,55,30,25,0,0,0
2024-03-27 12:15,76,40,36,0,0,0
2024-03-27 12:30,63,36,27,0,0,0
2024-03-27 12:45,76,38,38,0,0,0
2024-03-27 13:00,78,43,35,0,0,0
2024-03-27 13:15,67,39,28,0,0,0
2024-03-27 13:30,67,36,31,0,0,0
2024-03-27 13:45,71,39,32,0,0,0
2024-03-27 14:00,70,41,29,0,0,0
2024-03-27 14:15,72,33,39,0,0,0
2024-03-27 14:30,89,36,53,0,0,0
2024-03-27 14:45,58,28,30,0,0,0
2024-03-27 15:00,66,27,39,0,0,0
2024-03-27 15:15,70,37,33,0,0,0
2024-03-27 15:30,79,38,41,0,0,0
2024-03-27 15:45,85,34,51,0,0,0
2024-03-27 16:00,93,39,54,0,0,0
2024-03-27 16:15,92,44,48,0,0,0
2024-03-27 16:30,79,38,41,0,0,0
2024-03-27 16:45,100,46,54,0,0,0
2024-03-27 17:00,81,37,44,0,0,0
2024-03-27 17:15,106,43,63,0,0,0
2024-03-27 17:30,79,35,44,0,0,0
2024-03-27 17:45,72,31,41,0,0,0
2024-03-27 18:00,66,23,43,0,0,0
2024-03-27 18:15,75,31,44,0,0,0
2024-03-27 18:30,70,27,43,0,0,0
2024-03-27 18:45,54,20,34,0,0,0
2024-03-27 19:00,51,26,25,0,0,0
2024-03-27 19:15,57,25,32,0,0,0
2024-03-27 19:30,49,25,24,0,0,0
2024-03-27 19:45,43,26,17,0,0,0
2024-03-27 20:00,35,18,17,0,0,0
2024-03-27 20:15,46,16,30,0,0,0
2024-03-27 20:30,23,10,13,0,0,0
2024-03-27 20:45,18,8,10,0,0,0
2024-03-27 21:00,36,9,27,0,0,0
2024-03-27 21:15,18,8,10,0,0,0
2024-03-27 21:30,27,9,18,0,0,0
2024-03-27 21:45,24,8,16,0,0,0
2024-03-27 22:00,18,7,11,0,0,0
2024-03-27 22:15,23,11,12,0,0,0
2024-03-27 22:30,31,12,19,0,0,0
2024-03-27 22:45,28,9,19,0,0,0
2024-03-27 23:00,18,10,8,0,0,0
2024-03-27 23:15,9,4,5,0,0,0
2024-03-27 23:30,4,4,0,0,0,0
2024-03-27 23:45,8,5,3,0,0,0
2024-03-28 00:00,11,5,6,0,0,0
2024-03-28 00:15,11,5,6,0,0,0
2024-03-28 00:30,3,1,2,0,0,0
2024-03-28 00:45,9,0,9,0,0,0
2024-03-28 01:00,5,3,2,0,0,0
2024-03-28 01:15,7,4,3,0,0,0
2024-03-28 01:30,9,0,9,0,0,0
2024-03-28 01:45,4,1,3,0,0,0
2024-03-28 02:00,1,0,1,0,0,0
2024-03-28 02:15,1,0,1,0,0,0
2024-03-28 02:30,5,1,4,0,0,0
2024-03-28 02:45,4,0,4,0,0,0
2024-03-28 03:00,1,0,1,0,0,0
2024-03-28 03:15,4,1,3,0,0,0
2024-03-28 03:30,4,0,4,0,0,0
2024-03-28 03:45,3,0,3,0,0,0
2024-03-28 04:00,1,0,1,0,0,0
2024-03-28 04:15,2,0,2,0,0,0
2024-03-28 04:30,1,1,0,0,0,0
2024-03-28 04:45,3,2,1,0,0,0
2024-03-28 05:00,2,2,0,0,0,0
2024-03-28 05:15,3,1,2,0,0,0
2024-03-28 05:30,9,5,4,0,0,0
2024-03-28 05:45,9,3,6,0,0,0
2024-03-28 06:00,14,10,4,0,0,0
2024-03-28 06:15,16,14,2,0,0,0
2024-03-28 06:30,30,20,10,0,0,0
2024-03-28 06:45,24,15,9,0,0,0
2024-03-28 07:00,36,21,15,0,0,0
2024-03-28 07:15,45,32,13,0,0,0
2024-03-28 07:30,62,47,15,0,0,0
2024-03-28 07:45,98,68,30,0,0,0
2024-03-28 08:00,66,47,19,0,0,0
2024-03-28 08:15,63,42,21,0,0,0
2024-03-28 08:30,64,52,12,0,0,0
2024-03-28 08:45,67,47,20,0,0,0
2024-03-28 09:00,59,39,20,0,0,0
2024-03-28 09:15,57,40,17,0,0,0
2024-03-28 09:30,48,27,21,0,0,0
2024-03-28 09:45,76,50,26,0,0,0
2024-03-28 10:00,50,30,20,0,0,0
2024-03-28 10:15,44,33,11,0,0,0
2024-03-28 10:30,45,24,21,0,0,0
2024-03-28 10:45,57,31,26,0,0,0
2024-03-28 11:00,30,13,17,0,0,0
2024-03-28 11:15,39,19,20,0,0,0
2024-03-28 11:30,37,15,22,0,0,0
2024-03-28 11:45,37,25,12,0,0,0
2024-03-28 12:00,40,19,21,0,0,0
2024-03-28 12:15,29,9,20,0,0,0
2024-03-28 12:30,44,26,18,0,0,0
2024-03-28 12:45,41,21,20,0,0,0
2024-03-28 13:00,53,24,29,0,0,0
2024-03-28 13:15,47,20,27,0,0,0
2024-03-28 13:30,36,15,21,0,0,0
2024-03-28 13:45,40,24,16,0,0,0
2024-03-28 14:00,54,18,36,0,0,0
2024-03-28 14:15,76,34,42,0,0,0
2024-03-28 14:30,65,35,30,0,0,0
2024-03-28 14:45,83,40,43,0,0,0
2024-03-28 15:00,64,19,45,0,0,0
2024-03-28 15:15,82,54,28,0,0,0
2024-03-28 15:30,78,42,36,0,0,0
2024-03-28 15:45,67,30,37,0,0,0
2024-03-28 16:00,55,21,34,0,0,0
2024-03-28 16:15,95,48,47,0,0,0
2024-03-28 16:30,86,42,44,0,0,0
2024-03-28 16:45,62,28,34,0,0,0
2024-03-28 17:00,92,45,47,0,0,0
2024-03-28 17:15,92,42,50,0,0,0
2024-03-28 17:30,75,29,46,0,0,0
2024-03-28 17:45,80,40,40,0,0,0
2024-03-28 18:00,55,29,26,0,0,0
2024-03-28 18:15,52,20,32,0,0,0
2024-03-28 18:30,70,32,38,0,0,0
2024-03-28 18:45,49,27,22,0,0,0
2024-03-28 19:00,62,34,28,0,0,0
2024-03-28 19:15,41,15,26,0,0,0
2024-03-28 19:30,34,18,16,0,0,0
2024-03-28 19:45,43,19,24,0,0,0
2024-03-28 20:00,32,13,19,0,0,0
2024-03-28 20:15,33,16,17,0,0,0
2024-03-28 20:30,29,13,16,0,0,0
2024-03-28 20:45,24,11,13,0,0,0
2024-03-28 21:00,19,7,12,0,0,0
2024-03-28 21:15,13,3,10,0,0,0
2024-03-28 21:30,14,8,6,0,0,0
2024-03-28 21:45,27,14,13,0,0,0
2024-03-28 22:00,23,6,17,0,0,0
2024-03-28 22:15,15,7,8,0,0,0
2024-03-28 22:30,18,8,10,0,0,0
2024-03-28 22:45,13,6,7,0,0,0
2024-03-28 23:00,9,3,6,0,0,0
2024-03-28 23:15,15,4,11,0,0,0
2024-03-28 23:30,17,6,11,0,0,0
2024-03-28 23:45,14,4,10,0,0,0
2024-03-29 00:00,13,1,12,0,0,0
2024-03-29 00:15,6,2,4,0,0,0
2024-03-29 00:30,8,2,6,0,0,0
2024-03-29 00:45,11,4,7,0,0,0
2024-03-29 01:00,12,4,8,0,0,0
2024-03-29 01:15,5,3,2,0,0,0
2024-03-29 01:30,6,2,4,0,0,0
2024-03-29 01:45,9,3,6,0,0,0
2024-03-29 02:00,6,0,6,0,0,0
2024-03-29 02:15,7,1,6,0,0,0
2024-03-29 02:30,3,1,2,0,0,0
2024-03-29 02:45,0,0,0,0,0,0
2024-03-29 03:00,0,0,0,0,0,0
2024-03-29 03:15,2,0,2,0,0,0
2024-03-29 03:30,1,0,1,0,0,0
2024-03-29 03:45,3,1,2,0,0,0
2024-03-29 04:00,4,2,2,0,0,0
2024-03-29 04:15,1,1,0,0,0,0
2024-03-29 04:30,0,0,0,0,0,0
2024-03-29 04:45,5,1,4,0,0,0
2024-03-29 05:00,0,0,0,0,0,0
2024-03-29 05:15,2,2,0,0,0,0
2024-03-29 05:30,6,5,1,0,0,0
2024-03-29 05:45,1,1,0,0,0,0
2024-03-29 06:00,2,2,0,0,0,0
2024-03-29 06:15,2,2,0,0,0,0
2024-03-29 06:30,3,1,2,0,0,0
2024-03-29 06:45,4,3,1,0,0,0
2024-03-29 07:00,2,0,2,0,0,0
2024-03-29 07:15,2,2,0,0,0,0
2024-03-29 07:30,0,0,0,0,0,0
2024-03-29 07:45,3,1,2,0,0,0
2024-03-29 08:00,5,4,1,0,0,0
2024-03-29 08:15,7,4,3,0,0,0
2024-03-29 08:30,13,9,4,0,0,0
2024-03-29 08:45,11,3,8,0,0,0
2024-03-29 09:00,1,0,1,0,0,0
2024-03-29 09:15,11,3,8,0,0,0
2024-03-29 09:30,11,8,3,0,0,0
2024-03-29 09:45,12,8,4,0,0,0
2024-03-29 10:00,12,7,5,0,0,0
2024-03-29 10:15,12,6,6,0,0,0
2024-03-29 10:30,25,17,8,0,0,0
2024-03-29 10:45,28,9,19,0,0,0
2024-03-29 11:00,18,8,10,0,0,0
2024-03-29 11:15,17,11,6,0,0,0
2024-03-29 11:30,20,16,4,0,0,0
2024-03-29 11:45,25,14,11,0,0,0
2024-03-29 12:00,18,12,6,0,0,0
2024-03-29 12:15,23,15,8,0,0,0
2024-03-29 12:30,24,13,11,0,0,0
2024-03-29 12:45,18,9,9,0,0,0
2024-03-29 13:00,17,7,10,0,0,0
2024-03-29 13:15,19,14,5,0,0,0
2024-03-29 13:30,36,22,14,0,0,0
2024-03-29 13:45,27,21,6,0,0,0
2024-03-29 14:00,23,17,6,0,0,0
2024-03-29 14:15,34,22,12,0,0,0
2024-03-29 14:30,30,16,14,0,0,0
2024-03-29 14:45,38,25,13,0,0,0
2024-03-29 15:00,43,26,17,0,0,0
2024-03-29 15:15,35,19,16,0,0,0
2024-03-29 15:30,41,22,19,0,0,0
2024-03-29 15:45,35,21,14,0,0,0
2024-03-29 16:00,25,15,10,0,0,0
2024-03-29 16:15,38,16,22,0,0,0
2024-03-29 16:30,33,15,18,0,0,0
2024-03-29 16:45,32,17,15,0,0,0
2024-03-29 17:00,30,19,11,0,0,0
2024-03-29 17:15,39,18,21,0,0,0
2024-03-29 17:30,27,8,19,0,0,0
2024-03-29 17:45,45,23,22,0,0,0
2024-03-29 18:00,35,11,24,0,0,0
2024-03-29 18:15,23,7,16,0,0,0
2024-03-29 18:30,21,10,11,0,0,0
2024-03-29 18:45,23,15,8,0,0,0
2024-03-29 19:00,18,9,9,0,0,0
2024-03-29 19:15,30,16,14,0,0,0
2024-03-29 19:30,22,10,12,0,0,0
2024-03-29 19:45,23,11,12,0,0,0
2024-03-29 20:00,19,10,9,0,0,0
2024-03-29 20:15,22,7,15,0,0,0
2024-03-29 20:30,10,7,3,0,0,0
2024-03-29 20:45,21,12,9,0,0,0
2024-03-29 21:00,19,12,7,0,0,0
2024-03-29 21:15,9,4,5,0,0,0
2024-03-29 21:30,10,7,3,0,0,0
2024-03-29 21:45,12,7,5,0,0,0
2024-03-29 22:00,5,4,1,0,0,0
2024-03-29 22:15,11,2,9,0,0,0
2024-03-29 22:30,5,3,2,0,0,0
2024-03-29 22:45,23,11,12,0,0,0
2024-03-29 23:00,13,3,10,0,0,0
2024-03-29 23:15,10,4,6,0,0,0
2024-03-29 23:30,11,7,4,0,0,0
2024-03-29 23:45,14,11,3,0,0,0
2024-03-30 00:00,11,4,7,0,0,0
2024-03-30 00:15,6,5,1,0,0,0
2024-03-30 00:30,1,0,1,0,0,0
2024-03-30 00:45,4,1,3,0,0,0
2024-03-30 01:00,3,1,2,0,0,0
2024-03-30 01:15,6,0,6,0,0,0
2024-03-30 01:30,5,2,3,0,0,0
2024-03-30 01:45,0,0,0,0,0,0
2024-03-30 02:00,3,1,2,0,0,0
2024-03-30 02:15,5,2,3,0,0,0
2024-03-30 02:30,2,1,1,0,0,0
2024-03-30 02:45,0,0,0,0,0,0
2024-03-30 03:00,1,0,1,0,0,0
2024-03-30 03:15,3,1,2,0,0,0
2024-03-30 03:30,1,0,1,0,0,0
2024-03-30 03:45,1,1,0,0,0,0
2024-03-30 04:00,2,1,1,0,0,0
2024-03-30 04:15,1,1,0,0,0,0
2024-03-30 04:30,1,0,1,0,0,0
2024-03-30 04:45,1,1,0,0,0,0
2024-03-30 05:00,0,0,0,0,0,0
2024-03-30 05:15,1,1,0,0,0,0
2024-03-30 05:30,5,3,2,0,0,0
2024-03-30 05:45,6,4,2,0,0,0
2024-03-30 06:00,3,2,1,0,0,0
2024-03-30 06:15,10,9,1,0,0,0
2024-03-30 06:30,10,5,5,0,0,0
2024-03-30 06:45,13,12,1,0,0,0
2024-03-30 07:00,9,8,1,0,0,0
2024-03-30 07:15,18,14,4,0,0,0
2024-03-30 07:30,17,10,7,0,0,0
2024-03-30 07:45,26,14,12,0,0,0
2024-03-30 08:00,22,13,9,0,0,0
2024-03-30 08:15,24,14,10,0,0,0
2024-03-30 08:30,25,14,11,0,0,0
2024-03-30 08:45,31,22,9,0,0,0
2024-03-30 09:00,39,29,10,0,0,0
2024-03-30 09:15,51,32,19,0,0,0
2024-03-30 09:30,54,43,11,0,0,0
2024-03-30 09:45,69,53,16,0,0,0
2024-03-30 10:00,57,41,16,0,0,0
2024-03-30 10:15,79,54,25,0,0,0
2024-03-30 10:30,69,50,19,0,0,0
2024-03-30 10:45,77,47,30,0,0,0
2024-03-30 11:00,66,43,23,0,0,0
2024-03-30 11:15,65,42,23,0,0,0
2024-03-30 11:30,70,43,27,0,0,0
2024-03-30 11:45,88,53,35,0,0,0
2024-03-30 12:00,69,39,30,0,0,0
2024-03-30 12:15,90,53,37,0,0,0
2024-03-30 12:30,78,43,35,0,0,0
2024-03-30 12:45,84,54,30,0,0,0
2024-03-30 13:00,81,50,31,0,0,0
2024-03-30 13:15,71,35,36,0,0,0
2024-03-30 13:30,72,30,42,0,0,0
2024-03-30 13:45,63,36,27,0,0,0
2024-03-30 14:00,63,39,24,0,0,0
2024-03-30 14:15,67,31,36,0,0,0
2024-03-30 14:30,62,20,42,0,0,0
2024-03-30 14:45,69,27,42,0,0,0
2024-03-30 15:00,54,27,27,0,0,0
2024-03-30 15:15,51,29,22,0,0,0
2024-03-30 15:30,49,13,36,0,0,0
2024-03-30 15:45,52,22,30,0,0,0
2024-03-30 16:00,53,24,29,0,0,0
2024-03-30 16:15,45,22,23,0,0,0
2024-03-30 16:30,46,19,27,0,0,0
2024-03-30 16:45,46,16,30,0,0,0
2024-03-30 17:00,46,17,29,0,0,0
2024-03-30 17:15,39,21,18,0,0,0
2024-03-30 17:30,40,22,18,0,0,0
2024-03-30 17:45,52,29,23,0,0,0
2024-03-30 18:00,45,18,27,0,0,0
2024-03-30 18:15,39,21,18,0,0,0
2024-03-30 18:30,41,19,22,0,0,0
2024-03-30 18:45,29,20,9,0,0,0
2024-03-30 19:00,31,15,16,0,0,0
2024-03-30 19:15,26,9,17,0,0,0
2024-03-30 19:30,25,16,9,0,0,0
2024-03-30 19:45,26,20,6,0,0,0
2024-03-30 20:00,21,12,9,0,0,0
2024-03-30 20:15,19,9,10,0,0,0
2024-03-30 20:30,20,10,10,0,0,0
2024-03-30 20:45,29,16,13,0,0,0
2024-03-30 21:00,19,9,10,0,0,0
2024-03-30 21:15,13,6,7,0,0,0
2024-03-30 21:30,11,6,5,0,0,0
2024-03-30 21:45,11,6,5,0,0,0
2024-03-30 22:00,13,5,8,0,0,0
2024-03-30 22:15,9,1,8,0,0,0
2024-03-30 22:30,26,5,21,0,0,0
2024-03-30 22:45,11,4,7,0,0,0
2024-03-30 23:00,18,6,12,0,0,0
2024-03-30 23:15,16,4,12,0,0,0
2024-03-30 23:30,4,1,3,0,0,0
2024-03-30 23:45,15,8,7,0,0,0
2024-03-31 00:00,12,3,9,0,0,0
2024-03-31 00:15,10,1,9,0,0,0
2024-03-31 00:30,11,4,7,0,0,0
2024-03-31 00:45,9,2,7,0,0,0
2024-03-31 01:00,8,3,5,0,0,0
2024-03-31 01:15,2,0,2,0,0,0
2024-03-31 01:30,8,0,8,0,0,0
2024-03-31 01:45,5,1,4,0,0,0
2024-03-31 03:00,2,0,2,0,0,0
2024-03-31 03:15,0,0,0,0,0,0
2024-03-31 03:30,3,0,3,0,0,0
2024-03-31 03:45,5,1,4,0,0,0
2024-03-31 04:00,5,3,2,0,0,0
2024-03-31 04:15,3,0,3,0,0,0
2024-03-31 04:30,1,1,0,0,0,0
2024-03-31 04:45,5,5,0,0,0,0
2024-03-31 05:00,2,1,1,0,0,0
2024-03-31 05:15,2,1,1,0,0,0
2024-03-31 05:30,5,4,1,0,0,0
2024-03-31 05:45,5,2,3,0,0,0
2024-03-31 06:00,6,2,4,0,0,0
2024-03-31 06:15,2,2,0,0,0,0
2024-03-31 06:30,0,0,0,0,0,0
2024-03-31 06:45,8,5,3,0,0,0
2024-03-31 07:00,7,1,6,0,0,0
2024-03-31 07:15,4,1,3,0,0,0
2024-03-31 07:30,3,1,2,0,0,0
2024-03-31 07:45,2,1,1,0,0,0
2024-03-31 08:00,3,2,1,0,0,0
2024-03-31 08:15,5,4,1,0,0,0
2024-03-31 08:30,8,7,1,0,0,0
2024-03-31 08:45,13,10,3,0,0,0
2024-03-31 09:00,11,7,4,0,0,0
2024-03-31 09:15,10,2,8,0,0,0
2024-03-31 09:30,12,9,3,0,0,0
2024-03-31 09:45,12,10,2,0,0,0
2024-03-31 10:00,11,7,4,0,0,0
2024-03-31 10:15,18,13,5,0,0,0
2024-03-31 10:30,12,9,3,0,0,0
2024-03-31 10:45,18,11,7,0,0,0
2024-03-31 11:00,19,8,11,0,0,0
2024-03-31 11:15,17,11,6,0,0,0
2024-03-31 11:30,8,5,3,0,0,0
2024-03-31 11:45,29,16,13,0,0,0
2024-03-31 12:00,19,6,13,0,0,0
2024-03-31 12:15,38,19,19,0,0,0
2024-03-31 12:30,22,9,13,0,0,0
2024-03-31 12:45,33,22,11,0,0,0
2024-03-31 13:00,29,17,12,0,0,0
2024-03-31 13:15,40,21,19,0,0,0
2024-03-31 13:30,33,16,17,0,0,0
2024-03-31 13:45,36,19,17,0,0,0
2024-03-31 14:00,51,24,27,0,0,0
2024-03-31 14:15,37,15,22,0,0,0
2024-03-31 14:30,27,12,15,0,0,0
2024-03-31 14:45,28,15,13,0,0,0
2024-03-31 15:00,38,29,9,0,0,0
2024-03-31 15:15,45,30,15,0,0,0
2024-03-31 15:30,35,11,24,0,0,0
2024-03-31 15:45,49,26,23,0,0,0
2024-03-31 16:00,37,18,19,0,0,0
2024-03-31 16:15,26,12,14,0,0,0
2024-03-31 16:30,22,18,4,0,0,0
2024-03-31 16:45,33,13,20,0,0,0
2024-03-31 17:00,29,16,13,0,0,0
2024-03-31 17:15,31,15,16,0,0,0
2024-03-31 17:30,35,15,20,0,0,0
2024-03-31 17:45,39,20,19,0,0,0
2024-03-31 18:00,22,9,13,0,0,0
2024-03-31 18:15,37,18,19,0,0,0
2024-03-31 18:30,22,12,10,0,0,0
2024-03-31 18:45,35,18,17,0,0,0
2024-03-31 19:00,27,16,11,0,0,0
2024-03-31 19:15,23,13,10,0,0,0
2024-03-31 19:30,21,11,10,0,0,0
2024-03-31 19:45,20,11,9,0,0,0
2024-03-31 20:00,25,17,8,0,0,0
2024-03-31 20:15,13,6,7,0,0,0
2024-03-31 20:30,11,1,10,0,0,0
2024-03-31 20:45,5,2,3,0,0,0
2024-03-31 21:00,8,1,7,0,0,0
2024-03-31 21:15,9,2,7,0,0,0
2024-03-31 21:30,14,10,4,0,0,0
2024-03-31 21:45,7,2,5,0,0,0
2024-03-31 22:00,8,5,3,0,0,0
2024-03-31 22:15,5,3,2,0,0,0
2024-03-31 22:30,16,9,7,0,0,0
2024-03-31 22:45,16,5,11,0,0,0
2024-03-31 23:00,5,4,1,0,0,0
2024-03-31 23:15,5,2,3,0,0,0
2024-03-31 23:30,9,3,6,0,0,0
2024-03-31 23:45,13,6,7,0,0,0
