Datetime,300037920 (Lütkenbecker Str.),353413813 (Lütkenbecker Str. [Bike Stadteinwärts]),353413814 (Lütkenbecker Str. [Bike Stadtauswärts]),300037920-status,353413813-status,353413814-status
2024-11-01 00:00,18,2,16,0,0,0
2024-11-01 00:15,9,6,3,0,0,0
2024-11-01 00:30,19,4,15,0,0,0
2024-11-01 00:45,16,7,9,0,0,0
2024-11-01 01:00,20,8,12,0,0,0
2024-11-01 01:15,7,3,4,0,0,0
2024-11-01 01:30,10,2,8,0,0,0
2024-11-01 01:45,9,1,8,0,0,0
2024-11-01 02:00,11,3,8,0,0,0
2024-11-01 02:15,3,2,1,0,0,0
2024-11-01 02:30,4,3,1,0,0,0
2024-11-01 02:45,8,6,2,0,0,0
2024-11-01 03:00,5,1,4,0,0,0
2024-11-01 03:15,3,0,3,0,0,0
2024-11-01 03:30,1,1,0,0,0,0
2024-11-01 03:45,2,2,0,0,0,0
2024-11-01 04:00,4,2,2,0,0,0
2024-11-01 04:15,3,2,1,0,0,0
2024-11-01 04:30,3,0,3,0,0,0
2024-11-01 04:45,1,0,1,0,0,0
2024-11-01 05:00,7,1,6,0,0,0
2024-11-01 05:15,4,2,2,0,0,0
2024-11-01 05:30,4,1,3,0,0,0
2024-11-01 05:45,4,4,0,0,0,0
2024-11-01 06:00,2,1,1,0,0,0
2024-11-01 06:15,6,5,1,0,0,0
2024-11-01 06:30,5,1,4,0,0,0
2024-11-01 06:45,4,0,4,0,0,0
2024-11-01 07:00,1,0,1,0,0,0
2024-11-01 07:15,4,2,2,0,0,0
2024-11-01 07:30,9,3,6,0,0,0
2024-11-01 07:45,4,2,2,0,0,0
2024-11-01 08:00,5,1,4,0,0,0
2024-11-01 08:15,5,2,3,0,0,0
2024-11-01 08:30,15,8,7,0,0,0
2024-11-01 08:45,8,5,3,0,0,0
2024-11-01 09:00,8,4,4,0,0,0
2024-11-01 09:15,16,8,8,0,0,0
2024-11-01 09:30,17,8,9,0,0,0
2024-11-01 09:45,28,18,10,0,0,0
2024-11-01 10:00,22,13,9,0,0,0
2024-11-01 10:15,20,10,10,0,0,0
2024-11-01 10:30,28,20,8,0,0,0
2024-11-01 10:45,32,28,4,0,0,0
2024-11-01 11:00,16,6,10,0,0,0
2024-11-01 11:15,26,17,9,0,0,0
2024-11-01 11:30,31,15,16,0,0,0
2024-11-01 11:45,20,11,9,0,0,0
2024-11-01 12:00,20,9,11,0,0,0
2024-11-01 12:15,25,13,12,0,0,0
2024-11-01 12:30,49,14,35,0,0,0
2024-11-01 12:45,35,18,17,0,0,0
2024-11-01 13:00,27,11,16,0,0,0
2024-11-01 13:15,37,11,26,0,0,0
2024-11-01 13:30,24,7,17,0,0,0
2024-11-01 13:45,25,10,15,0,0,0
2024-11-01 14:00,33,14,19,0,0,0
2024-11-01 14:15,33,11,22,0,0,0
2024-11-01 14:30,30,13,17,0,0,0
2024-11-01 14:45,34,14,20,0,0,0
2024-11-01 15:00,22,13,9,0,0,0
2024-11-01 15:15,32,14,18,0,0,0
2024-11-01 15:30,34,22,12,0,0,0
2024-11-01 15:45,27,20,7,0,0,0
2024-11-01 16:00,19,8,11,0,0,0
2024-11-01 16:15,18,9,9,0,0,0
2024-11-01 16:30,33,20,13,0,0,0
2024-11-01 16:45,30,16,14,0,0,0
2024-11-01 17:00,31,16,15,0,0,0
2024-11-01 17:15,26,12,14,0,0,0
2024-11-01 17:30,24,17,7,0,0,0
2024-11-01 17:45,33,20,13,0,0,0
2024-11-01 18:00,21,9,12,0,0,0
2024-11-01 18:15,25,13,12,0,0,0
2024-11-01 18:30,17,11,6,0,0,0
2024-11-01 18:45,17,15,2,0,0,0
2024-11-01 19:00,14,6,8,0,0,0
2024-11-01 19:15,22,15,7,0,0,0
2024-11-01 19:30,14,7,7,0,0,0
2024-11-01 19:45,17,10,7,0,0,0
2024-11-01 20:00,19,4,15,0,0,0
2024-11-01 20:15,10,7,3,0,0,0
2024-11-01 20:30,6,2,4,0,0,0
2024-11-01 20:45,10,4,6,0,0,0
2024-11-01 21:00,10,5,5,0,0,0
2024-11-01 21:15,6,2,4,0,0,0
2024-11-01 21:30,8,3,5,0,0,0
2024-11-01 21:45,8,2,6,0,0,0
2024-11-01 22:00,8,2,6,0,0,0
2024-11-01 22:15,10,1,9,0,0,0
2024-11-01 22:30,6,2,4,0,0,0
2024-11-01 22:45,6,0,6,0,0,0
2024-11-01 23:00,13,3,10,0,0,0
2024-11-01 23:15,6,3,3,0,0,0
2024-11-01 23:30,11,3,8,0,0,0
2024-11-01 23:45,16,1,15,0,0,0
2024-11-02 00:00,6,1,5,0,0,0
2024-11-02 00:15,5,2,3,0,0,0
2024-11-02 00:30,5,0,5,0,0,0
2024-11-02 00:45,4,1,3,0,0,0
2024-11-02 01:00,7,2,5,0,0,0
2024-11-02 01:15,6,1,5,0,0,0
2024-11-02 01:30,2,0,2,0,0,0
2024-11-02 01:45,2,0,2,0,0,0
2024-11-02 02:00,2,0,2,0,0,0
2024-11-02 02:15,2,1,1,0,0,0
2024-11-02 02:30,3,1,2,0,0,0
2024-11-02 02:45,2,0,2,0,0,0
2024-11-02 03:00,3,1,2,0,0,0
2024-11-02 03:15,0,0,0,0,0,0
2024-11-02 03:30,0,0,0,0,0,0
2024-11-02 03:45,1,0,1,0,0,0
2024-11-02 04:00,2,0,2,0,0,0
2024-11-02 04:15,2,0,2,0,0,0
2024-11-02 04:30,3,1,2,0,0,0
2024-11-02 04:45,1,1,0,0,0,0
2024-11-02 05:00,1,1,0,0,0,0
2024-11-02 05:15,3,0,3,0,0,0
2024-11-02 05:30,7,5,2,0,0,0
2024-11-02 05:45,5,3,2,0,0,0
2024-11-02 06:00,5,4,1,0,0,0
2024-11-02 06:15,2,2,0,0,0,0
2024-11-02 06:30,6,2,4,0,0,0
2024-11-02 06:45,6,3,3,0,0,0
2024-11-02 07:00,3,2,1,0,0,0
2024-11-02 07:15,5,5,0,0,0,0
2024-11-02 07:30,9,2,7,0,0,0
2024-11-02 07:45,10,4,6,0,0,0
2024-11-02 08:00,6,3,3,0,0,0
2024-11-02 08:15,12,10,2,0,0,0
2024-11-02 08:30,24,14,10,0,0,0
2024-11-02 08:45,22,11,11,0,0,0
2024-11-02 09:00,27,17,10,0,0,0
2024-11-02 09:15,33,24,9,0,0,0
2024-11-02 09:30,40,31,9,0,0,0
2024-11-02 09:45,54,40,14,0,0,0
2024-11-02 10:00,76,42,34,0,0,0
2024-11-02 10:15,63,44,19,0,0,0
2024-11-02 10:30,63,42,21,0,0,0
2024-11-02 10:45,72,52,20,0,0,0
2024-11-02 11:00,53,33,20,0,0,0
2024-11-02 11:15,80,53,27,0,0,0
2024-11-02 11:30,67,44,23,0,0,0
2024-11-02 11:45,77,44,33,0,0,0
2024-11-02 12:00,57,23,34,0,0,0
2024-11-02 12:15,68,33,35,0,0,0
2024-11-02 12:30,55,28,27,0,0,0
2024-11-02 12:45,73,41,32,0,0,0
2024-11-02 13:00,68,40,28,0,0,0
2024-11-02 13:15,81,38,43,0,0,0
2024-11-02 13:30,67,24,43,0,0,0
2024-11-02 13:45,62,27,35,0,0,0
2024-11-02 14:00,59,29,30,0,0,0
2024-11-02 14:15,75,29,46,0,0,0
2024-11-02 14:30,83,32,51,0,0,0
2024-11-02 14:45,73,40,33,0,0,0
2024-11-02 15:00,99,39,60,0,0,0
2024-11-02 15:15,82,36,46,0,0,0
2024-11-02 15:30,87,43,44,0,0,0
2024-11-02 15:45,75,37,38,0,0,0
2024-11-02 16:00,47,20,27,0,0,0
2024-11-02 16:15,69,33,36,0,0,0
2024-11-02 16:30,73,31,42,0,0,0
2024-11-02 16:45,46,18,28,0,0,0
2024-11-02 17:00,60,28,32,0,0,0
2024-11-02 17:15,55,21,34,0,0,0
2024-11-02 17:30,61,33,28,0,0,0
2024-11-02 17:45,56,30,26,0,0,0
2024-11-02 18:00,46,16,30,0,0,0
2024-11-02 18:15,51,31,20,0,0,0
2024-11-02 18:30,30,12,18,0,0,0
2024-11-02 18:45,44,28,16,0,0,0
2024-11-02 19:00,29,17,12,0,0,0
2024-11-02 19:15,27,11,16,0,0,0
2024-11-02 19:30,29,18,11,0,0,0
2024-11-02 19:45,48,24,24,0,0,0
2024-11-02 20:00,19,12,7,0,0,0
2024-11-02 20:15,17,7,10,0,0,0
2024-11-02 20:30,14,8,6,0,0,0
2024-11-02 20:45,12,4,8,0,0,0
2024-11-02 21:00,12,8,4,0,0,0
2024-11-02 21:15,13,1,12,0,0,0
2024-11-02 21:30,15,7,8,0,0,0
2024-11-02 21:45,26,11,15,0,0,0
2024-11-02 22:00,27,6,21,0,0,0
2024-11-02 22:15,19,5,14,0,0,0
2024-11-02 22:30,11,4,7,0,0,0
2024-11-02 22:45,8,2,6,0,0,0
2024-11-02 23:00,18,4,14,0,0,0
2024-11-02 23:15,10,3,7,0,0,0
2024-11-02 23:30,10,4,6,0,0,0
2024-11-02 23:45,16,4,12,0,0,0
2024-11-03 00:00,9,4,5,0,0,0
2024-11-03 00:15,19,5,14,0,0,0
2024-11-03 00:30,12,5,7,0,0,0
2024-11-03 00:45,11,2,9,0,0,0
2024-11-03 01:00,9,3,6,0,0,0
2024-11-03 01:15,5,0,5,0,0,0
2024-11-03 01:30,10,4,6,0,0,0
2024-11-03 01:45,5,0,5,0,0,0
2024-11-03 02:00,7,2,5,0,0,0
2024-11-03 02:15,7,0,7,0,0,0
2024-11-03 02:30,6,0,6,0,0,0
2024-11-03 02:45,1,0,1,0,0,0
2024-11-03 03:00,2,0,2,0,0,0
2024-11-03 03:15,3,0,3,0,0,0
2024-11-03 03:30,1,0,1,0,0,0
2024-11-03 03:45,3,0,3,0,0,0
2024-11-03 04:00,0,0,0,0,0,0
2024-11-03 04:15,1,0,1,0,0,0
2024-11-03 04:30,1,0,1,0,0,0
2024-11-03 04:45,0,0,0,0,0,0
2024-11-03 05:00,1,1,0,0,0,0
2024-11-03 05:15,3,2,1,0,0,0
2024-11-03 05:30,1,1,0,0,0,0
2024-11-03 05:45,3,2,1,0,0,0
2024-11-03 06:00,4,3,1,0,0,0
2024-11-03 06:15,1,1,0,0,0,0
2024-11-03 06:30,3,2,1,0,0,0
2024-11-03 06:45,5,1,4,0,0,0
2024-11-03 07:00,4,1,3,0,0,0
2024-11-03 07:15,3,1,2,0,0,0
2024-11-03 07:30,3,2,1,0,0,0
2024-11-03 07:45,6,4,2,0,0,0
2024-11-03 08:00,4,1,3,0,0,0
2024-11-03 08:15,9,6,3,0,0,0
2024-11-03 08:30,6,4,2,0,0,0
2024-11-03 08:45,10,8,2,0,0,0
2024-11-03 09:00,8,7,1,0,0,0
2024-11-03 09:15,19,13,6,0,0,0
2024-11-03 09:30,16,9,7,0,0,0
2024-11-03 09:45,22,14,8,0,0,0
2024-11-03 10:00,33,16,17,0,0,0
2024-11-03 10:15,21,12,9,0,0,0
2024-11-03 10:30,48,31,17,0,0,0
2024-11-03 10:45,33,13,20,0,0,0
2024-11-03 11:00,39,19,20,0,0,0
2024-11-03 11:15,31,21,10,0,0,0
2024-11-03 11:30,53,22,31,0,0,0
2024-11-03 11:45,42,19,23,0,0,0
2024-11-03 12:00,42,14,28,0,0,0
2024-11-03 12:15,42,12,30,0,0,0
2024-11-03 12:30,50,27,23,0,0,0
2024-11-03 12:45,37,25,12,0,0,0
2024-11-03 13:00,87,41,46,0,0,0
2024-11-03 13:15,49,28,21,0,0,0
2024-11-03 13:30,45,17,28,0,0,0
2024-11-03 13:45,63,27,36,0,0,0
2024-11-03 14:00,56,30,26,0,0,0
2024-11-03 14:15,75,29,46,0,0,0
2024-11-03 14:30,55,31,24,0,0,0
2024-11-03 14:45,90,62,28,0,0,0
2024-11-03 15:00,84,35,49,0,0,0
2024-11-03 15:15,91,46,45,0,0,0
2024-11-03 15:30,73,43,30,0,0,0
2024-11-03 15:45,52,31,21,0,0,0
2024-11-03 16:00,48,16,32,0,0,0
2024-11-03 16:15,45,21,24,0,0,0
2024-11-03 16:30,57,40,17,0,0,0
2024-11-03 16:45,44,24,20,0,0,0
2024-11-03 17:00,50,27,23,0,0,0
2024-11-03 17:15,55,32,23,0,0,0
2024-11-03 17:30,44,23,21,0,0,0
2024-11-03 17:45,36,27,9,0,0,0
2024-11-03 18:00,23,9,14,0,0,0
2024-11-03 18:15,22,13,9,0,0,0
2024-11-03 18:30,32,18,14,0,0,0
2024-11-03 18:45,33,11,22,0,0,0
2024-11-03 19:00,26,9,17,0,0,0
2024-11-03 19:15,14,7,7,0,0,0
2024-11-03 19:30,18,5,13,0,0,0
2024-11-03 19:45,9,3,6,0,0,0
2024-11-03 20:00,10,4,6,0,0,0
2024-11-03 20:15,18,11,7,0,0,0
2024-11-03 20:30,9,5,4,0,0,0
2024-11-03 20:45,13,7,6,0,0,0
2024-11-03 21:00,9,2,7,0,0,0
2024-11-03 21:15,17,6,11,0,0,0
2024-11-03 21:30,11,3,8,0,0,0
2024-11-03 21:45,10,4,6,0,0,0
2024-11-03 22:00,11,8,3,0,0,0
2024-11-03 22:15,4,2,2,0,0,0
2024-11-03 22:30,2,0,2,0,0,0
2024-11-03 22:45,1,0,1,0,0,0
2024-11-03 23:00,2,1,1,0,0,0
2024-11-03 23:15,3,2,1,0,0,0
2024-11-03 23:30,6,2,4,0,0,0
2024-11-03 23:45,1,1,0,0,0,0
2024-11-04 00:00,3,1,2,0,0,0
2024-11-04 00:15,0,0,0,0,0,0
2024-11-04 00:30,0,0,0,0,0,0
2024-11-04 00:45,1,0,1,0,0,0
2024-11-04 01:00,1,1,0,0,0,0
2024-11-04 01:15,0,0,0,0,0,0
2024-11-04 01:30,1,1,0,0,0,0
2024-11-04 01:45,0,0,0,0,0,0
2024-11-04 02:00,0,0,0,0,0,0
2024-11-04 02:15,0,0,0,0,0,0
2024-11-04 02:30,0,0,0,0,0,0
2024-11-04 02:45,0,0,0,0,0,0
2024-11-04 03:00,0,0,0,0,0,0
2024-11-04 03:15,0,0,0,0,0,0
2024-11-04 03:30,0,0,0,0,0,0
2024-11-04 03:45,0,0,0,0,0,0
2024-11-04 04:00,0,0,0,0,0,0
2024-11-04 04:15,2,2,0,0,0,0
2024-11-04 04:30,4,3,1,0,0,0
2024-11-04 04:45,8,4,4,0,0,0
2024-11-04 05:00,6,1,5,0,0,0
2024-11-04 05:15,12,3,9,0,0,0
2024-11-04 05:30,21,13,8,0,0,0
2024-11-04 05:45,32,17,15,0,0,0
2024-11-04 06:00,16,8,8,0,0,0
2024-11-04 06:15,32,21,11,0,0,0
2024-11-04 06:30,40,23,17,0,0,0
2024-11-04 06:45,48,31,17,0,0,0
2024-11-04 07:00,74,49,25,0,0,0
2024-11-04 07:15,194,162,32,0,0,0
2024-11-04 07:30,235,205,30,0,0,0
2024-11-04 07:45,219,181,38,0,0,0
2024-11-04 08:00,133,102,31,0,0,0
2024-11-04 08:15,111,83,28,0,0,0
2024-11-04 08:30,80,55,25,0,0,0
2024-11-04 08:45,79,54,25,0,0,0
2024-11-04 09:00,48,34,14,0,0,0
2024-11-04 09:15,50,37,13,0,0,0
2024-11-04 09:30,68,42,26,0,0,0
2024-11-04 09:45,59,42,17,0,0,0
2024-11-04 10:00,45,31,14,0,0,0
2024-11-04 10:15,47,28,19,0,0,0
2024-11-04 10:30,38,23,15,0,0,0
2024-11-04 10:45,55,37,18,0,0,0
2024-11-04 11:00,46,28,18,0,0,0
2024-11-04 11:15,44,21,23,0,0,0
2024-11-04 11:30,56,25,31,0,0,0
2024-11-04 11:45,49,21,28,0,0,0
2024-11-04 12:00,39,15,24,0,0,0
2024-11-04 12:15,53,34,19,0,0,0
2024-11-04 12:30,91,28,63,0,0,0
2024-11-04 12:45,65,25,40,0,0,0
2024-11-04 13:00,76,28,48,0,0,0
2024-11-04 13:15,137,21,116,0,0,0
2024-11-04 13:30,68,17,51,0,0,0
2024-11-04 13:45,61,26,35,0,0,0
2024-11-04 14:00,78,26,52,0,0,0
2024-11-04 14:15,62,26,36,0,0,0
2024-11-04 14:30,85,25,60,0,0,0
2024-11-04 14:45,96,41,55,0,0,0
2024-11-04 15:00,94,24,70,0,0,0
2024-11-04 15:15,81,37,44,0,0,0
2024-11-04 15:30,93,28,65,0,0,0
2024-11-04 15:45,114,42,72,0,0,0
2024-11-04 16:00,78,28,50,0,0,0
2024-11-04 16:15,122,63,59,0,0,0
2024-11-04 16:30,82,38,44,0,0,0
2024-11-04 16:45,120,44,76,0,0,0
2024-11-04 17:00,90,31,59,0,0,0
2024-11-04 17:15,108,41,67,0,0,0
2024-11-04 17:30,105,51,54,0,0,0
2024-11-04 17:45,83,29,54,0,0,0
2024-11-04 18:00,67,23,44,0,0,0
2024-11-04 18:15,74,20,54,0,0,0
2024-11-04 18:30,61,23,38,0,0,0
2024-11-04 18:45,46,14,32,0,0,0
2024-11-04 19:00,33,16,17,0,0,0
2024-11-04 19:15,31,13,18,0,0,0
2024-11-04 19:30,38,13,25,0,0,0
2024-11-04 19:45,35,16,19,0,0,0
2024-11-04 20:00,26,13,13,0,0,0
2024-11-04 20:15,15,5,10,0,0,0
2024-11-04 20:30,28,5,23,0,0,0
2024-11-04 20:45,15,5,10,0,0,0
2024-11-04 21:00,15,7,8,0,0,0
2024-11-04 21:15,16,4,12,0,0,0
2024-11-04 21:30,11,7,4,0,0,0
2024-11-04 21:45,11,4,7,0,0,0
2024-11-04 22:00,18,3,15,0,0,0
2024-11-04 22:15,23,6,17,0,0,0
2024-11-04 22:30,11,4,7,0,0,0
2024-11-04 22:45,8,1,7,0,0,0
2024-11-04 23:00,12,1,11,0,0,0
2024-11-04 23:15,6,2,4,0,0,0
2024-11-04 23:30,5,5,0,0,0,0
2024-11-04 23:45,1,0,1,0,0,0
2024-11-05 00:00,5,1,4,0,0,0
2024-11-05 00:15,2,1,1,0,0,0
2024-11-05 00:30,4,2,2,0,0,0
2024-11-05 00:45,0,0,0,0,0,0
2024-11-05 01:00,0,0,0,0,0,0
2024-11-05 01:15,1,1,0,0,0,0
2024-11-05 01:30,4,3,1,0,0,0
2024-11-05 01:45,0,0,0,0,0,0
2024-11-05 02:00,0,0,0,0,0,0
2024-11-05 02:15,0,0,0,0,0,0
2024-11-05 02:30,0,0,0,0,0,0
2024-11-05 02:45,0,0,0,0,0,0
2024-11-05 03:00,0,0,0,0,0,0
2024-11-05 03:15,0,0,0,0,0,0
2024-11-05 03:30,0,0,0,0,0,0
2024-11-05 03:45,0,0,0,0,0,0
2024-11-05 04:00,1,0,1,0,0,0
2024-11-05 04:15,5,3,2,0,0,0
2024-11-05 04:30,0,0,0,0,0,0
2024-11-05 04:45,5,3,2,0,0,0
2024-11-05 05:00,8,3,5,0,0,0
2024-11-05 05:15,13,4,9,0,0,0
2024-11-05 05:30,17,9,8,0,0,0
2024-11-05 05:45,29,19,10,0,0,0
2024-11-05 06:00,28,13,15,0,0,0
2024-11-05 06:15,32,18,14,0,0,0
2024-11-05 06:30,43,29,14,0,0,0
2024-11-05 06:45,80,41,39,0,0,0
2024-11-05 07:00,61,41,20,0,0,0
2024-11-05 07:15,177,147,30,0,0,0
2024-11-05 07:30,259,225,34,0,0,0
2024-11-05 07:45,199,141,58,0,0,0
2024-11-05 08:00,159,117,42,0,0,0
2024-11-05 08:15,132,96,36,0,0,0
2024-11-05 08:30,83,57,26,0,0,0
2024-11-05 08:45,85,57,28,0,0,0
2024-11-05 09:00,66,40,26,0,0,0
2024-11-05 09:15,42,34,8,0,0,0
2024-11-05 09:30,51,39,12,0,0,0
2024-11-05 09:45,55,42,13,0,0,0
2024-11-05 10:00,37,24,13,0,0,0
2024-11-05 10:15,53,25,28,0,0,0
2024-11-05 10:30,46,26,20,0,0,0
2024-11-05 10:45,38,22,16,0,0,0
2024-11-05 11:00,35,15,20,0,0,0
2024-11-05 11:15,52,21,31,0,0,0
2024-11-05 11:30,44,19,25,0,0,0
2024-11-05 11:45,58,29,29,0,0,0
2024-11-05 12:00,44,19,25,0,0,0
2024-11-05 12:15,35,16,19,0,0,0
2024-11-05 12:30,51,25,26,0,0,0
2024-11-05 12:45,73,36,37,0,0,0
2024-11-05 13:00,64,18,46,0,0,0
2024-11-05 13:15,188,20,168,0,0,0
2024-11-05 13:30,73,20,53,0,0,0
2024-11-05 13:45,78,34,44,0,0,0
2024-11-05 14:00,90,34,56,0,0,0
2024-11-05 14:15,103,47,56,0,0,0
2024-11-05 14:30,86,42,44,0,0,0
2024-11-05 14:45,84,37,47,0,0,0
2024-11-05 15:00,78,25,53,0,0,0
2024-11-05 15:15,119,64,55,0,0,0
2024-11-05 15:30,107,40,67,0,0,0
2024-11-05 15:45,104,49,55,0,0,0
2024-11-05 16:00,92,30,62,0,0,0
2024-11-05 16:15,107,52,55,0,0,0
2024-11-05 16:30,101,42,59,0,0,0
2024-11-05 16:45,110,64,46,0,0,0
2024-11-05 17:00,117,46,71,0,0,0
2024-11-05 17:15,107,42,65,0,0,0
2024-11-05 17:30,100,35,65,0,0,0
2024-11-05 17:45,92,32,60,0,0,0
2024-11-05 18:00,68,31,37,0,0,0
2024-11-05 18:15,85,40,45,0,0,0
2024-11-05 18:30,55,25,30,0,0,0
2024-11-05 18:45,44,20,24,0,0,0
2024-11-05 19:00,55,19,36,0,0,0
2024-11-05 19:15,38,16,22,0,0,0
2024-11-05 19:30,30,14,16,0,0,0
2024-11-05 19:45,34,8,26,0,0,0
2024-11-05 20:00,30,12,18,0,0,0
2024-11-05 20:15,32,10,22,0,0,0
2024-11-05 20:30,22,7,15,0,0,0
2024-11-05 20:45,27,9,18,0,0,0
2024-11-05 21:00,18,8,10,0,0,0
2024-11-05 21:15,37,11,26,0,0,0
2024-11-05 21:30,20,2,18,0,0,0
2024-11-05 21:45,14,6,8,0,0,0
2024-11-05 22:00,18,10,8,0,0,0
2024-11-05 22:15,18,8,10,0,0,0
2024-11-05 22:30,24,9,15,0,0,0
2024-11-05 22:45,9,1,8,0,0,0
2024-11-05 23:00,5,0,5,0,0,0
2024-11-05 23:15,6,1,5,0,0,0
2024-11-05 23:30,3,1,2,0,0,0
2024-11-05 23:45,12,6,6,0,0,0
2024-11-06 00:00,5,3,2,0,0,0
2024-11-06 00:15,0,0,0,0,0,0
2024-11-06 00:30,7,3,4,0,0,0
2024-11-06 00:45,0,0,0,0,0,0
2024-11-06 01:00,3,3,0,0,0,0
2024-11-06 01:15,0,0,0,0,0,0
2024-11-06 01:30,3,0,3,0,0,0
2024-11-06 01:45,0,0,0,0,0,0
2024-11-06 02:00,0,0,0,0,0,0
2024-11-06 02:15,0,0,0,0,0,0
2024-11-06 02:30,2,1,1,0,0,0
2024-11-06 02:45,1,0,1,0,0,0
2024-11-06 03:00,0,0,0,0,0,0
2024-11-06 03:15,1,1,0,0,0,0
2024-11-06 03:30,0,0,0,0,0,0
2024-11-06 03:45,0,0,0,0,0,0
2024-11-06 04:00,0,0,0,0,0,0
2024-11-06 04:15,1,1,0,0,0,0
2024-11-06 04:30,1,0,1,0,0,0
2024-11-06 04:45,3,2,1,0,0,0
2024-11-06 05:00,9,3,6,0,0,0
2024-11-06 05:15,9,3,6,0,0,0
2024-11-06 05:30,32,20,12,0,0,0
2024-11-06 05:45,23,14,9,0,0,0
2024-11-06 06:00,21,14,7,0,0,0
2024-11-06 06:15,31,20,11,0,0,0
2024-11-06 06:30,46,30,16,0,0,0
2024-11-06 06:45,58,35,23,0,0,0
2024-11-06 07:00,73,51,22,0,0,0
2024-11-06 07:15,172,134,38,0,0,0
2024-11-06 07:30,252,219,33,0,0,0
2024-11-06 07:45,206,166,40,0,0,0
2024-11-06 08:00,155,112,43,0,0,0
2024-11-06 08:15,103,71,32,0,0,0
2024-11-06 08:30,98,77,21,0,0,0
2024-11-06 08:45,85,60,25,0,0,0
2024-11-06 09:00,43,37,6,0,0,0
2024-11-06 09:15,52,34,18,0,0,0
2024-11-06 09:30,79,55,24,0,0,0
2024-11-06 09:45,57,41,16,0,0,0
2024-11-06 10:00,38,24,14,0,0,0
2024-11-06 10:15,28,21,7,0,0,0
2024-11-06 10:30,32,23,9,0,0,0
2024-11-06 10:45,43,24,19,0,0,0
2024-11-06 11:00,43,34,9,0,0,0
2024-11-06 11:15,38,18,20,0,0,0
2024-11-06 11:30,47,21,26,0,0,0
2024-11-06 11:45,56,25,31,0,0,0
2024-11-06 12:00,58,24,34,0,0,0
2024-11-06 12:15,44,17,27,0,0,0
2024-11-06 12:30,52,17,35,0,0,0
2024-11-06 12:45,67,27,40,0,0,0
2024-11-06 13:00,67,17,50,0,0,0
2024-11-06 13:15,95,24,71,0,0,0
2024-11-06 13:30,63,22,41,0,0,0
2024-11-06 13:45,60,22,38,0,0,0
2024-11-06 14:00,65,15,50,0,0,0
2024-11-06 14:15,73,32,41,0,0,0
2024-11-06 14:30,87,40,47,0,0,0
2024-11-06 14:45,78,27,51,0,0,0
2024-11-06 15:00,79,20,59,0,0,0
2024-11-06 15:15,75,20,55,0,0,0
2024-11-06 15:30,78,23,55,0,0,0
2024-11-06 15:45,163,36,127,0,0,0
2024-11-06 16:00,145,50,95,0,0,0
2024-11-06 16:15,105,51,54,0,0,0
2024-11-06 16:30,105,38,67,0,0,0
2024-11-06 16:45,85,40,45,0,0,0
2024-11-06 17:00,86,29,57,0,0,0
2024-11-06 17:15,103,39,64,0,0,0
2024-11-06 17:30,78,40,38,0,0,0
2024-11-06 17:45,85,38,47,0,0,0
2024-11-06 18:00,78,35,43,0,0,0
2024-11-06 18:15,75,26,49,0,0,0
2024-11-06 18:30,62,31,31,0,0,0
2024-11-06 18:45,45,15,30,0,0,0
2024-11-06 19:00,43,18,25,0,0,0
2024-11-06 19:15,43,21,22,0,0,0
2024-11-06 19:30,39,11,28,0,0,0
2024-11-06 19:45,33,14,19,0,0,0
2024-11-06 20:00,26,9,17,0,0,0
2024-11-06 20:15,27,9,18,0,0,0
2024-11-06 20:30,18,6,12,0,0,0
2024-11-06 20:45,23,12,11,0,0,0
2024-11-06 21:00,25,8,17,0,0,0
2024-11-06 21:15,26,8,18,0,0,0
2024-11-06 21:30,25,6,19,0,0,0
2024-11-06 21:45,35,8,27,0,0,0
2024-11-06 22:00,19,7,12,0,0,0
2024-11-06 22:15,22,8,14,0,0,0
2024-11-06 22:30,26,3,23,0,0,0
2024-11-06 22:45,10,1,9,0,0,0
2024-11-06 23:00,19,0,19,0,0,0
2024-11-06 23:15,11,5,6,0,0,0
2024-11-06 23:30,4,2,2,0,0,0
2024-11-06 23:45,9,0,9,0,0,0
2024-11-07 00:00,11,4,7,0,0,0
2024-11-07 00:15,0,0,0,0,0,0
2024-11-07 00:30,10,7,3,0,0,0
2024-11-07 00:45,9,3,6,0,0,0
2024-11-07 01:00,7,5,2,0,0,0
2024-11-07 01:15,12,6,6,0,0,0
2024-11-07 01:30,4,4,0,0,0,0
2024-11-07 01:45,5,4,1,0,0,0
2024-11-07 02:00,3,3,0,0,0,0
2024-11-07 02:15,6,5,1,0,0,0
2024-11-07 02:30,1,0,1,0,0,0
2024-11-07 02:45,0,0,0,0,0,0
2024-11-07 03:00,0,0,0,0,0,0
2024-11-07 03:15,4,4,0,0,0,0
2024-11-07 03:30,0,0,0,0,0,0
2024-11-07 03:45,5,5,0,0,0,0
2024-11-07 04:00,0,0,0,0,0,0
2024-11-07 04:15,3,3,0,0,0,0
2024-11-07 04:30,3,1,2,0,0,0
2024-11-07 04:45,2,1,1,0,0,0
2024-11-07 05:00,8,2,6,0,0,0
2024-11-07 05:15,13,6,7,0,0,0
2024-11-07 05:30,18,12,6,0,0,0
2024-11-07 05:45,27,15,12,0,0,0
2024-11-07 06:00,17,10,7,0,0,0
2024-11-07 06:15,37,18,19,0,0,0
2024-11-07 06:30,39,24,15,0,0,0
2024-11-07 06:45,72,38,34,0,0,0
2024-11-07 07:00,77,51,26,0,0,0
2024-11-07 07:15,151,126,25,0,0,0
2024-11-07 07:30,236,210,26,0,0,0
2024-11-07 07:45,234,185,49,0,0,0
2024-11-07 08:00,132,91,41,0,0,0
2024-11-07 08:15,120,94,26,0,0,0
2024-11-07 08:30,75,52,23,0,0,0
2024-11-07 08:45,105,74,31,0,0,0
2024-11-07 09:00,56,36,20,0,0,0
2024-11-07 09:15,50,41,9,0,0,0
2024-11-07 09:30,65,48,17,0,0,0
2024-11-07 09:45,49,35,14,0,0,0
2024-11-07 10:00,32,19,13,0,0,0
2024-11-07 10:15,34,22,12,0,0,0
2024-11-07 10:30,39,21,18,0,0,0
2024-11-07 10:45,41,24,17,0,0,0
2024-11-07 11:00,37,17,20,0,0,0
2024-11-07 11:15,31,16,15,0,0,0
2024-11-07 11:30,29,15,14,0,0,0
2024-11-07 11:45,38,21,17,0,0,0
2024-11-07 12:00,46,21,25,0,0,0
2024-11-07 12:15,43,17,26,0,0,0
2024-11-07 12:30,37,11,26,0,0,0
2024-11-07 12:45,42,14,28,0,0,0
2024-11-07 13:00,84,30,54,0,0,0
2024-11-07 13:15,72,19,53,0,0,0
2024-11-07 13:30,49,17,32,0,0,0
2024-11-07 13:45,46,18,28,0,0,0
2024-11-07 14:00,58,14,44,0,0,0
2024-11-07 14:15,93,44,49,0,0,0
2024-11-07 14:30,75,35,40,0,0,0
2024-11-07 14:45,64,26,38,0,0,0
2024-11-07 15:00,73,29,44,0,0,0
2024-11-07 15:15,67,19,48,0,0,0
2024-11-07 15:30,91,31,60,0,0,0
2024-11-07 15:45,164,39,125,0,0,0
2024-11-07 16:00,111,40,71,0,0,0
2024-11-07 16:15,94,37,57,0,0,0
2024-11-07 16:30,90,23,67,0,0,0
2024-11-07 16:45,121,52,69,0,0,0
2024-11-07 17:00,84,34,50,0,0,0
2024-11-07 17:15,83,40,43,0,0,0
2024-11-07 17:30,84,32,52,0,0,0
2024-11-07 17:45,96,51,45,0,0,0
2024-11-07 18:00,84,39,45,0,0,0
2024-11-07 18:15,77,30,47,0,0,0
2024-11-07 18:30,72,25,47,0,0,0
2024-11-07 18:45,38,16,22,0,0,0
2024-11-07 19:00,40,16,24,0,0,0
2024-11-07 19:15,30,16,14,0,0,0
2024-11-07 19:30,32,13,19,0,0,0
2024-11-07 19:45,31,15,16,0,0,0
2024-11-07 20:00,30,16,14,0,0,0
2024-11-07 20:15,20,7,13,0,0,0
2024-11-07 20:30,21,2,19,0,0,0
2024-11-07 20:45,21,10,11,0,0,0
2024-11-07 21:00,17,4,13,0,0,0
2024-11-07 21:15,15,4,11,0,0,0
2024-11-07 21:30,21,8,13,0,0,0
2024-11-07 21:45,12,3,9,0,0,0
2024-11-07 22:00,24,10,14,0,0,0
2024-11-07 22:15,22,5,17,0,0,0
2024-11-07 22:30,22,11,11,0,0,0
2024-11-07 22:45,17,3,14,0,0,0
2024-11-07 23:00,12,2,10,0,0,0
2024-11-07 23:15,14,3,11,0,0,0
2024-11-07 23:30,10,3,7,0,0,0
2024-11-07 23:45,10,5,5,0,0,0
2024-11-08 00:00,5,4,1,0,0,0
2024-11-08 00:15,5,3,2,0,0,0
2024-11-08 00:30,3,1,2,0,0,0
2024-11-08 00:45,1,0,1,0,0,0
2024-11-08 01:00,6,2,4,0,0,0
2024-11-08 01:15,2,2,0,0,0,0
2024-11-08 01:30,0,0,0,0,0,0
2024-11-08 01:45,6,3,3,0,0,0
2024-11-08 02:00,9,7,2,0,0,0
2024-11-08 02:15,2,2,0,0,0,0
2024-11-08 02:30,0,0,0,0,0,0
2024-11-08 02:45,2,2,0,0,0,0
2024-11-08 03:00,1,0,1,0,0,0
2024-11-08 03:15,1,0,1,0,0,0
2024-11-08 03:30,0,0,0,0,0,0
2024-11-08 03:45,2,0,2,0,0,0
2024-11-08 04:00,0,0,0,0,0,0
2024-11-08 04:15,1,1,0,0,0,0
2024-11-08 04:30,3,0,3,0,0,0
2024-11-08 04:45,1,0,1,0,0,0
2024-11-08 05:00,8,2,6,0,0,0
2024-11-08 05:15,10,3,7,0,0,0
2024-11-08 05:30,19,12,7,0,0,0
2024-11-08 05:45,15,9,6,0,0,0
2024-11-08 06:00,19,10,9,0,0,0
2024-11-08 06:15,28,19,9,0,0,0
2024-11-08 06:30,41,29,12,0,0,0
2024-11-08 06:45,53,31,22,0,0,0
2024-11-08 07:00,51,36,15,0,0,0
2024-11-08 07:15,149,118,31,0,0,0
2024-11-08 07:30,229,199,30,0,0,0
2024-11-08 07:45,190,145,45,0,0,0
2024-11-08 08:00,104,69,35,0,0,0
2024-11-08 08:15,62,44,18,0,0,0
2024-11-08 08:30,67,55,12,0,0,0
2024-11-08 08:45,61,40,21,0,0,0
2024-11-08 09:00,50,32,18,0,0,0
2024-11-08 09:15,33,23,10,0,0,0
2024-11-08 09:30,58,41,17,0,0,0
2024-11-08 09:45,50,36,14,0,0,0
2024-11-08 10:00,38,20,18,0,0,0
2024-11-08 10:15,31,21,10,0,0,0
2024-11-08 10:30,39,28,11,0,0,0
2024-11-08 10:45,43,23,20,0,0,0
2024-11-08 11:00,37,18,19,0,0,0
2024-11-08 11:15,32,14,18,0,0,0
2024-11-08 11:30,36,16,20,0,0,0
2024-11-08 11:45,34,6,28,0,0,0
2024-11-08 12:00,51,24,27,0,0,0
2024-11-08 12:15,66,25,41,0,0,0
2024-11-08 12:30,48,22,26,0,0,0
2024-11-08 12:45,59,25,34,0,0,0
2024-11-08 13:00,68,29,39,0,0,0
2024-11-08 13:15,193,29,164,0,0,0
2024-11-08 13:30,88,30,58,0,0,0
2024-11-08 13:45,89,24,65,0,0,0
2024-11-08 14:00,71,25,46,0,0,0
2024-11-08 14:15,75,29,46,0,0,0
2024-11-08 14:30,67,27,40,0,0,0
2024-11-08 14:45,76,27,49,0,0,0
2024-11-08 15:00,83,31,52,0,0,0
2024-11-08 15:15,60,28,32,0,0,0
2024-11-08 15:30,70,28,42,0,0,0
2024-11-08 15:45,64,34,30,0,0,0
2024-11-08 16:00,61,24,37,0,0,0
2024-11-08 16:15,62,31,31,0,0,0
2024-11-08 16:30,65,30,35,0,0,0
2024-11-08 16:45,71,29,42,0,0,0
2024-11-08 17:00,60,34,26,0,0,0
2024-11-08 17:15,56,30,26,0,0,0
2024-11-08 17:30,52,14,38,0,0,0
2024-11-08 17:45,63,38,25,0,0,0
2024-11-08 18:00,48,26,22,0,0,0
2024-11-08 18:15,52,16,36,0,0,0
2024-11-08 18:30,40,26,14,0,0,0
2024-11-08 18:45,51,28,23,0,0,0
2024-11-08 19:00,45,22,23,0,0,0
2024-11-08 19:15,38,24,14,0,0,0
2024-11-08 19:30,40,19,21,0,0,0
2024-11-08 19:45,28,15,13,0,0,0
2024-11-08 20:00,40,23,17,0,0,0
2024-11-08 20:15,15,9,6,0,0,0
2024-11-08 20:30,21,9,12,0,0,0
2024-11-08 20:45,26,18,8,0,0,0
2024-11-08 21:00,21,15,6,0,0,0
2024-11-08 21:15,24,7,17,0,0,0
2024-11-08 21:30,6,2,4,0,0,0
2024-11-08 21:45,18,7,11,0,0,0
2024-11-08 22:00,12,1,11,0,0,0
2024-11-08 22:15,22,2,20,0,0,0
2024-11-08 22:30,15,3,12,0,0,0
2024-11-08 22:45,13,1,12,0,0,0
2024-11-08 23:00,25,5,20,0,0,0
2024-11-08 23:15,17,3,14,0,0,0
2024-11-08 23:30,9,2,7,0,0,0
2024-11-08 23:45,12,3,9,0,0,0
2024-11-09 00:00,13,7,6,0,0,0
2024-11-09 00:15,19,3,16,0,0,0
2024-11-09 00:30,12,1,11,0,0,0
2024-11-09 00:45,11,3,8,0,0,0
2024-11-09 01:00,6,0,6,0,0,0
2024-11-09 01:15,7,0,7,0,0,0
2024-11-09 01:30,14,0,14,0,0,0
2024-11-09 01:45,6,2,4,0,0,0
2024-11-09 02:00,18,8,10,0,0,0
2024-11-09 02:15,10,3,7,0,0,0
2024-11-09 02:30,2,0,2,0,0,0
2024-11-09 02:45,14,2,12,0,0,0
2024-11-09 03:00,0,0,0,0,0,0
2024-11-09 03:15,0,0,0,0,0,0
2024-11-09 03:30,4,1,3,0,0,0
2024-11-09 03:45,0,0,0,0,0,0
2024-11-09 04:00,6,5,1,0,0,0
2024-11-09 04:15,1,1,0,0,0,0
2024-11-09 04:30,2,1,1,0,0,0
2024-11-09 04:45,0,0,0,0,0,0
2024-11-09 05:00,1,0,1,0,0,0
2024-11-09 05:15,2,1,1,0,0,0
2024-11-09 05:30,7,4,3,0,0,0
2024-11-09 05:45,8,5,3,0,0,0
2024-11-09 06:00,3,3,0,0,0,0
2024-11-09 06:15,4,3,1,0,0,0
2024-11-09 06:30,8,3,5,0,0,0
2024-11-09 06:45,10,3,7,0,0,0
2024-11-09 07:00,3,1,2,0,0,0
2024-11-09 07:15,5,4,1,0,0,0
2024-11-09 07:30,9,7,2,0,0,0
2024-11-09 07:45,16,7,9,0,0,0
2024-11-09 08:00,24,15,9,0,0,0
2024-11-09 08:15,12,10,2,0,0,0
2024-11-09 08:30,15,11,4,0,0,0
2024-11-09 08:45,34,22,12,0,0,0
2024-11-09 09:00,23,17,6,0,0,0
2024-11-09 09:15,25,16,9,0,0,0
2024-11-09 09:30,34,27,7,0,0,0
2024-11-09 09:45,49,37,12,0,0,0
2024-11-09 10:00,28,21,7,0,0,0
2024-11-09 10:15,37,23,14,0,0,0
2024-11-09 10:30,46,29,17,0,0,0
2024-11-09 10:45,35,21,14,0,0,0
2024-11-09 11:00,48,40,8,0,0,0
2024-11-09 11:15,45,28,17,0,0,0
2024-11-09 11:30,57,38,19,0,0,0
2024-11-09 11:45,54,31,23,0,0,0
2024-11-09 12:00,43,30,13,0,0,0
2024-11-09 12:15,58,38,20,0,0,0
2024-11-09 12:30,56,26,30,0,0,0
2024-11-09 12:45,59,30,29,0,0,0
2024-11-09 13:00,82,42,40,0,0,0
2024-11-09 13:15,52,30,22,0,0,0
2024-11-09 13:30,64,29,35,0,0,0
2024-11-09 13:45,56,30,26,0,0,0
2024-11-09 14:00,52,22,30,0,0,0
2024-11-09 14:15,51,20,31,0,0,0
2024-11-09 14:30,56,16,40,0,0,0
2024-11-09 14:45,66,34,32,0,0,0
2024-11-09 15:00,69,23,46,0,0,0
2024-11-09 15:15,33,13,20,0,0,0
2024-11-09 15:30,50,29,21,0,0,0
2024-11-09 15:45,64,36,28,0,0,0
2024-11-09 16:00,56,19,37,0,0,0
2024-11-09 16:15,39,17,22,0,0,0
2024-11-09 16:30,52,18,34,0,0,0
2024-11-09 16:45,45,18,27,0,0,0
2024-11-09 17:00,48,29,19,0,0,0
2024-11-09 17:15,52,19,33,0,0,0
2024-11-09 17:30,45,20,25,0,0,0
2024-11-09 17:45,48,32,16,0,0,0
2024-11-09 18:00,35,18,17,0,0,0
2024-11-09 18:15,35,19,16,0,0,0
2024-11-09 18:30,31,12,19,0,0,0
2024-11-09 18:45,44,27,17,0,0,0
2024-11-09 19:00,28,15,13,0,0,0
2024-11-09 19:15,17,6,11,0,0,0
2024-11-09 19:30,28,19,9,0,0,0
2024-11-09 19:45,19,12,7,0,0,0
2024-11-09 20:00,30,13,17,0,0,0
2024-11-09 20:15,29,16,13,0,0,0
2024-11-09 20:30,14,3,11,0,0,0
2024-11-09 20:45,25,6,19,0,0,0
2024-11-09 21:00,11,5,6,0,0,0
2024-11-09 21:15,18,8,10,0,0,0
2024-11-09 21:30,22,13,9,0,0,0
2024-11-09 21:45,11,4,7,0,0,0
2024-11-09 22:00,9,1,8,0,0,0
2024-11-09 22:15,10,3,7,0,0,0
2024-11-09 22:30,18,8,10,0,0,0
2024-11-09 22:45,15,5,10,0,0,0
2024-11-09 23:00,9,1,8,0,0,0
2024-11-09 23:15,16,4,12,0,0,0
2024-11-09 23:30,15,9,6,0,0,0
2024-11-09 23:45,15,4,11,0,0,0
2024-11-10 00:00,16,3,13,0,0,0
2024-11-10 00:15,8,3,5,0,0,0
2024-11-10 00:30,8,2,6,0,0,0
2024-11-10 00:45,13,7,6,0,0,0
2024-11-10 01:00,12,4,8,0,0,0
2024-11-10 01:15,9,1,8,0,0,0
2024-11-10 01:30,11,3,8,0,0,0
2024-11-10 01:45,9,4,5,0,0,0
2024-11-10 02:00,12,5,7,0,0,0
2024-11-10 02:15,5,1,4,0,0,0
2024-11-10 02:30,3,2,1,0,0,0
2024-11-10 02:45,8,8,0,0,0,0
2024-11-10 03:00,5,0,5,0,0,0
2024-11-10 03:15,4,1,3,0,0,0
2024-11-10 03:30,3,3,0,0,0,0
2024-11-10 03:45,12,5,7,0,0,0
2024-11-10 04:00,2,0,2,0,0,0
2024-11-10 04:15,2,0,2,0,0,0
2024-11-10 04:30,5,3,2,0,0,0
2024-11-10 04:45,3,0,3,0,0,0
2024-11-10 05:00,4,4,0,0,0,0
2024-11-10 05:15,2,0,2,0,0,0
2024-11-10 05:30,0,0,0,0,0,0
2024-11-10 05:45,4,3,1,0,0,0
2024-11-10 06:00,3,2,1,0,0,0
2024-11-10 06:15,5,2,3,0,0,0
2024-11-10 06:30,1,0,1,0,0,0
2024-11-10 06:45,1,0,1,0,0,0
2024-11-10 07:00,4,0,4,0,0,0
2024-11-10 07:15,1,1,0,0,0,0
2024-11-10 07:30,1,1,0,0,0,0
2024-11-10 07:45,6,4,2,0,0,0
2024-11-10 08:00,5,2,3,0,0,0
2024-11-10 08:15,2,2,0,0,0,0
2024-11-10 08:30,9,7,2,0,0,0
2024-11-10 08:45,15,13,2,0,0,0
2024-11-10 09:00,5,1,4,0,0,0
2024-11-10 09:15,17,15,2,0,0,0
2024-11-10 09:30,18,11,7,0,0,0
2024-11-10 09:45,21,20,1,0,0,0
2024-11-10 10:00,15,13,2,0,0,0
2024-11-10 10:15,26,15,11,0,0,0
2024-11-10 10:30,22,10,12,0,0,0
2024-11-10 10:45,25,18,7,0,0,0
2024-11-10 11:00,30,15,15,0,0,0
2024-11-10 11:15,13,5,8,0,0,0
2024-11-10 11:30,29,16,13,0,0,0
2024-11-10 11:45,20,12,8,0,0,0
2024-11-10 12:00,31,9,22,0,0,0
2024-11-10 12:15,25,13,12,0,0,0
2024-11-10 12:30,24,9,15,0,0,0
2024-11-10 12:45,40,27,13,0,0,0
2024-11-10 13:00,35,20,15,0,0,0
2024-11-10 13:15,26,19,7,0,0,0
2024-11-10 13:30,43,18,25,0,0,0
2024-11-10 13:45,43,19,24,0,0,0
2024-11-10 14:00,26,16,10,0,0,0
2024-11-10 14:15,32,13,19,0,0,0
2024-11-10 14:30,50,20,30,0,0,0
2024-11-10 14:45,38,21,17,0,0,0
2024-11-10 15:00,55,21,34,0,0,0
2024-11-10 15:15,32,15,17,0,0,0
2024-11-10 15:30,24,11,13,0,0,0
2024-11-10 15:45,43,24,19,0,0,0
2024-11-10 16:00,39,16,23,0,0,0
2024-11-10 16:15,30,15,15,0,0,0
2024-11-10 16:30,41,17,24,0,0,0
2024-11-10 16:45,39,21,18,0,0,0
2024-11-10 17:00,33,20,13,0,0,0
2024-11-10 17:15,34,16,18,0,0,0
2024-11-10 17:30,30,16,14,0,0,0
2024-11-10 17:45,37,15,22,0,0,0
2024-11-10 18:00,17,6,11,0,0,0
2024-11-10 18:15,19,6,13,0,0,0
2024-11-10 18:30,21,14,7,0,0,0
2024-11-10 18:45,13,6,7,0,0,0
2024-11-10 19:00,17,6,11,0,0,0
2024-11-10 19:15,16,8,8,0,0,0
2024-11-10 19:30,18,6,12,0,0,0
2024-11-10 19:45,17,5,12,0,0,0
2024-11-10 20:00,11,8,3,0,0,0
2024-11-10 20:15,12,4,8,0,0,0
2024-11-10 20:30,5,2,3,0,0,0
2024-11-10 20:45,10,6,4,0,0,0
2024-11-10 21:00,7,2,5,0,0,0
2024-11-10 21:15,5,1,4,0,0,0
2024-11-10 21:30,8,3,5,0,0,0
2024-11-10 21:45,9,2,7,0,0,0
2024-11-10 22:00,10,2,8,0,0,0
2024-11-10 22:15,7,2,5,0,0,0
2024-11-10 22:30,6,3,3,0,0,0
2024-11-10 22:45,7,2,5,0,0,0
2024-11-10 23:00,4,0,4,0,0,0
2024-11-10 23:15,4,0,4,0,0,0
2024-11-10 23:30,0,0,0,0,0,0
2024-11-10 23:45,3,0,3,0,0,0
2024-11-11 00:00,1,1,0,0,0,0
2024-11-11 00:15,2,0,2,0,0,0
2024-11-11 00:30,1,1,0,0,0,0
2024-11-11 00:45,1,1,0,0,0,0
2024-11-11 01:00,2,0,2,0,0,0
2024-11-11 01:15,2,2,0,0,0,0
2024-11-11 01:30,0,0,0,0,0,0
2024-11-11 01:45,0,0,0,0,0,0
2024-11-11 02:00,0,0,0,0,0,0
2024-11-11 02:15,0,0,0,0,0,0
2024-11-11 02:30,0,0,0,0,0,0
2024-11-11 02:45,0,0,0,0,0,0
2024-11-11 03:00,1,1,0,0,0,0
2024-11-11 03:15,0,0,0,0,0,0
2024-11-11 03:30,1,0,1,0,0,0
2024-11-11 03:45,0,0,0,0,0,0
2024-11-11 04:00,0,0,0,0,0,0
2024-11-11 04:15,2,2,0,0,0,0
2024-11-11 04:30,1,0,1,0,0,0
2024-11-11 04:45,5,1,4,0,0,0
2024-11-11 05:00,13,7,6,0,0,0
2024-11-11 05:15,10,1,9,0,0,0
2024-11-11 05:30,15,11,4,0,0,0
2024-11-11 05:45,24,9,15,0,0,0
2024-11-11 06:00,29,20,9,0,0,0
2024-11-11 06:15,33,22,11,0,0,0
2024-11-11 06:30,40,23,17,0,0,0
2024-11-11 06:45,66,38,28,0,0,0
2024-11-11 07:00,56,42,14,0,0,0
2024-11-11 07:15,133,115,18,0,0,0
2024-11-11 07:30,234,198,36,0,0,0
2024-11-11 07:45,177,143,34,0,0,0
2024-11-11 08:00,93,67,26,0,0,0
2024-11-11 08:15,73,52,21,0,0,0
2024-11-11 08:30,59,43,16,0,0,0
2024-11-11 08:45,70,50,20,0,0,0
2024-11-11 09:00,29,19,10,0,0,0
2024-11-11 09:15,48,35,13,0,0,0
2024-11-11 09:30,39,26,13,0,0,0
2024-11-11 09:45,33,25,8,0,0,0
2024-11-11 10:00,37,22,15,0,0,0
2024-11-11 10:15,11,6,5,0,0,0
2024-11-11 10:30,35,22,13,0,0,0
2024-11-11 10:45,28,14,14,0,0,0
2024-11-11 11:00,34,16,18,0,0,0
2024-11-11 11:15,34,15,19,0,0,0
2024-11-11 11:30,38,16,22,0,0,0
2024-11-11 11:45,30,15,15,0,0,0
2024-11-11 12:00,25,15,10,0,0,0
2024-11-11 12:15,35,12,23,0,0,0
2024-11-11 12:30,44,22,22,0,0,0
2024-11-11 12:45,44,18,26,0,0,0
2024-11-11 13:00,53,24,29,0,0,0
2024-11-11 13:15,73,20,53,0,0,0
2024-11-11 13:30,31,8,23,0,0,0
2024-11-11 13:45,64,33,31,0,0,0
2024-11-11 14:00,51,12,39,0,0,0
2024-11-11 14:15,76,37,39,0,0,0
2024-11-11 14:30,62,31,31,0,0,0
2024-11-11 14:45,58,25,33,0,0,0
2024-11-11 15:00,68,19,49,0,0,0
2024-11-11 15:15,55,17,38,0,0,0
2024-11-11 15:30,61,21,40,0,0,0
2024-11-11 15:45,161,36,125,0,0,0
2024-11-11 16:00,120,23,97,0,0,0
2024-11-11 16:15,64,27,37,0,0,0
2024-11-11 16:30,63,23,40,0,0,0
2024-11-11 16:45,69,26,43,0,0,0
2024-11-11 17:00,81,33,48,0,0,0
2024-11-11 17:15,87,23,64,0,0,0
2024-11-11 17:30,55,22,33,0,0,0
2024-11-11 17:45,49,20,29,0,0,0
2024-11-11 18:00,52,25,27,0,0,0
2024-11-11 18:15,36,8,28,0,0,0
2024-11-11 18:30,40,14,26,0,0,0
2024-11-11 18:45,43,21,22,0,0,0
2024-11-11 19:00,39,11,28,0,0,0
2024-11-11 19:15,21,11,10,0,0,0
2024-11-11 19:30,24,7,17,0,0,0
2024-11-11 19:45,21,7,14,0,0,0
2024-11-11 20:00,12,5,7,0,0,0
2024-11-11 20:15,16,6,10,0,0,0
2024-11-11 20:30,9,4,5,0,0,0
2024-11-11 20:45,15,7,8,0,0,0
2024-11-11 21:00,10,2,8,0,0,0
2024-11-11 21:15,11,3,8,0,0,0
2024-11-11 21:30,12,4,8,0,0,0
2024-11-11 21:45,16,5,11,0,0,0
2024-11-11 22:00,15,6,9,0,0,0
2024-11-11 22:15,13,10,3,0,0,0
2024-11-11 22:30,11,4,7,0,0,0
2024-11-11 22:45,4,0,4,0,0,0
2024-11-11 23:00,6,2,4,0,0,0
2024-11-11 23:15,6,1,5,0,0,0
2024-11-11 23:30,3,2,1,0,0,0
2024-11-11 23:45,3,1,2,0,0,0
2024-11-12 00:00,1,1,0,0,0,0
2024-11-12 00:15,5,0,5,0,0,0
2024-11-12 00:30,1,1,0,0,0,0
2024-11-12 00:45,0,0,0,0,0,0
2024-11-12 01:00,2,1,1,0,0,0
2024-11-12 01:15,5,2,3,0,0,0
2024-11-12 01:30,0,0,0,0,0,0
2024-11-12 01:45,1,1,0,0,0,0
2024-11-12 02:00,0,0,0,0,0,0
2024-11-12 02:15,0,0,0,0,0,0
2024-11-12 02:30,0,0,0,0,0,0
2024-11-12 02:45,1,1,0,0,0,0
2024-11-12 03:00,1,0,1,0,0,0
2024-11-12 03:15,1,0,1,0,0,0
2024-11-12 03:30,0,0,0,0,0,0
2024-11-12 03:45,0,0,0,0,0,0
2024-11-12 04:00,2,1,1,0,0,0
2024-11-12 04:15,3,2,1,0,0,0
2024-11-12 04:30,2,0,2,0,0,0
2024-11-12 04:45,2,1,1,0,0,0
2024-11-12 05:00,11,3,8,0,0,0
2024-11-12 05:15,12,5,7,0,0,0
2024-11-12 05:30,19,9,10,0,0,0
2024-11-12 05:45,30,15,15,0,0,0
2024-11-12 06:00,26,17,9,0,0,0
2024-11-12 06:15,29,23,6,0,0,0
2024-11-12 06:30,34,18,16,0,0,0
2024-11-12 06:45,64,37,27,0,0,0
2024-11-12 07:00,60,34,26,0,0,0
2024-11-12 07:15,146,113,33,0,0,0
2024-11-12 07:30,251,204,47,0,0,0
2024-11-12 07:45,213,175,38,0,0,0
2024-11-12 08:00,164,120,44,0,0,0
2024-11-12 08:15,103,86,17,0,0,0
2024-11-12 08:30,84,62,22,0,0,0
2024-11-12 08:45,70,48,22,0,0,0
2024-11-12 09:00,53,35,18,0,0,0
2024-11-12 09:15,50,28,22,0,0,0
2024-11-12 09:30,68,47,21,0,0,0
2024-11-12 09:45,52,32,20,0,0,0
2024-11-12 10:00,42,25,17,0,0,0
2024-11-12 10:15,26,19,7,0,0,0
2024-11-12 10:30,39,26,13,0,0,0
2024-11-12 10:45,25,17,8,0,0,0
2024-11-12 11:00,29,20,9,0,0,0
2024-11-12 11:15,37,21,16,0,0,0
2024-11-12 11:30,37,19,18,0,0,0
2024-11-12 11:45,46,22,24,0,0,0
2024-11-12 12:00,44,18,26,0,0,0
2024-11-12 12:15,32,16,16,0,0,0
2024-11-12 12:30,51,17,34,0,0,0
2024-11-12 12:45,58,20,38,0,0,0
2024-11-12 13:00,71,21,50,0,0,0
2024-11-12 13:15,167,25,142,0,0,0
2024-11-12 13:30,70,29,41,0,0,0
2024-11-12 13:45,87,29,58,0,0,0
2024-11-12 14:00,77,31,46,0,0,0
2024-11-12 14:15,82,35,47,0,0,0
2024-11-12 14:30,71,34,37,0,0,0
2024-11-12 14:45,70,31,39,0,0,0
2024-11-12 15:00,59,25,34,0,0,0
2024-11-12 15:15,86,38,48,0,0,0
2024-11-12 15:30,86,33,53,0,0,0
2024-11-12 15:45,105,45,60,0,0,0
2024-11-12 16:00,84,29,55,0,0,0
2024-11-12 16:15,94,43,51,0,0,0
2024-11-12 16:30,95,38,57,0,0,0
2024-11-12 16:45,97,45,52,0,0,0
2024-11-12 17:00,91,34,57,0,0,0
2024-11-12 17:15,127,43,84,0,0,0
2024-11-12 17:30,79,26,53,0,0,0
2024-11-12 17:45,89,42,47,0,0,0
2024-11-12 18:00,69,33,36,0,0,0
2024-11-12 18:15,69,34,35,0,0,0
2024-11-12 18:30,46,21,25,0,0,0
2024-11-12 18:45,53,19,34,0,0,0
2024-11-12 19:00,46,14,32,0,0,0
2024-11-12 19:15,46,22,24,0,0,0
2024-11-12 19:30,36,10,26,0,0,0
2024-11-12 19:45,34,11,23,0,0,0
2024-11-12 20:00,32,9,23,0,0,0
2024-11-12 20:15,20,4,16,0,0,0
2024-11-12 20:30,15,6,9,0,0,0
2024-11-12 20:45,12,2,10,0,0,0
2024-11-12 21:00,18,7,11,0,0,0
2024-11-12 21:15,21,7,14,0,0,0
2024-11-12 21:30,24,8,16,0,0,0
2024-11-12 21:45,20,4,16,0,0,0
2024-11-12 22:00,15,7,8,0,0,0
2024-11-12 22:15,12,3,9,0,0,0
2024-11-12 22:30,26,11,15,0,0,0
2024-11-12 22:45,19,7,12,0,0,0
2024-11-12 23:00,4,1,3,0,0,0
2024-11-12 23:15,6,3,3,0,0,0
2024-11-12 23:30,11,3,8,0,0,0
2024-11-12 23:45,2,1,1,0,0,0
2024-11-13 00:00,1,1,0,0,0,0
2024-11-13 00:15,3,0,3,0,0,0
2024-11-13 00:30,1,0,1,0,0,0
2024-11-13 00:45,0,0,0,0,0,0
2024-11-13 01:00,0,0,0,0,0,0
2024-11-13 01:15,3,3,0,0,0,0
2024-11-13 01:30,3,2,1,0,0,0
2024-11-13 01:45,0,0,0,0,0,0
2024-11-13 02:00,0,0,0,0,0,0
2024-11-13 02:15,0,0,0,0,0,0
2024-11-13 02:30,0,0,0,0,0,0
2024-11-13 02:45,0,0,0,0,0,0
2024-11-13 03:00,0,0,0,0,0,0
2024-11-13 03:15,0,0,0,0,0,0
2024-11-13 03:30,0,0,0,0,0,0
2024-11-13 03:45,0,0,0,0,0,0
2024-11-13 04:00,0,0,0,0,0,0
2024-11-13 04:15,3,3,0,0,0,0
2024-11-13 04:30,1,0,1,0,0,0
2024-11-13 04:45,1,0,1,0,0,0
2024-11-13 05:00,13,6,7,0,0,0
2024-11-13 05:15,11,5,6,0,0,0
2024-11-13 05:30,18,11,7,0,0,0
2024-11-13 05:45,29,13,16,0,0,0
2024-11-13 06:00,22,15,7,0,0,0
2024-11-13 06:15,33,29,4,0,0,0
2024-11-13 06:30,41,24,17,0,0,0
2024-11-13 06:45,56,35,21,0,0,0
2024-11-13 07:00,73,50,23,0,0,0
2024-11-13 07:15,144,124,20,0,0,0
2024-11-13 07:30,253,222,31,0,0,0
2024-11-13 07:45,222,170,52,0,0,0
2024-11-13 08:00,139,103,36,0,0,0
2024-11-13 08:15,99,70,29,0,0,0
2024-11-13 08:30,111,84,27,0,0,0
2024-11-13 08:45,58,43,15,0,0,0
2024-11-13 09:00,43,30,13,0,0,0
2024-11-13 09:15,38,23,15,0,0,0
2024-11-13 09:30,77,62,15,0,0,0
2024-11-13 09:45,47,36,11,0,0,0
2024-11-13 10:00,54,32,22,0,0,0
2024-11-13 10:15,33,22,11,0,0,0
2024-11-13 10:30,47,29,18,0,0,0
2024-11-13 10:45,38,23,15,0,0,0
2024-11-13 11:00,30,20,10,0,0,0
2024-11-13 11:15,35,18,17,0,0,0
2024-11-13 11:30,40,23,17,0,0,0
2024-11-13 11:45,45,16,29,0,0,0
2024-11-13 12:00,46,19,27,0,0,0
2024-11-13 12:15,33,18,15,0,0,0
2024-11-13 12:30,47,15,32,0,0,0
2024-11-13 12:45,55,17,38,0,0,0
2024-11-13 13:00,65,26,39,0,0,0
2024-11-13 13:15,80,10,70,0,0,0
2024-11-13 13:30,54,20,34,0,0,0
2024-11-13 13:45,58,24,34,0,0,0
2024-11-13 14:00,88,24,64,0,0,0
2024-11-13 14:15,79,35,44,0,0,0
2024-11-13 14:30,77,32,45,0,0,0
2024-11-13 14:45,67,30,37,0,0,0
2024-11-13 15:00,77,15,62,0,0,0
2024-11-13 15:15,72,29,43,0,0,0
2024-11-13 15:30,81,19,62,0,0,0
2024-11-13 15:45,166,39,127,0,0,0
2024-11-13 16:00,127,27,100,0,0,0
2024-11-13 16:15,81,36,45,0,0,0
2024-11-13 16:30,99,42,57,0,0,0
2024-11-13 16:45,85,31,54,0,0,0
2024-11-13 17:00,86,31,55,0,0,0
2024-11-13 17:15,90,37,53,0,0,0
2024-11-13 17:30,72,32,40,0,0,0
2024-11-13 17:45,86,40,46,0,0,0
2024-11-13 18:00,70,29,41,0,0,0
2024-11-13 18:15,83,32,51,0,0,0
2024-11-13 18:30,54,24,30,0,0,0
2024-11-13 18:45,52,12,40,0,0,0
2024-11-13 19:00,39,15,24,0,0,0
2024-11-13 19:15,34,8,26,0,0,0
2024-11-13 19:30,30,13,17,0,0,0
2024-11-13 19:45,28,5,23,0,0,0
2024-11-13 20:00,31,13,18,0,0,0
2024-11-13 20:15,24,6,18,0,0,0
2024-11-13 20:30,11,7,4,0,0,0
2024-11-13 20:45,14,7,7,0,0,0
2024-11-13 21:00,18,9,9,0,0,0
2024-11-13 21:15,22,8,14,0,0,0
2024-11-13 21:30,19,6,13,0,0,0
2024-11-13 21:45,25,6,19,0,0,0
2024-11-13 22:00,19,5,14,0,0,0
2024-11-13 22:15,15,2,13,0,0,0
2024-11-13 22:30,15,9,6,0,0,0
2024-11-13 22:45,14,5,9,0,0,0
2024-11-13 23:00,14,3,11,0,0,0
2024-11-13 23:15,7,2,5,0,0,0
2024-11-13 23:30,5,0,5,0,0,0
2024-11-13 23:45,3,2,1,0,0,0
2024-11-14 00:00,7,1,6,0,0,0
2024-11-14 00:15,3,1,2,0,0,0
2024-11-14 00:30,7,2,5,0,0,0
2024-11-14 00:45,1,1,0,0,0,0
2024-11-14 01:00,2,0,2,0,0,0
2024-11-14 01:15,1,1,0,0,0,0
2024-11-14 01:30,2,0,2,0,0,0
2024-11-14 01:45,1,1,0,0,0,0
2024-11-14 02:00,0,0,0,0,0,0
2024-11-14 02:15,1,0,1,0,0,0
2024-11-14 02:30,0,0,0,0,0,0
2024-11-14 02:45,2,0,2,0,0,0
2024-11-14 03:00,1,0,1,0,0,0
2024-11-14 03:15,0,0,0,0,0,0
2024-11-14 03:30,1,0,1,0,0,0
2024-11-14 03:45,1,0,1,0,0,0
2024-11-14 04:00,1,1,0,0,0,0
2024-11-14 04:15,0,0,0,0,0,0
2024-11-14 04:30,0,0,0,0,0,0
2024-11-14 04:45,2,1,1,0,0,0
2024-11-14 05:00,9,2,7,0,0,0
2024-11-14 05:15,16,8,8,0,0,0
2024-11-14 05:30,16,6,10,0,0,0
2024-11-14 05:45,24,9,15,0,0,0
2024-11-14 06:00,19,11,8,0,0,0
2024-11-14 06:15,25,18,7,0,0,0
2024-11-14 06:30,32,18,14,0,0,0
2024-11-14 06:45,68,41,27,0,0,0
2024-11-14 07:00,72,44,28,0,0,0
2024-11-14 07:15,154,122,32,0,0,0
2024-11-14 07:30,266,225,41,0,0,0
2024-11-14 07:45,198,159,39,0,0,0
2024-11-14 08:00,116,76,40,0,0,0
2024-11-14 08:15,116,89,27,0,0,0
2024-11-14 08:30,93,69,24,0,0,0
2024-11-14 08:45,92,63,29,0,0,0
2024-11-14 09:00,53,39,14,0,0,0
2024-11-14 09:15,59,37,22,0,0,0
2024-11-14 09:30,64,43,21,0,0,0
2024-11-14 09:45,58,49,9,0,0,0
2024-11-14 10:00,45,26,19,0,0,0
2024-11-14 10:15,29,20,9,0,0,0
2024-11-14 10:30,42,29,13,0,0,0
2024-11-14 10:45,35,23,12,0,0,0
2024-11-14 11:00,30,12,18,0,0,0
2024-11-14 11:15,36,18,18,0,0,0
2024-11-14 11:30,39,19,20,0,0,0
2024-11-14 11:45,30,14,16,0,0,0
2024-11-14 12:00,32,14,18,0,0,0
2024-11-14 12:15,47,18,29,0,0,0
2024-11-14 12:30,64,19,45,0,0,0
2024-11-14 12:45,46,21,25,0,0,0
2024-11-14 13:00,66,24,42,0,0,0
2024-11-14 13:15,78,23,55,0,0,0
2024-11-14 13:30,58,15,43,0,0,0
2024-11-14 13:45,57,26,31,0,0,0
2024-11-14 14:00,60,17,43,0,0,0
2024-11-14 14:15,80,35,45,0,0,0
2024-11-14 14:30,67,29,38,0,0,0
2024-11-14 14:45,86,33,53,0,0,0
2024-11-14 15:00,66,25,41,0,0,0
2024-11-14 15:15,69,28,41,0,0,0
2024-11-14 15:30,72,23,49,0,0,0
2024-11-14 15:45,161,25,136,0,0,0
2024-11-14 16:00,127,38,89,0,0,0
2024-11-14 16:15,111,39,72,0,0,0
2024-11-14 16:30,77,36,41,0,0,0
2024-11-14 16:45,92,37,55,0,0,0
2024-11-14 17:00,77,27,50,0,0,0
2024-11-14 17:15,92,43,49,0,0,0
2024-11-14 17:30,79,26,53,0,0,0
2024-11-14 17:45,82,37,45,0,0,0
2024-11-14 18:00,88,31,57,0,0,0
2024-11-14 18:15,91,43,48,0,0,0
2024-11-14 18:30,63,30,33,0,0,0
2024-11-14 18:45,54,26,28,0,0,0
2024-11-14 19:00,45,13,32,0,0,0
2024-11-14 19:15,48,14,34,0,0,0
2024-11-14 19:30,36,8,28,0,0,0
2024-11-14 19:45,18,5,13,0,0,0
2024-11-14 20:00,25,8,17,0,0,0
2024-11-14 20:15,18,6,12,0,0,0
2024-11-14 20:30,18,3,15,0,0,0
2024-11-14 20:45,19,3,16,0,0,0
2024-11-14 21:00,19,7,12,0,0,0
2024-11-14 21:15,28,8,20,0,0,0
2024-11-14 21:30,24,7,17,0,0,0
2024-11-14 21:45,16,5,11,0,0,0
2024-11-14 22:00,18,6,12,0,0,0
2024-11-14 22:15,21,10,11,0,0,0
2024-11-14 22:30,21,11,10,0,0,0
2024-11-14 22:45,12,8,4,0,0,0
2024-11-14 23:00,4,0,4,0,0,0
2024-11-14 23:15,8,0,8,0,0,0
2024-11-14 23:30,5,3,2,0,0,0
2024-11-14 23:45,8,3,5,0,0,0
2024-11-15 00:00,7,2,5,0,0,0
2024-11-15 00:15,7,3,4,0,0,0
2024-11-15 00:30,0,0,0,0,0,0
2024-11-15 00:45,0,0,0,0,0,0
2024-11-15 01:00,3,0,3,0,0,0
2024-11-15 01:15,3,2,1,0,0,0
2024-11-15 01:30,0,0,0,0,0,0
2024-11-15 01:45,3,2,1,0,0,0
2024-11-15 02:00,1,0,1,0,0,0
2024-11-15 02:15,3,1,2,0,0,0
2024-11-15 02:30,0,0,0,0,0,0
2024-11-15 02:45,2,2,0,0,0,0
2024-11-15 03:00,1,1,0,0,0,0
2024-11-15 03:15,1,0,1,0,0,0
2024-11-15 03:30,0,0,0,0,0,0
2024-11-15 03:45,0,0,0,0,0,0
2024-11-15 04:00,0,0,0,0,0,0
2024-11-15 04:15,3,1,2,0,0,0
2024-11-15 04:30,1,0,1,0,0,0
2024-11-15 04:45,8,1,7,0,0,0
2024-11-15 05:00,8,3,5,0,0,0
2024-11-15 05:15,13,3,10,0,0,0
2024-11-15 05:30,19,8,11,0,0,0
2024-11-15 05:45,22,10,12,0,0,0
2024-11-15 06:00,15,8,7,0,0,0
2024-11-15 06:15,19,11,8,0,0,0
2024-11-15 06:30,32,22,10,0,0,0
2024-11-15 06:45,61,40,21,0,0,0
2024-11-15 07:00,65,43,22,0,0,0
2024-11-15 07:15,146,116,30,0,0,0
2024-11-15 07:30,245,209,36,0,0,0
2024-11-15 07:45,202,163,39,0,0,0
2024-11-15 08:00,88,65,23,0,0,0
2024-11-15 08:15,85,51,34,0,0,0
2024-11-15 08:30,91,74,17,0,0,0
2024-11-15 08:45,60,38,22,0,0,0
2024-11-15 09:00,49,26,23,0,0,0
2024-11-15 09:15,43,31,12,0,0,0
2024-11-15 09:30,50,38,12,0,0,0
2024-11-15 09:45,50,34,16,0,0,0
2024-11-15 10:00,32,23,9,0,0,0
2024-11-15 10:15,32,23,9,0,0,0
2024-11-15 10:30,34,19,15,0,0,0
2024-11-15 10:45,29,16,13,0,0,0
2024-11-15 11:00,32,14,18,0,0,0
2024-11-15 11:15,50,25,25,0,0,0
2024-11-15 11:30,40,18,22,0,0,0
2024-11-15 11:45,40,18,22,0,0,0
2024-11-15 12:00,52,18,34,0,0,0
2024-11-15 12:15,60,29,31,0,0,0
2024-11-15 12:30,81,33,48,0,0,0
2024-11-15 12:45,60,18,42,0,0,0
2024-11-15 13:00,81,26,55,0,0,0
2024-11-15 13:15,201,38,163,0,0,0
2024-11-15 13:30,98,33,65,0,0,0
2024-11-15 13:45,100,45,55,0,0,0
2024-11-15 14:00,75,28,47,0,0,0
2024-11-15 14:15,103,42,61,0,0,0
2024-11-15 14:30,75,28,47,0,0,0
2024-11-15 14:45,89,47,42,0,0,0
2024-11-15 15:00,112,38,74,0,0,0
2024-11-15 15:15,73,29,44,0,0,0
2024-11-15 15:30,82,30,52,0,0,0
2024-11-15 15:45,73,31,42,0,0,0
2024-11-15 16:00,67,22,45,0,0,0
2024-11-15 16:15,79,46,33,0,0,0
2024-11-15 16:30,67,34,33,0,0,0
2024-11-15 16:45,58,24,34,0,0,0
2024-11-15 17:00,63,27,36,0,0,0
2024-11-15 17:15,55,31,24,0,0,0
2024-11-15 17:30,45,20,25,0,0,0
2024-11-15 17:45,69,34,35,0,0,0
2024-11-15 18:00,56,28,28,0,0,0
2024-11-15 18:15,48,31,17,0,0,0
2024-11-15 18:30,59,32,27,0,0,0
2024-11-15 18:45,54,28,26,0,0,0
2024-11-15 19:00,38,20,18,0,0,0
2024-11-15 19:15,38,19,19,0,0,0
2024-11-15 19:30,32,20,12,0,0,0
2024-11-15 19:45,31,15,16,0,0,0
2024-11-15 20:00,19,9,10,0,0,0
2024-11-15 20:15,14,4,10,0,0,0
2024-11-15 20:30,15,8,7,0,0,0
2024-11-15 20:45,22,7,15,0,0,0
2024-11-15 21:00,15,5,10,0,0,0
2024-11-15 21:15,24,6,18,0,0,0
2024-11-15 21:30,24,7,17,0,0,0
2024-11-15 21:45,13,4,9,0,0,0
2024-11-15 22:00,9,6,3,0,0,0
2024-11-15 22:15,18,3,15,0,0,0
2024-11-15 22:30,21,9,12,0,0,0
2024-11-15 22:45,11,5,6,0,0,0
2024-11-15 23:00,13,4,9,0,0,0
2024-11-15 23:15,13,3,10,0,0,0
2024-11-15 23:30,14,3,11,0,0,0
2024-11-15 23:45,17,8,9,0,0,0
2024-11-16 00:00,10,5,5,0,0,0
2024-11-16 00:15,15,2,13,0,0,0
2024-11-16 00:30,13,4,9,0,0,0
2024-11-16 00:45,9,3,6,0,0,0
2024-11-16 01:00,9,0,9,0,0,0
2024-11-16 01:15,11,1,10,0,0,0
2024-11-16 01:30,10,2,8,0,0,0
2024-11-16 01:45,2,1,1,0,0,0
2024-11-16 02:00,5,0,5,0,0,0
2024-11-16 02:15,2,2,0,0,0,0
2024-11-16 02:30,9,3,6,0,0,0
2024-11-16 02:45,3,0,3,0,0,0
2024-11-16 03:00,0,0,0,0,0,0
2024-11-16 03:15,1,0,1,0,0,0
2024-11-16 03:30,0,0,0,0,0,0
2024-11-16 03:45,0,0,0,0,0,0
2024-11-16 04:00,2,0,2,0,0,0
2024-11-16 04:15,1,0,1,0,0,0
2024-11-16 04:30,1,0,1,0,0,0
2024-11-16 04:45,3,1,2,0,0,0
2024-11-16 05:00,1,1,0,0,0,0
2024-11-16 05:15,0,0,0,0,0,0
2024-11-16 05:30,7,4,3,0,0,0
2024-11-16 05:45,10,8,2,0,0,0
2024-11-16 06:00,2,2,0,0,0,0
2024-11-16 06:15,3,0,3,0,0,0
2024-11-16 06:30,6,3,3,0,0,0
2024-11-16 06:45,6,2,4,0,0,0
2024-11-16 07:00,7,7,0,0,0,0
2024-11-16 07:15,4,2,2,0,0,0
2024-11-16 07:30,10,3,7,0,0,0
2024-11-16 07:45,4,3,1,0,0,0
2024-11-16 08:00,10,6,4,0,0,0
2024-11-16 08:15,13,11,2,0,0,0
2024-11-16 08:30,13,8,5,0,0,0
2024-11-16 08:45,22,12,10,0,0,0
2024-11-16 09:00,21,15,6,0,0,0
2024-11-16 09:15,36,29,7,0,0,0
2024-11-16 09:30,46,35,11,0,0,0
2024-11-16 09:45,44,28,16,0,0,0
2024-11-16 10:00,33,28,5,0,0,0
2024-11-16 10:15,44,30,14,0,0,0
2024-11-16 10:30,52,31,21,0,0,0
2024-11-16 10:45,38,31,7,0,0,0
2024-11-16 11:00,35,16,19,0,0,0
2024-11-16 11:15,62,47,15,0,0,0
2024-11-16 11:30,44,22,22,0,0,0
2024-11-16 11:45,53,29,24,0,0,0
2024-11-16 12:00,57,32,25,0,0,0
2024-11-16 12:15,66,34,32,0,0,0
2024-11-16 12:30,79,41,38,0,0,0
2024-11-16 12:45,48,26,22,0,0,0
2024-11-16 13:00,51,32,19,0,0,0
2024-11-16 13:15,65,28,37,0,0,0
2024-11-16 13:30,44,24,20,0,0,0
2024-11-16 13:45,65,28,37,0,0,0
2024-11-16 14:00,49,14,35,0,0,0
2024-11-16 14:15,51,18,33,0,0,0
2024-11-16 14:30,59,19,40,0,0,0
2024-11-16 14:45,53,27,26,0,0,0
2024-11-16 15:00,39,13,26,0,0,0
2024-11-16 15:15,50,26,24,0,0,0
2024-11-16 15:30,33,12,21,0,0,0
2024-11-16 15:45,58,23,35,0,0,0
2024-11-16 16:00,54,27,27,0,0,0
2024-11-16 16:15,48,26,22,0,0,0
2024-11-16 16:30,39,19,20,0,0,0
2024-11-16 16:45,40,14,26,0,0,0
2024-11-16 17:00,47,17,30,0,0,0
2024-11-16 17:15,32,12,20,0,0,0
2024-11-16 17:30,50,19,31,0,0,0
2024-11-16 17:45,49,30,19,0,0,0
2024-11-16 18:00,37,18,19,0,0,0
2024-11-16 18:15,50,28,22,0,0,0
2024-11-16 18:30,27,14,13,0,0,0
2024-11-16 18:45,41,23,18,0,0,0
2024-11-16 19:00,40,19,21,0,0,0
2024-11-16 19:15,21,6,15,0,0,0
2024-11-16 19:30,21,15,6,0,0,0
2024-11-16 19:45,21,11,10,0,0,0
2024-11-16 20:00,31,19,12,0,0,0
2024-11-16 20:15,28,13,15,0,0,0
2024-11-16 20:30,19,7,12,0,0,0
2024-11-16 20:45,15,8,7,0,0,0
2024-11-16 21:00,11,7,4,0,0,0
2024-11-16 21:15,14,8,6,0,0,0
2024-11-16 21:30,11,6,5,0,0,0
2024-11-16 21:45,4,2,2,0,0,0
2024-11-16 22:00,10,3,7,0,0,0
2024-11-16 22:15,15,5,10,0,0,0
2024-11-16 22:30,13,5,8,0,0,0
2024-11-16 22:45,14,4,10,0,0,0
2024-11-16 23:00,27,5,22,0,0,0
2024-11-16 23:15,6,0,6,0,0,0
2024-11-16 23:30,13,6,7,0,0,0
2024-11-16 23:45,6,3,3,0,0,0
