Datetime,100034980 (Hammer Straße),101034980 (Hammer Straße stadteinwärts),102034980 (Hammer Straße stadtauswärts),100034980-status,101034980-status,102034980-status
2023-11-01 00:00,55,32,23,0,0,0
2023-11-01 00:15,39,16,23,0,0,0
2023-11-01 00:30,41,18,23,0,0,0
2023-11-01 00:45,38,11,27,0,0,0
2023-11-01 01:00,45,26,19,0,0,0
2023-11-01 01:15,43,14,29,0,0,0
2023-11-01 01:30,44,26,18,0,0,0
2023-11-01 01:45,40,16,24,0,0,0
2023-11-01 02:00,19,8,11,0,0,0
2023-11-01 02:15,40,16,24,0,0,0
2023-11-01 02:30,41,19,22,0,0,0
2023-11-01 02:45,29,14,15,0,0,0
2023-11-01 03:00,20,9,11,0,0,0
2023-11-01 03:15,28,11,17,0,0,0
2023-11-01 03:30,30,5,25,0,0,0
2023-11-01 03:45,26,10,16,0,0,0
2023-11-01 04:00,13,7,6,0,0,0
2023-11-01 04:15,20,8,12,0,0,0
2023-11-01 04:30,13,1,12,0,0,0
2023-11-01 04:45,9,5,4,0,0,0
2023-11-01 05:00,10,2,8,0,0,0
2023-11-01 05:15,8,0,8,0,0,0
2023-11-01 05:30,6,3,3,0,0,0
2023-11-01 05:45,4,1,3,0,0,0
2023-11-01 06:00,5,1,4,0,0,0
2023-11-01 06:15,2,1,1,0,0,0
2023-11-01 06:30,7,3,4,0,0,0
2023-11-01 06:45,7,4,3,0,0,0
2023-11-01 07:00,2,1,1,0,0,0
2023-11-01 07:15,2,1,1,0,0,0
2023-11-01 07:30,6,2,4,0,0,0
2023-11-01 07:45,4,2,2,0,0,0
2023-11-01 08:00,5,1,4,0,0,0
2023-11-01 08:15,5,3,2,0,0,0
2023-11-01 08:30,6,4,2,0,0,0
2023-11-01 08:45,27,18,9,0,0,0
2023-11-01 09:00,15,9,6,0,0,0
2023-11-01 09:15,17,10,7,0,0,0
2023-11-01 09:30,25,10,15,0,0,0
2023-11-01 09:45,28,19,9,0,0,0
2023-11-01 10:00,24,11,13,0,0,0
2023-11-01 10:15,35,19,16,0,0,0
2023-11-01 10:30,21,12,9,0,0,0
2023-11-01 10:45,42,29,13,0,0,0
2023-11-01 11:00,33,22,11,0,0,0
2023-11-01 11:15,46,33,13,0,0,0
2023-11-01 11:30,32,14,18,0,0,0
2023-11-01 11:45,54,35,19,0,0,0
2023-11-01 12:00,52,26,26,0,0,0
2023-11-01 12:15,59,27,32,0,0,0
2023-11-01 12:30,32,18,14,0,0,0
2023-11-01 12:45,53,24,29,0,0,0
2023-11-01 13:00,64,24,40,0,0,0
2023-11-01 13:15,56,31,25,0,0,0
2023-11-01 13:30,43,21,22,0,0,0
2023-11-01 13:45,57,23,34,0,0,0
2023-11-01 14:00,85,32,53,0,0,0
2023-11-01 14:15,73,33,40,0,0,0
2023-11-01 14:30,66,31,35,0,0,0
2023-11-01 14:45,92,44,48,0,0,0
2023-11-01 15:00,87,49,38,0,0,0
2023-11-01 15:15,88,33,55,0,0,0
2023-11-01 15:30,85,32,53,0,0,0
2023-11-01 15:45,65,32,33,0,0,0
2023-11-01 16:00,71,29,42,0,0,0
2023-11-01 16:15,67,30,37,0,0,0
2023-11-01 16:30,76,34,42,0,0,0
2023-11-01 16:45,77,30,47,0,0,0
2023-11-01 17:00,75,32,43,0,0,0
2023-11-01 17:15,60,21,39,0,0,0
2023-11-01 17:30,81,42,39,0,0,0
2023-11-01 17:45,88,35,53,0,0,0
2023-11-01 18:00,59,27,32,0,0,0
2023-11-01 18:15,57,21,36,0,0,0
2023-11-01 18:30,56,20,36,0,0,0
2023-11-01 18:45,60,24,36,0,0,0
2023-11-01 19:00,48,21,27,0,0,0
2023-11-01 19:15,40,20,20,0,0,0
2023-11-01 19:30,37,13,24,0,0,0
2023-11-01 19:45,46,27,19,0,0,0
2023-11-01 20:00,37,25,12,0,0,0
2023-11-01 20:15,25,8,17,0,0,0
2023-11-01 20:30,46,16,30,0,0,0
2023-11-01 20:45,34,10,24,0,0,0
2023-11-01 21:00,28,10,18,0,0,0
2023-11-01 21:15,33,10,23,0,0,0
2023-11-01 21:30,40,24,16,0,0,0
2023-11-01 21:45,40,17,23,0,0,0
2023-11-01 22:00,38,21,17,0,0,0
2023-11-01 22:15,32,10,22,0,0,0
2023-11-01 22:30,22,13,9,0,0,0
2023-11-01 22:45,21,10,11,0,0,0
2023-11-01 23:00,9,3,6,0,0,0
2023-11-01 23:15,13,5,8,0,0,0
2023-11-01 23:30,4,1,3,0,0,0
2023-11-01 23:45,9,2,7,0,0,0
2023-11-02 00:00,8,4,4,0,0,0
2023-11-02 00:15,5,0,5,0,0,0
2023-11-02 00:30,8,2,6,0,0,0
2023-11-02 00:45,5,1,4,0,0,0
2023-11-02 01:00,6,4,2,0,0,0
2023-11-02 01:15,2,1,1,0,0,0
2023-11-02 01:30,1,1,0,0,0,0
2023-11-02 01:45,0,0,0,0,0,0
2023-11-02 02:00,0,0,0,0,0,0
2023-11-02 02:15,0,0,0,0,0,0
2023-11-02 02:30,2,1,1,0,0,0
2023-11-02 02:45,0,0,0,0,0,0
2023-11-02 03:00,0,0,0,0,0,0
2023-11-02 03:15,0,0,0,0,0,0
2023-11-02 03:30,0,0,0,0,0,0
2023-11-02 03:45,1,0,1,0,0,0
2023-11-02 04:00,0,0,0,0,0,0
2023-11-02 04:15,1,1,0,0,0,0
2023-11-02 04:30,1,1,0,0,0,0
2023-11-02 04:45,3,3,0,0,0,0
2023-11-02 05:00,5,4,1,0,0,0
2023-11-02 05:15,5,4,1,0,0,0
2023-11-02 05:30,18,6,12,0,0,0
2023-11-02 05:45,16,7,9,0,0,0
2023-11-02 06:00,19,16,3,0,0,0
2023-11-02 06:15,32,24,8,0,0,0
2023-11-02 06:30,38,24,14,0,0,0
2023-11-02 06:45,61,34,27,0,0,0
2023-11-02 07:00,67,44,23,0,0,0
2023-11-02 07:15,97,63,34,0,0,0
2023-11-02 07:30,164,116,48,0,0,0
2023-11-02 07:45,169,120,49,0,0,0
2023-11-02 08:00,129,83,46,0,0,0
2023-11-02 08:15,151,99,52,0,0,0
2023-11-02 08:30,123,83,40,0,0,0
2023-11-02 08:45,146,104,42,0,0,0
2023-11-02 09:00,103,68,35,0,0,0
2023-11-02 09:15,80,44,36,0,0,0
2023-11-02 09:30,110,73,37,0,0,0
2023-11-02 09:45,122,85,37,0,0,0
2023-11-02 10:00,109,75,34,0,0,0
2023-11-02 10:15,101,63,38,0,0,0
2023-11-02 10:30,115,72,43,0,0,0
2023-11-02 10:45,113,62,51,0,0,0
2023-11-02 11:00,83,50,33,0,0,0
2023-11-02 11:15,125,52,73,0,0,0
2023-11-02 11:30,103,43,60,0,0,0
2023-11-02 11:45,123,66,57,0,0,0
2023-11-02 12:00,122,62,60,0,0,0
2023-11-02 12:15,122,57,65,0,0,0
2023-11-02 12:30,129,63,66,0,0,0
2023-11-02 12:45,114,62,52,0,0,0
2023-11-02 13:00,155,61,94,0,0,0
2023-11-02 13:15,130,60,70,0,0,0
2023-11-02 13:30,148,70,78,0,0,0
2023-11-02 13:45,169,88,81,0,0,0
2023-11-02 14:00,146,71,75,0,0,0
2023-11-02 14:15,135,49,86,0,0,0
2023-11-02 14:30,131,59,72,0,0,0
2023-11-02 14:45,161,81,80,0,0,0
2023-11-02 15:00,134,53,81,0,0,0
2023-11-02 15:15,147,73,74,0,0,0
2023-11-02 15:30,172,61,111,0,0,0
2023-11-02 15:45,206,89,117,0,0,0
2023-11-02 16:00,208,83,125,0,0,0
2023-11-02 16:15,205,97,108,0,0,0
2023-11-02 16:30,173,74,99,0,0,0
2023-11-02 16:45,155,62,93,0,0,0
2023-11-02 17:00,182,58,124,0,0,0
2023-11-02 17:15,177,62,115,0,0,0
2023-11-02 17:30,150,60,90,0,0,0
2023-11-02 17:45,144,60,84,0,0,0
2023-11-02 18:00,163,46,117,0,0,0
2023-11-02 18:15,148,68,80,0,0,0
2023-11-02 18:30,145,43,102,0,0,0
2023-11-02 18:45,127,50,77,0,0,0
2023-11-02 19:00,106,34,72,0,0,0
2023-11-02 19:15,82,28,54,0,0,0
2023-11-02 19:30,105,35,70,0,0,0
2023-11-02 19:45,84,29,55,0,0,0
2023-11-02 20:00,66,16,50,0,0,0
2023-11-02 20:15,67,17,50,0,0,0
2023-11-02 20:30,51,14,37,0,0,0
2023-11-02 20:45,42,18,24,0,0,0
2023-11-02 21:00,51,18,33,0,0,0
2023-11-02 21:15,44,16,28,0,0,0
2023-11-02 21:30,39,17,22,0,0,0
2023-11-02 21:45,50,20,30,0,0,0
2023-11-02 22:00,65,37,28,0,0,0
2023-11-02 22:15,52,18,34,0,0,0
2023-11-02 22:30,35,8,27,0,0,0
2023-11-02 22:45,37,10,27,0,0,0
2023-11-02 23:00,29,9,20,0,0,0
2023-11-02 23:15,20,7,13,0,0,0
2023-11-02 23:30,19,7,12,0,0,0
2023-11-02 23:45,19,8,11,0,0,0
2023-11-03 00:00,15,2,13,0,0,0
2023-11-03 00:15,4,0,4,0,0,0
2023-11-03 00:30,6,2,4,0,0,0
2023-11-03 00:45,14,2,12,0,0,0
2023-11-03 01:00,3,0,3,0,0,0
2023-11-03 01:15,5,3,2,0,0,0
2023-11-03 01:30,1,0,1,0,0,0
2023-11-03 01:45,0,0,0,0,0,0
2023-11-03 02:00,2,0,2,0,0,0
2023-11-03 02:15,0,0,0,0,0,0
2023-11-03 02:30,4,0,4,0,0,0
2023-11-03 02:45,0,0,0,0,0,0
2023-11-03 03:00,1,0,1,0,0,0
2023-11-03 03:15,0,0,0,0,0,0
2023-11-03 03:30,0,0,0,0,0,0
2023-11-03 03:45,0,0,0,0,0,0
2023-11-03 04:00,2,1,1,0,0,0
2023-11-03 04:15,2,2,0,0,0,0
2023-11-03 04:30,0,0,0,0,0,0
2023-11-03 04:45,2,2,0,0,0,0
2023-11-03 05:00,2,2,0,0,0,0
2023-11-03 05:15,6,3,3,0,0,0
2023-11-03 05:30,14,9,5,0,0,0
2023-11-03 05:45,12,7,5,0,0,0
2023-11-03 06:00,31,20,11,0,0,0
2023-11-03 06:15,23,17,6,0,0,0
2023-11-03 06:30,40,23,17,0,0,0
2023-11-03 06:45,54,29,25,0,0,0
2023-11-03 07:00,58,36,22,0,0,0
2023-11-03 07:15,102,65,37,0,0,0
2023-11-03 07:30,141,93,48,0,0,0
2023-11-03 07:45,190,117,73,0,0,0
2023-11-03 08:00,137,92,45,0,0,0
2023-11-03 08:15,123,83,40,0,0,0
2023-11-03 08:30,112,72,40,0,0,0
2023-11-03 08:45,137,93,44,0,0,0
2023-11-03 09:00,79,52,27,0,0,0
2023-11-03 09:15,97,64,33,0,0,0
2023-11-03 09:30,106,71,35,0,0,0
2023-11-03 09:45,124,84,40,0,0,0
2023-11-03 10:00,82,57,25,0,0,0
2023-11-03 10:15,91,50,41,0,0,0
2023-11-03 10:30,88,48,40,0,0,0
2023-11-03 10:45,114,69,45,0,0,0
2023-11-03 11:00,107,47,60,0,0,0
2023-11-03 11:15,101,43,58,0,0,0
2023-11-03 11:30,99,44,55,0,0,0
2023-11-03 11:45,123,63,60,0,0,0
2023-11-03 12:00,112,41,71,0,0,0
2023-11-03 12:15,132,53,79,0,0,0
2023-11-03 12:30,118,61,57,0,0,0
2023-11-03 12:45,156,67,89,0,0,0
2023-11-03 13:00,143,50,93,0,0,0
2023-11-03 13:15,157,77,80,0,0,0
2023-11-03 13:30,155,55,100,0,0,0
2023-11-03 13:45,195,97,98,0,0,0
2023-11-03 14:00,167,70,97,0,0,0
2023-11-03 14:15,156,63,93,0,0,0
2023-11-03 14:30,172,82,90,0,0,0
2023-11-03 14:45,192,80,112,0,0,0
2023-11-03 15:00,151,52,99,0,0,0
2023-11-03 15:15,185,78,107,0,0,0
2023-11-03 15:30,147,67,80,0,0,0
2023-11-03 15:45,200,105,95,0,0,0
2023-11-03 16:00,177,79,98,0,0,0
2023-11-03 16:15,191,78,113,0,0,0
2023-11-03 16:30,193,77,116,0,0,0
2023-11-03 16:45,156,56,100,0,0,0
2023-11-03 17:00,173,60,113,0,0,0
2023-11-03 17:15,138,56,82,0,0,0
2023-11-03 17:30,155,55,100,0,0,0
2023-11-03 17:45,116,57,59,0,0,0
2023-11-03 18:00,153,47,106,0,0,0
2023-11-03 18:15,138,49,89,0,0,0
2023-11-03 18:30,122,44,78,0,0,0
2023-11-03 18:45,146,67,79,0,0,0
2023-11-03 19:00,110,31,79,0,0,0
2023-11-03 19:15,116,50,66,0,0,0
2023-11-03 19:30,108,45,63,0,0,0
2023-11-03 19:45,100,48,52,0,0,0
2023-11-03 20:00,106,45,61,0,0,0
2023-11-03 20:15,94,48,46,0,0,0
2023-11-03 20:30,66,34,32,0,0,0
2023-11-03 20:45,72,34,38,0,0,0
2023-11-03 21:00,58,24,34,0,0,0
2023-11-03 21:15,42,13,29,0,0,0
2023-11-03 21:30,31,11,20,0,0,0
2023-11-03 21:45,51,14,37,0,0,0
2023-11-03 22:00,54,21,33,0,0,0
2023-11-03 22:15,36,11,25,0,0,0
2023-11-03 22:30,61,14,47,0,0,0
2023-11-03 22:45,61,35,26,0,0,0
2023-11-03 23:00,63,34,29,0,0,0
2023-11-03 23:15,90,45,45,0,0,0
2023-11-03 23:30,47,22,25,0,0,0
2023-11-03 23:45,45,13,32,0,0,0
2023-11-04 00:00,44,17,27,0,0,0
2023-11-04 00:15,40,18,22,0,0,0
2023-11-04 00:30,37,6,31,0,0,0
2023-11-04 00:45,40,20,20,0,0,0
2023-11-04 01:00,19,5,14,0,0,0
2023-11-04 01:15,18,7,11,0,0,0
2023-11-04 01:30,17,4,13,0,0,0
2023-11-04 01:45,15,3,12,0,0,0
2023-11-04 02:00,5,2,3,0,0,0
2023-11-04 02:15,13,1,12,0,0,0
2023-11-04 02:30,8,1,7,0,0,0
2023-11-04 02:45,7,2,5,0,0,0
2023-11-04 03:00,7,3,4,0,0,0
2023-11-04 03:15,5,1,4,0,0,0
2023-11-04 03:30,15,4,11,0,0,0
2023-11-04 03:45,1,1,0,0,0,0
2023-11-04 04:00,10,1,9,0,0,0
2023-11-04 04:15,5,1,4,0,0,0
2023-11-04 04:30,2,2,0,0,0,0
2023-11-04 04:45,1,0,1,0,0,0
2023-11-04 05:00,6,3,3,0,0,0
2023-11-04 05:15,6,0,6,0,0,0
2023-11-04 05:30,8,6,2,0,0,0
2023-11-04 05:45,8,5,3,0,0,0
2023-11-04 06:00,11,9,2,0,0,0
2023-11-04 06:15,16,6,10,0,0,0
2023-11-04 06:30,7,5,2,0,0,0
2023-11-04 06:45,15,8,7,0,0,0
2023-11-04 07:00,6,5,1,0,0,0
2023-11-04 07:15,9,3,6,0,0,0
2023-11-04 07:30,25,11,14,0,0,0
2023-11-04 07:45,24,10,14,0,0,0
2023-11-04 08:00,26,18,8,0,0,0
2023-11-04 08:15,46,33,13,0,0,0
2023-11-04 08:30,35,20,15,0,0,0
2023-11-04 08:45,66,48,18,0,0,0
2023-11-04 09:00,41,22,19,0,0,0
2023-11-04 09:15,65,48,17,0,0,0
2023-11-04 09:30,83,57,26,0,0,0
2023-11-04 09:45,126,89,37,0,0,0
2023-11-04 10:00,116,81,35,0,0,0
2023-11-04 10:15,96,65,31,0,0,0
2023-11-04 10:30,121,78,43,0,0,0
2023-11-04 10:45,150,100,50,0,0,0
2023-11-04 11:00,148,94,54,0,0,0
2023-11-04 11:15,189,98,91,0,0,0
2023-11-04 11:30,133,82,51,0,0,0
2023-11-04 11:45,181,113,68,0,0,0
2023-11-04 12:00,162,80,82,0,0,0
2023-11-04 12:15,136,64,72,0,0,0
2023-11-04 12:30,138,75,63,0,0,0
2023-11-04 12:45,158,82,76,0,0,0
2023-11-04 13:00,159,72,87,0,0,0
2023-11-04 13:15,158,71,87,0,0,0
2023-11-04 13:30,139,54,85,0,0,0
2023-11-04 13:45,173,73,100,0,0,0
2023-11-04 14:00,128,43,85,0,0,0
2023-11-04 14:15,130,44,86,0,0,0
2023-11-04 14:30,97,38,59,0,0,0
2023-11-04 14:45,116,54,62,0,0,0
2023-11-04 15:00,88,23,65,0,0,0
2023-11-04 15:15,64,22,42,0,0,0
2023-11-04 15:30,82,34,48,0,0,0
2023-11-04 15:45,88,34,54,0,0,0
2023-11-04 16:00,66,15,51,0,0,0
2023-11-04 16:15,77,28,49,0,0,0
2023-11-04 16:30,84,33,51,0,0,0
2023-11-04 16:45,60,22,38,0,0,0
2023-11-04 17:00,66,19,47,0,0,0
2023-11-04 17:15,66,31,35,0,0,0
2023-11-04 17:30,69,19,50,0,0,0
2023-11-04 17:45,71,20,51,0,0,0
2023-11-04 18:00,64,20,44,0,0,0
2023-11-04 18:15,93,29,64,0,0,0
2023-11-04 18:30,63,28,35,0,0,0
2023-11-04 18:45,72,28,44,0,0,0
2023-11-04 19:00,86,37,49,0,0,0
2023-11-04 19:15,55,23,32,0,0,0
2023-11-04 19:30,45,16,29,0,0,0
2023-11-04 19:45,40,17,23,0,0,0
2023-11-04 20:00,53,28,25,0,0,0
2023-11-04 20:15,41,18,23,0,0,0
2023-11-04 20:30,43,15,28,0,0,0
2023-11-04 20:45,43,21,22,0,0,0
2023-11-04 21:00,36,18,18,0,0,0
2023-11-04 21:15,32,12,20,0,0,0
2023-11-04 21:30,31,13,18,0,0,0
2023-11-04 21:45,46,17,29,0,0,0
2023-11-04 22:00,41,19,22,0,0,0
2023-11-04 22:15,42,16,26,0,0,0
2023-11-04 22:30,31,12,19,0,0,0
2023-11-04 22:45,21,8,13,0,0,0
2023-11-04 23:00,32,7,25,0,0,0
2023-11-04 23:15,33,13,20,0,0,0
2023-11-04 23:30,20,8,12,0,0,0
2023-11-04 23:45,14,3,11,0,0,0
2023-11-05 00:00,18,8,10,0,0,0
2023-11-05 00:15,39,12,27,0,0,0
2023-11-05 00:30,24,8,16,0,0,0
2023-11-05 00:45,28,11,17,0,0,0
2023-11-05 01:00,20,8,12,0,0,0
2023-11-05 01:15,25,13,12,0,0,0
2023-11-05 01:30,11,2,9,0,0,0
2023-11-05 01:45,17,5,12,0,0,0
2023-11-05 02:00,17,7,10,0,0,0
2023-11-05 02:15,25,9,16,0,0,0
2023-11-05 02:30,13,4,9,0,0,0
2023-11-05 02:45,9,2,7,0,0,0
2023-11-05 03:00,17,7,10,0,0,0
2023-11-05 03:15,6,2,4,0,0,0
2023-11-05 03:30,7,3,4,0,0,0
2023-11-05 03:45,9,7,2,0,0,0
2023-11-05 04:00,8,2,6,0,0,0
2023-11-05 04:15,3,0,3,0,0,0
2023-11-05 04:30,2,1,1,0,0,0
2023-11-05 04:45,1,0,1,0,0,0
2023-11-05 05:00,4,0,4,0,0,0
2023-11-05 05:15,0,0,0,0,0,0
2023-11-05 05:30,8,4,4,0,0,0
2023-11-05 05:45,2,1,1,0,0,0
2023-11-05 06:00,6,4,2,0,0,0
2023-11-05 06:15,8,4,4,0,0,0
2023-11-05 06:30,4,2,2,0,0,0
2023-11-05 06:45,6,4,2,0,0,0
2023-11-05 07:00,4,0,4,0,0,0
2023-11-05 07:15,4,2,2,0,0,0
2023-11-05 07:30,6,5,1,0,0,0
2023-11-05 07:45,8,3,5,0,0,0
2023-11-05 08:00,4,2,2,0,0,0
2023-11-05 08:15,4,1,3,0,0,0
2023-11-05 08:30,8,5,3,0,0,0
2023-11-05 08:45,11,8,3,0,0,0
2023-11-05 09:00,15,11,4,0,0,0
2023-11-05 09:15,15,9,6,0,0,0
2023-11-05 09:30,23,11,12,0,0,0
2023-11-05 09:45,46,27,19,0,0,0
2023-11-05 10:00,31,21,10,0,0,0
2023-11-05 10:15,28,14,14,0,0,0
2023-11-05 10:30,25,17,8,0,0,0
2023-11-05 10:45,27,17,10,0,0,0
2023-11-05 11:00,26,18,8,0,0,0
2023-11-05 11:15,32,18,14,0,0,0
2023-11-05 11:30,39,19,20,0,0,0
2023-11-05 11:45,43,27,16,0,0,0
2023-11-05 12:00,29,16,13,0,0,0
2023-11-05 12:15,44,28,16,0,0,0
2023-11-05 12:30,39,18,21,0,0,0
2023-11-05 12:45,36,19,17,0,0,0
2023-11-05 13:00,47,17,30,0,0,0
2023-11-05 13:15,62,28,34,0,0,0
2023-11-05 13:30,43,27,16,0,0,0
2023-11-05 13:45,44,25,19,0,0,0
2023-11-05 14:00,29,10,19,0,0,0
2023-11-05 14:15,36,15,21,0,0,0
2023-11-05 14:30,44,15,29,0,0,0
2023-11-05 14:45,70,25,45,0,0,0
2023-11-05 15:00,64,19,45,0,0,0
2023-11-05 15:15,86,26,60,0,0,0
2023-11-05 15:30,87,14,73,0,0,0
2023-11-05 15:45,112,20,92,0,0,0
2023-11-05 16:00,79,20,59,0,0,0
2023-11-05 16:15,57,20,37,0,0,0
2023-11-05 16:30,35,14,21,0,0,0
2023-11-05 16:45,29,12,17,0,0,0
2023-11-05 17:00,38,17,21,0,0,0
2023-11-05 17:15,36,20,16,0,0,0
2023-11-05 17:30,36,21,15,0,0,0
2023-11-05 17:45,41,27,14,0,0,0
2023-11-05 18:00,40,9,31,0,0,0
2023-11-05 18:15,38,21,17,0,0,0
2023-11-05 18:30,96,81,15,0,0,0
2023-11-05 18:45,156,137,19,0,0,0
2023-11-05 19:00,43,28,15,0,0,0
2023-11-05 19:15,33,23,10,0,0,0
2023-11-05 19:30,37,21,16,0,0,0
2023-11-05 19:45,39,18,21,0,0,0
2023-11-05 20:00,41,18,23,0,0,0
2023-11-05 20:15,30,17,13,0,0,0
2023-11-05 20:30,26,14,12,0,0,0
2023-11-05 20:45,25,14,11,0,0,0
2023-11-05 21:00,16,4,12,0,0,0
2023-11-05 21:15,15,4,11,0,0,0
2023-11-05 21:30,26,5,21,0,0,0
2023-11-05 21:45,17,8,9,0,0,0
2023-11-05 22:00,23,6,17,0,0,0
2023-11-05 22:15,13,5,8,0,0,0
2023-11-05 22:30,16,1,15,0,0,0
2023-11-05 22:45,11,5,6,0,0,0
2023-11-05 23:00,15,6,9,0,0,0
2023-11-05 23:15,7,4,3,0,0,0
2023-11-05 23:30,6,3,3,0,0,0
2023-11-05 23:45,2,0,2,0,0,0
2023-11-06 00:00,2,1,1,0,0,0
2023-11-06 00:15,6,1,5,0,0,0
2023-11-06 00:30,1,0,1,0,0,0
2023-11-06 00:45,6,3,3,0,0,0
2023-11-06 01:00,2,2,0,0,0,0
2023-11-06 01:15,3,1,2,0,0,0
2023-11-06 01:30,1,0,1,0,0,0
2023-11-06 01:45,1,1,0,0,0,0
2023-11-06 02:00,0,0,0,0,0,0
2023-11-06 02:15,0,0,0,0,0,0
2023-11-06 02:30,2,0,2,0,0,0
2023-11-06 02:45,0,0,0,0,0,0
2023-11-06 03:00,1,0,1,0,0,0
2023-11-06 03:15,0,0,0,0,0,0
2023-11-06 03:30,1,1,0,0,0,0
2023-11-06 03:45,0,0,0,0,0,0
2023-11-06 04:00,1,1,0,0,0,0
2023-11-06 04:15,0,0,0,0,0,0
2023-11-06 04:30,0,0,0,0,0,0
2023-11-06 04:45,2,2,0,0,0,0
2023-11-06 05:00,5,5,0,0,0,0
2023-11-06 05:15,4,4,0,0,0,0
2023-11-06 05:30,12,6,6,0,0,0
2023-11-06 05:45,18,11,7,0,0,0
2023-11-06 06:00,25,19,6,0,0,0
2023-11-06 06:15,26,20,6,0,0,0
2023-11-06 06:30,47,32,15,0,0,0
2023-11-06 06:45,59,33,26,0,0,0
2023-11-06 07:00,91,52,39,0,0,0
2023-11-06 07:15,134,91,43,0,0,0
2023-11-06 07:30,166,110,56,0,0,0
2023-11-06 07:45,203,142,61,0,0,0
2023-11-06 08:00,112,77,35,0,0,0
2023-11-06 08:15,151,107,44,0,0,0
2023-11-06 08:30,114,76,38,0,0,0
2023-11-06 08:45,137,89,48,0,0,0
2023-11-06 09:00,97,64,33,0,0,0
2023-11-06 09:15,95,61,34,0,0,0
2023-11-06 09:30,125,93,32,0,0,0
2023-11-06 09:45,149,110,39,0,0,0
2023-11-06 10:00,104,61,43,0,0,0
2023-11-06 10:15,96,52,44,0,0,0
2023-11-06 10:30,95,45,50,0,0,0
2023-11-06 10:45,115,66,49,0,0,0
2023-11-06 11:00,104,49,55,0,0,0
2023-11-06 11:15,107,54,53,0,0,0
2023-11-06 11:30,121,53,68,0,0,0
2023-11-06 11:45,147,73,74,0,0,0
2023-11-06 12:00,140,75,65,0,0,0
2023-11-06 12:15,123,57,66,0,0,0
2023-11-06 12:30,102,39,63,0,0,0
2023-11-06 12:45,144,68,76,0,0,0
2023-11-06 13:00,132,45,87,0,0,0
2023-11-06 13:15,113,49,64,0,0,0
2023-11-06 13:30,128,54,74,0,0,0
2023-11-06 13:45,149,76,73,0,0,0
2023-11-06 14:00,144,65,79,0,0,0
2023-11-06 14:15,146,67,79,0,0,0
2023-11-06 14:30,132,67,65,0,0,0
2023-11-06 14:45,191,90,101,0,0,0
2023-11-06 15:00,146,65,81,0,0,0
2023-11-06 15:15,155,65,90,0,0,0
2023-11-06 15:30,144,54,90,0,0,0
2023-11-06 15:45,190,84,106,0,0,0
2023-11-06 16:00,197,81,116,0,0,0
2023-11-06 16:15,185,73,112,0,0,0
2023-11-06 16:30,182,71,111,0,0,0
2023-11-06 16:45,192,63,129,0,0,0
2023-11-06 17:00,180,60,120,0,0,0
2023-11-06 17:15,147,49,98,0,0,0
2023-11-06 17:30,151,44,107,0,0,0
2023-11-06 17:45,164,57,107,0,0,0
2023-11-06 18:00,179,59,120,0,0,0
2023-11-06 18:15,121,38,83,0,0,0
2023-11-06 18:30,121,41,80,0,0,0
2023-11-06 18:45,119,42,77,0,0,0
2023-11-06 19:00,99,30,69,0,0,0
2023-11-06 19:15,95,34,61,0,0,0
2023-11-06 19:30,86,26,60,0,0,0
2023-11-06 19:45,105,45,60,0,0,0
2023-11-06 20:00,61,24,37,0,0,0
2023-11-06 20:15,59,21,38,0,0,0
2023-11-06 20:30,34,9,25,0,0,0
2023-11-06 20:45,36,12,24,0,0,0
2023-11-06 21:00,52,18,34,0,0,0
2023-11-06 21:15,50,17,33,0,0,0
2023-11-06 21:30,45,11,34,0,0,0
2023-11-06 21:45,55,18,37,0,0,0
2023-11-06 22:00,49,13,36,0,0,0
2023-11-06 22:15,54,19,35,0,0,0
2023-11-06 22:30,45,13,32,0,0,0
2023-11-06 22:45,19,7,12,0,0,0
2023-11-06 23:00,21,10,11,0,0,0
2023-11-06 23:15,25,11,14,0,0,0
2023-11-06 23:30,9,2,7,0,0,0
2023-11-06 23:45,9,5,4,0,0,0
2023-11-07 00:00,10,3,7,0,0,0
2023-11-07 00:15,10,2,8,0,0,0
2023-11-07 00:30,12,5,7,0,0,0
2023-11-07 00:45,5,0,5,0,0,0
2023-11-07 01:00,2,0,2,0,0,0
2023-11-07 01:15,4,2,2,0,0,0
2023-11-07 01:30,4,0,4,0,0,0
2023-11-07 01:45,4,1,3,0,0,0
2023-11-07 02:00,1,1,0,0,0,0
2023-11-07 02:15,1,0,1,0,0,0
2023-11-07 02:30,3,0,3,0,0,0
2023-11-07 02:45,2,2,0,0,0,0
2023-11-07 03:00,0,0,0,0,0,0
2023-11-07 03:15,0,0,0,0,0,0
2023-11-07 03:30,0,0,0,0,0,0
2023-11-07 03:45,1,1,0,0,0,0
2023-11-07 04:00,2,1,1,0,0,0
2023-11-07 04:15,1,1,0,0,0,0
2023-11-07 04:30,4,4,0,0,0,0
2023-11-07 04:45,3,3,0,0,0,0
2023-11-07 05:00,5,5,0,0,0,0
2023-11-07 05:15,5,3,2,0,0,0
2023-11-07 05:30,16,5,11,0,0,0
2023-11-07 05:45,17,11,6,0,0,0
2023-11-07 06:00,32,24,8,0,0,0
2023-11-07 06:15,42,34,8,0,0,0
2023-11-07 06:30,49,33,16,0,0,0
2023-11-07 06:45,64,37,27,0,0,0
2023-11-07 07:00,72,47,25,0,0,0
2023-11-07 07:15,126,79,47,0,0,0
2023-11-07 07:30,181,109,72,0,0,0
2023-11-07 07:45,230,136,94,0,0,0
2023-11-07 08:00,169,119,50,0,0,0
2023-11-07 08:15,163,105,58,0,0,0
2023-11-07 08:30,152,90,62,0,0,0
2023-11-07 08:45,132,89,43,0,0,0
2023-11-07 09:00,97,56,41,0,0,0
2023-11-07 09:15,94,65,29,0,0,0
2023-11-07 09:30,122,78,44,0,0,0
2023-11-07 09:45,166,101,65,0,0,0
2023-11-07 10:00,115,74,41,0,0,0
2023-11-07 10:15,82,40,42,0,0,0
2023-11-07 10:30,103,56,47,0,0,0
2023-11-07 10:45,88,46,42,0,0,0
2023-11-07 11:00,90,50,40,0,0,0
2023-11-07 11:15,77,29,48,0,0,0
2023-11-07 11:30,89,47,42,0,0,0
2023-11-07 11:45,125,55,70,0,0,0
2023-11-07 12:00,144,72,72,0,0,0
2023-11-07 12:15,128,55,73,0,0,0
2023-11-07 12:30,113,44,69,0,0,0
2023-11-07 12:45,138,64,74,0,0,0
2023-11-07 13:00,143,55,88,0,0,0
2023-11-07 13:15,128,54,74,0,0,0
2023-11-07 13:30,134,59,75,0,0,0
2023-11-07 13:45,164,88,76,0,0,0
2023-11-07 14:00,142,73,69,0,0,0
2023-11-07 14:15,136,66,70,0,0,0
2023-11-07 14:30,145,66,79,0,0,0
2023-11-07 14:45,168,86,82,0,0,0
2023-11-07 15:00,152,63,89,0,0,0
2023-11-07 15:15,169,73,96,0,0,0
2023-11-07 15:30,176,67,109,0,0,0
2023-11-07 15:45,183,89,94,0,0,0
2023-11-07 16:00,200,84,116,0,0,0
2023-11-07 16:15,206,80,126,0,0,0
2023-11-07 16:30,199,80,119,0,0,0
2023-11-07 16:45,218,98,120,0,0,0
2023-11-07 17:00,182,67,115,0,0,0
2023-11-07 17:15,203,80,123,0,0,0
2023-11-07 17:30,182,62,120,0,0,0
2023-11-07 17:45,216,82,134,0,0,0
2023-11-07 18:00,206,65,141,0,0,0
2023-11-07 18:15,179,67,112,0,0,0
2023-11-07 18:30,156,70,86,0,0,0
2023-11-07 18:45,146,72,74,0,0,0
2023-11-07 19:00,131,48,83,0,0,0
2023-11-07 19:15,93,40,53,0,0,0
2023-11-07 19:30,98,32,66,0,0,0
2023-11-07 19:45,103,35,68,0,0,0
2023-11-07 20:00,84,27,57,0,0,0
2023-11-07 20:15,75,22,53,0,0,0
2023-11-07 20:30,38,12,26,0,0,0
2023-11-07 20:45,73,26,47,0,0,0
2023-11-07 21:00,51,9,42,0,0,0
2023-11-07 21:15,60,13,47,0,0,0
2023-11-07 21:30,49,15,34,0,0,0
2023-11-07 21:45,55,13,42,0,0,0
2023-11-07 22:00,60,18,42,0,0,0
2023-11-07 22:15,58,17,41,0,0,0
2023-11-07 22:30,47,16,31,0,0,0
2023-11-07 22:45,41,7,34,0,0,0
2023-11-07 23:00,49,13,36,0,0,0
2023-11-07 23:15,20,1,19,0,0,0
2023-11-07 23:30,19,7,12,0,0,0
2023-11-07 23:45,17,6,11,0,0,0
2023-11-08 00:00,10,2,8,0,0,0
2023-11-08 00:15,15,6,9,0,0,0
2023-11-08 00:30,10,5,5,0,0,0
2023-11-08 00:45,14,2,12,0,0,0
2023-11-08 01:00,5,1,4,0,0,0
2023-11-08 01:15,5,2,3,0,0,0
2023-11-08 01:30,3,1,2,0,0,0
2023-11-08 01:45,2,0,2,0,0,0
2023-11-08 02:00,3,2,1,0,0,0
2023-11-08 02:15,1,0,1,0,0,0
2023-11-08 02:30,2,0,2,0,0,0
2023-11-08 02:45,1,0,1,0,0,0
2023-11-08 03:00,0,0,0,0,0,0
2023-11-08 03:15,0,0,0,0,0,0
2023-11-08 03:30,3,1,2,0,0,0
2023-11-08 03:45,0,0,0,0,0,0
2023-11-08 04:00,0,0,0,0,0,0
2023-11-08 04:15,1,1,0,0,0,0
2023-11-08 04:30,0,0,0,0,0,0
2023-11-08 04:45,4,4,0,0,0,0
2023-11-08 05:00,4,4,0,0,0,0
2023-11-08 05:15,7,2,5,0,0,0
2023-11-08 05:30,13,9,4,0,0,0
2023-11-08 05:45,15,11,4,0,0,0
2023-11-08 06:00,24,14,10,0,0,0
2023-11-08 06:15,37,27,10,0,0,0
2023-11-08 06:30,45,30,15,0,0,0
2023-11-08 06:45,68,33,35,0,0,0
2023-11-08 07:00,80,51,29,0,0,0
2023-11-08 07:15,101,62,39,0,0,0
2023-11-08 07:30,182,112,70,0,0,0
2023-11-08 07:45,195,136,59,0,0,0
2023-11-08 08:00,205,136,69,0,0,0
2023-11-08 08:15,177,115,62,0,0,0
2023-11-08 08:30,133,99,34,0,0,0
2023-11-08 08:45,147,91,56,0,0,0
2023-11-08 09:00,126,79,47,0,0,0
2023-11-08 09:15,111,74,37,0,0,0
2023-11-08 09:30,91,64,27,0,0,0
2023-11-08 09:45,155,111,44,0,0,0
2023-11-08 10:00,121,74,47,0,0,0
2023-11-08 10:15,120,76,44,0,0,0
2023-11-08 10:30,101,57,44,0,0,0
2023-11-08 10:45,130,76,54,0,0,0
2023-11-08 11:00,113,65,48,0,0,0
2023-11-08 11:15,126,56,70,0,0,0
2023-11-08 11:30,138,73,65,0,0,0
2023-11-08 11:45,171,78,93,0,0,0
2023-11-08 12:00,166,84,82,0,0,0
2023-11-08 12:15,163,72,91,0,0,0
2023-11-08 12:30,136,50,86,0,0,0
2023-11-08 12:45,176,77,99,0,0,0
2023-11-08 13:00,143,53,90,0,0,0
2023-11-08 13:15,151,57,94,0,0,0
2023-11-08 13:30,141,49,92,0,0,0
2023-11-08 13:45,203,89,114,0,0,0
2023-11-08 14:00,152,65,87,0,0,0
2023-11-08 14:15,162,69,93,0,0,0
2023-11-08 14:30,164,70,94,0,0,0
2023-11-08 14:45,162,83,79,0,0,0
2023-11-08 15:00,156,67,89,0,0,0
2023-11-08 15:15,175,79,96,0,0,0
2023-11-08 15:30,178,81,97,0,0,0
2023-11-08 15:45,218,76,142,0,0,0
2023-11-08 16:00,218,86,132,0,0,0
2023-11-08 16:15,159,65,94,0,0,0
2023-11-08 16:30,144,43,101,0,0,0
2023-11-08 16:45,181,70,111,0,0,0
2023-11-08 17:00,179,56,123,0,0,0
2023-11-08 17:15,165,55,110,0,0,0
2023-11-08 17:30,155,59,96,0,0,0
2023-11-08 17:45,192,78,114,0,0,0
2023-11-08 18:00,162,39,123,0,0,0
2023-11-08 18:15,155,63,92,0,0,0
2023-11-08 18:30,121,35,86,0,0,0
2023-11-08 18:45,121,51,70,0,0,0
2023-11-08 19:00,103,26,77,0,0,0
2023-11-08 19:15,119,43,76,0,0,0
2023-11-08 19:30,106,37,69,0,0,0
2023-11-08 19:45,110,36,74,0,0,0
2023-11-08 20:00,87,26,61,0,0,0
2023-11-08 20:15,76,30,46,0,0,0
2023-11-08 20:30,67,20,47,0,0,0
2023-11-08 20:45,61,16,45,0,0,0
2023-11-08 21:00,45,16,29,0,0,0
2023-11-08 21:15,70,18,52,0,0,0
2023-11-08 21:30,54,12,42,0,0,0
2023-11-08 21:45,47,21,26,0,0,0
2023-11-08 22:00,37,12,25,0,0,0
2023-11-08 22:15,59,23,36,0,0,0
2023-11-08 22:30,59,19,40,0,0,0
2023-11-08 22:45,21,6,15,0,0,0
2023-11-08 23:00,47,21,26,0,0,0
2023-11-08 23:15,35,15,20,0,0,0
2023-11-08 23:30,31,14,17,0,0,0
2023-11-08 23:45,13,4,9,0,0,0
2023-11-09 00:00,8,3,5,0,0,0
2023-11-09 00:15,12,3,9,0,0,0
2023-11-09 00:30,9,5,4,0,0,0
2023-11-09 00:45,7,3,4,0,0,0
2023-11-09 01:00,3,0,3,0,0,0
2023-11-09 01:15,5,1,4,0,0,0
2023-11-09 01:30,6,0,6,0,0,0
2023-11-09 01:45,3,0,3,0,0,0
2023-11-09 02:00,5,1,4,0,0,0
2023-11-09 02:15,7,0,7,0,0,0
2023-11-09 02:30,9,1,8,0,0,0
2023-11-09 02:45,4,0,4,0,0,0
2023-11-09 03:00,10,0,10,0,0,0
2023-11-09 03:15,9,0,9,0,0,0
2023-11-09 03:30,6,0,6,0,0,0
2023-11-09 03:45,6,2,4,0,0,0
2023-11-09 04:00,4,1,3,0,0,0
2023-11-09 04:15,4,2,2,0,0,0
2023-11-09 04:30,4,2,2,0,0,0
2023-11-09 04:45,4,4,0,0,0,0
2023-11-09 05:00,7,4,3,0,0,0
2023-11-09 05:15,4,3,1,0,0,0
2023-11-09 05:30,11,5,6,0,0,0
2023-11-09 05:45,15,7,8,0,0,0
2023-11-09 06:00,28,22,6,0,0,0
2023-11-09 06:15,46,32,14,0,0,0
2023-11-09 06:30,44,32,12,0,0,0
2023-11-09 06:45,50,31,19,0,0,0
2023-11-09 07:00,75,51,24,0,0,0
2023-11-09 07:15,92,59,33,0,0,0
2023-11-09 07:30,160,98,62,0,0,0
2023-11-09 07:45,175,122,53,0,0,0
2023-11-09 08:00,149,97,52,0,0,0
2023-11-09 08:15,145,93,52,0,0,0
2023-11-09 08:30,90,61,29,0,0,0
2023-11-09 08:45,131,104,27,0,0,0
2023-11-09 09:00,73,51,22,0,0,0
2023-11-09 09:15,65,35,30,0,0,0
2023-11-09 09:30,59,44,15,0,0,0
2023-11-09 09:45,104,69,35,0,0,0
2023-11-09 10:00,81,59,22,0,0,0
2023-11-09 10:15,73,48,25,0,0,0
2023-11-09 10:30,74,53,21,0,0,0
2023-11-09 10:45,89,49,40,0,0,0
2023-11-09 11:00,69,35,34,0,0,0
2023-11-09 11:15,71,36,35,0,0,0
2023-11-09 11:30,91,50,41,0,0,0
2023-11-09 11:45,100,57,43,0,0,0
2023-11-09 12:00,141,62,79,0,0,0
2023-11-09 12:15,113,56,57,0,0,0
2023-11-09 12:30,108,47,61,0,0,0
2023-11-09 12:45,124,63,61,0,0,0
2023-11-09 13:00,139,60,79,0,0,0
2023-11-09 13:15,119,57,62,0,0,0
2023-11-09 13:30,152,58,94,0,0,0
2023-11-09 13:45,146,72,74,0,0,0
2023-11-09 14:00,138,59,79,0,0,0
2023-11-09 14:15,153,65,88,0,0,0
2023-11-09 14:30,161,76,85,0,0,0
2023-11-09 14:45,174,84,90,0,0,0
2023-11-09 15:00,146,70,76,0,0,0
2023-11-09 15:15,171,68,103,0,0,0
2023-11-09 15:30,176,82,94,0,0,0
2023-11-09 15:45,172,73,99,0,0,0
2023-11-09 16:00,186,72,114,0,0,0
2023-11-09 16:15,184,78,106,0,0,0
2023-11-09 16:30,196,88,108,0,0,0
2023-11-09 16:45,156,69,87,0,0,0
2023-11-09 17:00,192,71,121,0,0,0
2023-11-09 17:15,181,62,119,0,0,0
2023-11-09 17:30,147,48,99,0,0,0
2023-11-09 17:45,177,69,108,0,0,0
2023-11-09 18:00,167,51,116,0,0,0
2023-11-09 18:15,152,55,97,0,0,0
2023-11-09 18:30,127,44,83,0,0,0
2023-11-09 18:45,152,53,99,0,0,0
2023-11-09 19:00,143,42,101,0,0,0
2023-11-09 19:15,149,52,97,0,0,0
2023-11-09 19:30,118,25,93,0,0,0
2023-11-09 19:45,95,34,61,0,0,0
2023-11-09 20:00,82,24,58,0,0,0
2023-11-09 20:15,48,14,34,0,0,0
2023-11-09 20:30,51,15,36,0,0,0
2023-11-09 20:45,53,16,37,0,0,0
2023-11-09 21:00,58,31,27,0,0,0
2023-11-09 21:15,38,10,28,0,0,0
2023-11-09 21:30,33,13,20,0,0,0
2023-11-09 21:45,48,15,33,0,0,0
2023-11-09 22:00,58,13,45,0,0,0
2023-11-09 22:15,57,30,27,0,0,0
2023-11-09 22:30,74,47,27,0,0,0
2023-11-09 22:45,58,40,18,0,0,0
2023-11-09 23:00,38,14,24,0,0,0
2023-11-09 23:15,26,6,20,0,0,0
2023-11-09 23:30,25,17,8,0,0,0
2023-11-09 23:45,12,5,7,0,0,0
2023-11-10 00:00,21,7,14,0,0,0
2023-11-10 00:15,18,9,9,0,0,0
2023-11-10 00:30,9,2,7,0,0,0
2023-11-10 00:45,13,8,5,0,0,0
2023-11-10 01:00,8,2,6,0,0,0
2023-11-10 01:15,4,2,2,0,0,0
2023-11-10 01:30,3,2,1,0,0,0
2023-11-10 01:45,1,0,1,0,0,0
2023-11-10 02:00,2,1,1,0,0,0
2023-11-10 02:15,1,1,0,0,0,0
2023-11-10 02:30,4,1,3,0,0,0
2023-11-10 02:45,2,0,2,0,0,0
2023-11-10 03:00,0,0,0,0,0,0
2023-11-10 03:15,3,2,1,0,0,0
2023-11-10 03:30,0,0,0,0,0,0
2023-11-10 03:45,1,1,0,0,0,0
2023-11-10 04:00,0,0,0,0,0,0
2023-11-10 04:15,0,0,0,0,0,0
2023-11-10 04:30,2,2,0,0,0,0
2023-11-10 04:45,4,2,2,0,0,0
2023-11-10 05:00,4,4,0,0,0,0
2023-11-10 05:15,1,1,0,0,0,0
2023-11-10 05:30,8,5,3,0,0,0
2023-11-10 05:45,12,7,5,0,0,0
2023-11-10 06:00,17,8,9,0,0,0
2023-11-10 06:15,26,20,6,0,0,0
2023-11-10 06:30,34,20,14,0,0,0
2023-11-10 06:45,53,27,26,0,0,0
2023-11-10 07:00,72,44,28,0,0,0
2023-11-10 07:15,104,53,51,0,0,0
2023-11-10 07:30,163,103,60,0,0,0
2023-11-10 07:45,175,115,60,0,0,0
2023-11-10 08:00,116,73,43,0,0,0
2023-11-10 08:15,129,79,50,0,0,0
2023-11-10 08:30,124,78,46,0,0,0
2023-11-10 08:45,134,87,47,0,0,0
2023-11-10 09:00,81,45,36,0,0,0
2023-11-10 09:15,71,55,16,0,0,0
2023-11-10 09:30,85,60,25,0,0,0
2023-11-10 09:45,132,82,50,0,0,0
2023-11-10 10:00,92,56,36,0,0,0
2023-11-10 10:15,73,40,33,0,0,0
2023-11-10 10:30,100,58,42,0,0,0
2023-11-10 10:45,111,52,59,0,0,0
2023-11-10 11:00,117,49,68,0,0,0
2023-11-10 11:15,114,51,63,0,0,0
2023-11-10 11:30,141,76,65,0,0,0
2023-11-10 11:45,132,66,66,0,0,0
2023-11-10 12:00,141,56,85,0,0,0
2023-11-10 12:15,148,77,71,0,0,0
2023-11-10 12:30,129,50,79,0,0,0
2023-11-10 12:45,147,77,70,0,0,0
2023-11-10 13:00,165,62,103,0,0,0
2023-11-10 13:15,135,57,78,0,0,0
2023-11-10 13:30,133,55,78,0,0,0
2023-11-10 13:45,138,58,80,0,0,0
2023-11-10 14:00,128,44,84,0,0,0
2023-11-10 14:15,118,46,72,0,0,0
2023-11-10 14:30,119,56,63,0,0,0
2023-11-10 14:45,140,54,86,0,0,0
2023-11-10 15:00,153,79,74,0,0,0
2023-11-10 15:15,150,65,85,0,0,0
2023-11-10 15:30,127,56,71,0,0,0
2023-11-10 15:45,147,74,73,0,0,0
2023-11-10 16:00,131,49,82,0,0,0
2023-11-10 16:15,129,56,73,0,0,0
2023-11-10 16:30,110,46,64,0,0,0
2023-11-10 16:45,117,46,71,0,0,0
2023-11-10 17:00,113,49,64,0,0,0
2023-11-10 17:15,127,57,70,0,0,0
2023-11-10 17:30,98,29,69,0,0,0
2023-11-10 17:45,135,43,92,0,0,0
2023-11-10 18:00,131,42,89,0,0,0
2023-11-10 18:15,113,39,74,0,0,0
2023-11-10 18:30,93,35,58,0,0,0
2023-11-10 18:45,113,44,69,0,0,0
2023-11-10 19:00,97,31,66,0,0,0
2023-11-10 19:15,88,39,49,0,0,0
2023-11-10 19:30,81,38,43,0,0,0
2023-11-10 19:45,74,28,46,0,0,0
2023-11-10 20:00,60,22,38,0,0,0
2023-11-10 20:15,70,29,41,0,0,0
2023-11-10 20:30,57,19,38,0,0,0
2023-11-10 20:45,37,14,23,0,0,0
2023-11-10 21:00,39,18,21,0,0,0
2023-11-10 21:15,55,19,36,0,0,0
2023-11-10 21:30,49,17,32,0,0,0
2023-11-10 21:45,41,14,27,0,0,0
2023-11-10 22:00,60,24,36,0,0,0
2023-11-10 22:15,50,22,28,0,0,0
2023-11-10 22:30,26,13,13,0,0,0
2023-11-10 22:45,28,6,22,0,0,0
2023-11-10 23:00,46,18,28,0,0,0
2023-11-10 23:15,44,28,16,0,0,0
2023-11-10 23:30,24,10,14,0,0,0
2023-11-10 23:45,20,6,14,0,0,0
2023-11-11 00:00,33,6,27,0,0,0
2023-11-11 00:15,26,7,19,0,0,0
2023-11-11 00:30,17,9,8,0,0,0
2023-11-11 00:45,8,2,6,0,0,0
2023-11-11 01:00,12,4,8,0,0,0
2023-11-11 01:15,7,2,5,0,0,0
2023-11-11 01:30,12,4,8,0,0,0
2023-11-11 01:45,11,3,8,0,0,0
2023-11-11 02:00,5,2,3,0,0,0
2023-11-11 02:15,3,2,1,0,0,0
2023-11-11 02:30,7,3,4,0,0,0
2023-11-11 02:45,6,2,4,0,0,0
2023-11-11 03:00,2,0,2,0,0,0
2023-11-11 03:15,2,0,2,0,0,0
2023-11-11 03:30,1,1,0,0,0,0
2023-11-11 03:45,3,1,2,0,0,0
2023-11-11 04:00,1,0,1,0,0,0
2023-11-11 04:15,4,0,4,0,0,0
2023-11-11 04:30,3,0,3,0,0,0
2023-11-11 04:45,0,0,0,0,0,0
2023-11-11 05:00,8,6,2,0,0,0
2023-11-11 05:15,8,3,5,0,0,0
2023-11-11 05:30,6,4,2,0,0,0
2023-11-11 05:45,12,6,6,0,0,0
2023-11-11 06:00,8,7,1,0,0,0
2023-11-11 06:15,4,3,1,0,0,0
2023-11-11 06:30,7,4,3,0,0,0
2023-11-11 06:45,7,3,4,0,0,0
2023-11-11 07:00,15,11,4,0,0,0
2023-11-11 07:15,9,7,2,0,0,0
2023-11-11 07:30,14,8,6,0,0,0
2023-11-11 07:45,21,14,7,0,0,0
2023-11-11 08:00,32,16,16,0,0,0
2023-11-11 08:15,38,30,8,0,0,0
2023-11-11 08:30,36,25,11,0,0,0
2023-11-11 08:45,45,32,13,0,0,0
2023-11-11 09:00,43,28,15,0,0,0
2023-11-11 09:15,61,43,18,0,0,0
2023-11-11 09:30,74,51,23,0,0,0
2023-11-11 09:45,135,92,43,0,0,0
2023-11-11 10:00,102,77,25,0,0,0
2023-11-11 10:15,139,95,44,0,0,0
2023-11-11 10:30,114,82,32,0,0,0
2023-11-11 10:45,161,105,56,0,0,0
2023-11-11 11:00,133,91,42,0,0,0
2023-11-11 11:15,126,65,61,0,0,0
2023-11-11 11:30,132,80,52,0,0,0
2023-11-11 11:45,134,83,51,0,0,0
2023-11-11 12:00,152,81,71,0,0,0
2023-11-11 12:15,119,56,63,0,0,0
2023-11-11 12:30,139,73,66,0,0,0
2023-11-11 12:45,156,75,81,0,0,0
2023-11-11 13:00,171,74,97,0,0,0
2023-11-11 13:15,158,72,86,0,0,0
2023-11-11 13:30,131,61,70,0,0,0
2023-11-11 13:45,148,69,79,0,0,0
2023-11-11 14:00,155,69,86,0,0,0
2023-11-11 14:15,153,55,98,0,0,0
2023-11-11 14:30,142,48,94,0,0,0
2023-11-11 14:45,146,44,102,0,0,0
2023-11-11 15:00,126,45,81,0,0,0
2023-11-11 15:15,132,61,71,0,0,0
2023-11-11 15:30,119,48,71,0,0,0
2023-11-11 15:45,143,65,78,0,0,0
2023-11-11 16:00,90,40,50,0,0,0
2023-11-11 16:15,107,32,75,0,0,0
2023-11-11 16:30,86,32,54,0,0,0
2023-11-11 16:45,112,46,66,0,0,0
2023-11-11 17:00,98,37,61,0,0,0
2023-11-11 17:15,111,41,70,0,0,0
2023-11-11 17:30,108,53,55,0,0,0
2023-11-11 17:45,87,35,52,0,0,0
2023-11-11 18:00,93,42,51,0,0,0
2023-11-11 18:15,93,31,62,0,0,0
2023-11-11 18:30,85,27,58,0,0,0
2023-11-11 18:45,105,59,46,0,0,0
2023-11-11 19:00,102,46,56,0,0,0
2023-11-11 19:15,67,27,40,0,0,0
2023-11-11 19:30,65,33,32,0,0,0
2023-11-11 19:45,87,33,54,0,0,0
2023-11-11 20:00,76,29,47,0,0,0
2023-11-11 20:15,55,21,34,0,0,0
2023-11-11 20:30,37,16,21,0,0,0
2023-11-11 20:45,39,12,27,0,0,0
2023-11-11 21:00,42,16,26,0,0,0
2023-11-11 21:15,44,18,26,0,0,0
2023-11-11 21:30,48,11,37,0,0,0
2023-11-11 21:45,54,18,36,0,0,0
2023-11-11 22:00,35,17,18,0,0,0
2023-11-11 22:15,39,16,23,0,0,0
2023-11-11 22:30,50,20,30,0,0,0
2023-11-11 22:45,26,9,17,0,0,0
2023-11-11 23:00,47,11,36,0,0,0
2023-11-11 23:15,39,20,19,0,0,0
2023-11-11 23:30,27,12,15,0,0,0
2023-11-11 23:45,29,12,17,0,0,0
2023-11-12 00:00,27,5,22,0,0,0
2023-11-12 00:15,28,12,16,0,0,0
2023-11-12 00:30,28,12,16,0,0,0
2023-11-12 00:45,26,8,18,0,0,0
2023-11-12 01:00,19,5,14,0,0,0
2023-11-12 01:15,21,5,16,0,0,0
2023-11-12 01:30,11,6,5,0,0,0
2023-11-12 01:45,9,2,7,0,0,0
2023-11-12 02:00,18,7,11,0,0,0
2023-11-12 02:15,5,0,5,0,0,0
2023-11-12 02:30,7,0,7,0,0,0
2023-11-12 02:45,8,4,4,0,0,0
2023-11-12 03:00,16,2,14,0,0,0
2023-11-12 03:15,4,1,3,0,0,0
2023-11-12 03:30,3,0,3,0,0,0
2023-11-12 03:45,13,1,12,0,0,0
2023-11-12 04:00,0,0,0,0,0,0
2023-11-12 04:15,1,1,0,0,0,0
2023-11-12 04:30,4,1,3,0,0,0
2023-11-12 04:45,3,2,1,0,0,0
2023-11-12 05:00,2,2,0,0,0,0
2023-11-12 05:15,1,0,1,0,0,0
2023-11-12 05:30,7,2,5,0,0,0
2023-11-12 05:45,4,3,1,0,0,0
2023-11-12 06:00,2,1,1,0,0,0
2023-11-12 06:15,5,3,2,0,0,0
2023-11-12 06:30,4,3,1,0,0,0
2023-11-12 06:45,3,2,1,0,0,0
2023-11-12 07:00,5,2,3,0,0,0
2023-11-12 07:15,1,1,0,0,0,0
2023-11-12 07:30,4,3,1,0,0,0
2023-11-12 07:45,6,2,4,0,0,0
2023-11-12 08:00,5,2,3,0,0,0
2023-11-12 08:15,3,2,1,0,0,0
2023-11-12 08:30,9,5,4,0,0,0
2023-11-12 08:45,15,14,1,0,0,0
2023-11-12 09:00,20,9,11,0,0,0
2023-11-12 09:15,30,20,10,0,0,0
2023-11-12 09:30,33,14,19,0,0,0
2023-11-12 09:45,48,24,24,0,0,0
2023-11-12 10:00,45,23,22,0,0,0
2023-11-12 10:15,38,19,19,0,0,0
2023-11-12 10:30,38,32,6,0,0,0
2023-11-12 10:45,40,21,19,0,0,0
2023-11-12 11:00,48,20,28,0,0,0
2023-11-12 11:15,37,22,15,0,0,0
2023-11-12 11:30,41,22,19,0,0,0
2023-11-12 11:45,57,32,25,0,0,0
2023-11-12 12:00,46,14,32,0,0,0
2023-11-12 12:15,63,32,31,0,0,0
2023-11-12 12:30,51,23,28,0,0,0
2023-11-12 12:45,65,26,39,0,0,0
2023-11-12 13:00,50,28,22,0,0,0
2023-11-12 13:15,77,37,40,0,0,0
2023-11-12 13:30,60,26,34,0,0,0
2023-11-12 13:45,58,26,32,0,0,0
2023-11-12 14:00,81,31,50,0,0,0
2023-11-12 14:15,62,25,37,0,0,0
2023-11-12 14:30,78,46,32,0,0,0
2023-11-12 14:45,105,45,60,0,0,0
2023-11-12 15:00,84,44,40,0,0,0
2023-11-12 15:15,64,35,29,0,0,0
2023-11-12 15:30,73,36,37,0,0,0
2023-11-12 15:45,90,45,45,0,0,0
2023-11-12 16:00,78,31,47,0,0,0
2023-11-12 16:15,72,40,32,0,0,0
2023-11-12 16:30,81,34,47,0,0,0
2023-11-12 16:45,59,25,34,0,0,0
2023-11-12 17:00,63,16,47,0,0,0
2023-11-12 17:15,79,34,45,0,0,0
2023-11-12 17:30,77,22,55,0,0,0
2023-11-12 17:45,66,34,32,0,0,0
2023-11-12 18:00,40,16,24,0,0,0
2023-11-12 18:15,62,27,35,0,0,0
2023-11-12 18:30,44,19,25,0,0,0
2023-11-12 18:45,47,21,26,0,0,0
2023-11-12 19:00,41,13,28,0,0,0
2023-11-12 19:15,48,18,30,0,0,0
2023-11-12 19:30,36,15,21,0,0,0
2023-11-12 19:45,44,21,23,0,0,0
2023-11-12 20:00,49,22,27,0,0,0
2023-11-12 20:15,30,10,20,0,0,0
2023-11-12 20:30,31,13,18,0,0,0
2023-11-12 20:45,39,16,23,0,0,0
2023-11-12 21:00,29,8,21,0,0,0
2023-11-12 21:15,20,3,17,0,0,0
2023-11-12 21:30,21,6,15,0,0,0
2023-11-12 21:45,16,4,12,0,0,0
2023-11-12 22:00,18,4,14,0,0,0
2023-11-12 22:15,20,7,13,0,0,0
2023-11-12 22:30,28,11,17,0,0,0
2023-11-12 22:45,45,31,14,0,0,0
2023-11-12 23:00,21,11,10,0,0,0
2023-11-12 23:15,6,4,2,0,0,0
2023-11-12 23:30,5,1,4,0,0,0
2023-11-12 23:45,6,2,4,0,0,0
2023-11-13 00:00,8,2,6,0,0,0
2023-11-13 00:15,4,1,3,0,0,0
2023-11-13 00:30,3,0,3,0,0,0
2023-11-13 00:45,4,1,3,0,0,0
2023-11-13 01:00,1,0,1,0,0,0
2023-11-13 01:15,1,1,0,0,0,0
2023-11-13 01:30,1,0,1,0,0,0
2023-11-13 01:45,3,2,1,0,0,0
2023-11-13 02:00,0,0,0,0,0,0
2023-11-13 02:15,2,0,2,0,0,0
2023-11-13 02:30,0,0,0,0,0,0
2023-11-13 02:45,0,0,0,0,0,0
2023-11-13 03:00,1,1,0,0,0,0
2023-11-13 03:15,0,0,0,0,0,0
2023-11-13 03:30,3,1,2,0,0,0
2023-11-13 03:45,1,1,0,0,0,0
2023-11-13 04:00,0,0,0,0,0,0
2023-11-13 04:15,3,0,3,0,0,0
2023-11-13 04:30,1,1,0,0,0,0
2023-11-13 04:45,1,1,0,0,0,0
2023-11-13 05:00,3,3,0,0,0,0
2023-11-13 05:15,11,9,2,0,0,0
2023-11-13 05:30,13,9,4,0,0,0
2023-11-13 05:45,14,10,4,0,0,0
2023-11-13 06:00,21,17,4,0,0,0
2023-11-13 06:15,34,29,5,0,0,0
2023-11-13 06:30,39,26,13,0,0,0
2023-11-13 06:45,62,36,26,0,0,0
2023-11-13 07:00,83,50,33,0,0,0
2023-11-13 07:15,114,63,51,0,0,0
2023-11-13 07:30,165,101,64,0,0,0
2023-11-13 07:45,195,125,70,0,0,0
2023-11-13 08:00,133,104,29,0,0,0
2023-11-13 08:15,129,85,44,0,0,0
2023-11-13 08:30,121,78,43,0,0,0
2023-11-13 08:45,144,85,59,0,0,0
2023-11-13 09:00,96,65,31,0,0,0
2023-11-13 09:15,90,59,31,0,0,0
2023-11-13 09:30,84,55,29,0,0,0
2023-11-13 09:45,104,68,36,0,0,0
2023-11-13 10:00,77,50,27,0,0,0
2023-11-13 10:15,58,34,24,0,0,0
2023-11-13 10:30,68,33,35,0,0,0
2023-11-13 10:45,77,42,35,0,0,0
2023-11-13 11:00,66,39,27,0,0,0
2023-11-13 11:15,68,33,35,0,0,0
2023-11-13 11:30,60,29,31,0,0,0
2023-11-13 11:45,73,32,41,0,0,0
2023-11-13 12:00,71,34,37,0,0,0
2023-11-13 12:15,79,38,41,0,0,0
2023-11-13 12:30,85,26,59,0,0,0
2023-11-13 12:45,99,37,62,0,0,0
2023-11-13 13:00,98,38,60,0,0,0
2023-11-13 13:15,88,36,52,0,0,0
2023-11-13 13:30,81,31,50,0,0,0
2023-11-13 13:45,104,48,56,0,0,0
2023-11-13 14:00,93,34,59,0,0,0
2023-11-13 14:15,98,41,57,0,0,0
2023-11-13 14:30,114,49,65,0,0,0
2023-11-13 14:45,101,47,54,0,0,0
2023-11-13 15:00,110,50,60,0,0,0
2023-11-13 15:15,111,47,64,0,0,0
2023-11-13 15:30,99,30,69,0,0,0
2023-11-13 15:45,135,51,84,0,0,0
2023-11-13 16:00,167,57,110,0,0,0
2023-11-13 16:15,123,53,70,0,0,0
2023-11-13 16:30,129,40,89,0,0,0
2023-11-13 16:45,172,60,112,0,0,0
2023-11-13 17:00,129,54,75,0,0,0
2023-11-13 17:15,125,47,78,0,0,0
2023-11-13 17:30,159,59,100,0,0,0
2023-11-13 17:45,186,74,112,0,0,0
2023-11-13 18:00,156,60,96,0,0,0
2023-11-13 18:15,134,63,71,0,0,0
2023-11-13 18:30,126,43,83,0,0,0
2023-11-13 18:45,104,37,67,0,0,0
2023-11-13 19:00,88,29,59,0,0,0
2023-11-13 19:15,103,38,65,0,0,0
2023-11-13 19:30,69,23,46,0,0,0
2023-11-13 19:45,94,42,52,0,0,0
2023-11-13 20:00,93,28,65,0,0,0
2023-11-13 20:15,53,20,33,0,0,0
2023-11-13 20:30,38,20,18,0,0,0
2023-11-13 20:45,47,22,25,0,0,0
2023-11-13 21:00,43,17,26,0,0,0
2023-11-13 21:15,39,15,24,0,0,0
2023-11-13 21:30,38,7,31,0,0,0
2023-11-13 21:45,38,7,31,0,0,0
2023-11-13 22:00,65,25,40,0,0,0
2023-11-13 22:15,31,9,22,0,0,0
2023-11-13 22:30,36,11,25,0,0,0
2023-11-13 22:45,30,3,27,0,0,0
2023-11-13 23:00,16,2,14,0,0,0
2023-11-13 23:15,26,11,15,0,0,0
2023-11-13 23:30,13,4,9,0,0,0
2023-11-13 23:45,7,3,4,0,0,0
2023-11-14 00:00,9,2,7,0,0,0
2023-11-14 00:15,10,2,8,0,0,0
2023-11-14 00:30,5,2,3,0,0,0
2023-11-14 00:45,1,1,0,0,0,0
2023-11-14 01:00,2,1,1,0,0,0
2023-11-14 01:15,4,1,3,0,0,0
2023-11-14 01:30,0,0,0,0,0,0
2023-11-14 01:45,3,1,2,0,0,0
2023-11-14 02:00,1,1,0,0,0,0
2023-11-14 02:15,4,2,2,0,0,0
2023-11-14 02:30,2,0,2,0,0,0
2023-11-14 02:45,0,0,0,0,0,0
2023-11-14 03:00,3,1,2,0,0,0
2023-11-14 03:15,1,1,0,0,0,0
2023-11-14 03:30,2,1,1,0,0,0
2023-11-14 03:45,3,3,0,0,0,0
2023-11-14 04:00,0,0,0,0,0,0
2023-11-14 04:15,0,0,0,0,0,0
2023-11-14 04:30,2,2,0,0,0,0
2023-11-14 04:45,4,3,1,0,0,0
2023-11-14 05:00,4,4,0,0,0,0
2023-11-14 05:15,5,5,0,0,0,0
2023-11-14 05:30,10,7,3,0,0,0
2023-11-14 05:45,14,7,7,0,0,0
2023-11-14 06:00,27,22,5,0,0,0
2023-11-14 06:15,34,30,4,0,0,0
2023-11-14 06:30,35,23,12,0,0,0
2023-11-14 06:45,58,40,18,0,0,0
2023-11-14 07:00,81,48,33,0,0,0
2023-11-14 07:15,107,64,43,0,0,0
2023-11-14 07:30,193,129,64,0,0,0
2023-11-14 07:45,173,109,64,0,0,0
2023-11-14 08:00,165,113,52,0,0,0
2023-11-14 08:15,153,96,57,0,0,0
2023-11-14 08:30,138,89,49,0,0,0
2023-11-14 08:45,144,93,51,0,0,0
2023-11-14 09:00,103,59,44,0,0,0
2023-11-14 09:15,99,60,39,0,0,0
2023-11-14 09:30,96,62,34,0,0,0
2023-11-14 09:45,128,89,39,0,0,0
2023-11-14 10:00,126,76,50,0,0,0
2023-11-14 10:15,79,36,43,0,0,0
2023-11-14 10:30,62,28,34,0,0,0
2023-11-14 10:45,80,38,42,0,0,0
2023-11-14 11:00,93,51,42,0,0,0
2023-11-14 11:15,84,41,43,0,0,0
2023-11-14 11:30,86,51,35,0,0,0
2023-11-14 11:45,122,64,58,0,0,0
2023-11-14 12:00,138,69,69,0,0,0
2023-11-14 12:15,125,63,62,0,0,0
2023-11-14 12:30,121,60,61,0,0,0
2023-11-14 12:45,135,64,71,0,0,0
2023-11-14 13:00,119,53,66,0,0,0
2023-11-14 13:15,125,44,81,0,0,0
2023-11-14 13:30,109,50,59,0,0,0
2023-11-14 13:45,141,63,78,0,0,0
2023-11-14 14:00,123,46,77,0,0,0
2023-11-14 14:15,126,56,70,0,0,0
2023-11-14 14:30,111,45,66,0,0,0
2023-11-14 14:45,144,71,73,0,0,0
2023-11-14 15:00,138,56,82,0,0,0
2023-11-14 15:15,131,63,68,0,0,0
2023-11-14 15:30,168,74,94,0,0,0
2023-11-14 15:45,168,65,103,0,0,0
2023-11-14 16:00,208,94,114,0,0,0
2023-11-14 16:15,189,83,106,0,0,0
2023-11-14 16:30,192,90,102,0,0,0
2023-11-14 16:45,177,64,113,0,0,0
2023-11-14 17:00,154,63,91,0,0,0
2023-11-14 17:15,121,42,79,0,0,0
2023-11-14 17:30,150,39,111,0,0,0
2023-11-14 17:45,157,66,91,0,0,0
2023-11-14 18:00,141,43,98,0,0,0
2023-11-14 18:15,107,31,76,0,0,0
2023-11-14 18:30,112,32,80,0,0,0
2023-11-14 18:45,103,39,64,0,0,0
2023-11-14 19:00,89,31,58,0,0,0
2023-11-14 19:15,100,39,61,0,0,0
2023-11-14 19:30,81,21,60,0,0,0
2023-11-14 19:45,92,30,62,0,0,0
2023-11-14 20:00,60,17,43,0,0,0
2023-11-14 20:15,47,17,30,0,0,0
2023-11-14 20:30,44,19,25,0,0,0
2023-11-14 20:45,42,17,25,0,0,0
2023-11-14 21:00,33,10,23,0,0,0
2023-11-14 21:15,54,12,42,0,0,0
2023-11-14 21:30,36,11,25,0,0,0
2023-11-14 21:45,32,17,15,0,0,0
2023-11-14 22:00,50,13,37,0,0,0
2023-11-14 22:15,48,14,34,0,0,0
2023-11-14 22:30,47,18,29,0,0,0
2023-11-14 22:45,20,7,13,0,0,0
2023-11-14 23:00,28,12,16,0,0,0
2023-11-14 23:15,15,5,10,0,0,0
2023-11-14 23:30,10,3,7,0,0,0
2023-11-14 23:45,12,3,9,0,0,0
2023-11-15 00:00,9,3,6,0,0,0
2023-11-15 00:15,9,2,7,0,0,0
2023-11-15 00:30,6,1,5,0,0,0
2023-11-15 00:45,4,0,4,0,0,0
2023-11-15 01:00,2,1,1,0,0,0
2023-11-15 01:15,0,0,0,0,0,0
2023-11-15 01:30,1,0,1,0,0,0
2023-11-15 01:45,4,1,3,0,0,0
2023-11-15 02:00,0,0,0,0,0,0
2023-11-15 02:15,1,0,1,0,0,0
2023-11-15 02:30,1,0,1,0,0,0
2023-11-15 02:45,0,0,0,0,0,0
2023-11-15 03:00,3,1,2,0,0,0
2023-11-15 03:15,2,0,2,0,0,0
2023-11-15 03:30,3,2,1,0,0,0
2023-11-15 03:45,3,1,2,0,0,0
2023-11-15 04:00,2,1,1,0,0,0
2023-11-15 04:15,0,0,0,0,0,0
2023-11-15 04:30,0,0,0,0,0,0
2023-11-15 04:45,5,3,2,0,0,0
2023-11-15 05:00,4,3,1,0,0,0
2023-11-15 05:15,11,7,4,0,0,0
2023-11-15 05:30,14,10,4,0,0,0
2023-11-15 05:45,12,8,4,0,0,0
2023-11-15 06:00,30,23,7,0,0,0
2023-11-15 06:15,38,28,10,0,0,0
2023-11-15 06:30,34,25,9,0,0,0
2023-11-15 06:45,55,41,14,0,0,0
2023-11-15 07:00,62,36,26,0,0,0
2023-11-15 07:15,109,59,50,0,0,0
2023-11-15 07:30,134,88,46,0,0,0
2023-11-15 07:45,145,101,44,0,0,0
2023-11-15 08:00,148,99,49,0,0,0
2023-11-15 08:15,150,93,57,0,0,0
2023-11-15 08:30,94,69,25,0,0,0
2023-11-15 08:45,111,81,30,0,0,0
2023-11-15 09:00,88,60,28,0,0,0
2023-11-15 09:15,50,34,16,0,0,0
2023-11-15 09:30,56,33,23,0,0,0
2023-11-15 09:45,78,57,21,0,0,0
2023-11-15 10:00,60,41,19,0,0,0
2023-11-15 10:15,50,27,23,0,0,0
2023-11-15 10:30,43,27,16,0,0,0
2023-11-15 10:45,49,29,20,0,0,0
2023-11-15 11:00,49,34,15,0,0,0
2023-11-15 11:15,61,34,27,0,0,0
2023-11-15 11:30,81,52,29,0,0,0
2023-11-15 11:45,133,80,53,0,0,0
2023-11-15 12:00,119,56,63,0,0,0
2023-11-15 12:15,122,65,57,0,0,0
2023-11-15 12:30,106,42,64,0,0,0
2023-11-15 12:45,118,59,59,0,0,0
2023-11-15 13:00,109,49,60,0,0,0
2023-11-15 13:15,131,70,61,0,0,0
2023-11-15 13:30,134,61,73,0,0,0
2023-11-15 13:45,142,72,70,0,0,0
2023-11-15 14:00,122,62,60,0,0,0
2023-11-15 14:15,102,40,62,0,0,0
2023-11-15 14:30,127,47,80,0,0,0
2023-11-15 14:45,129,56,73,0,0,0
2023-11-15 15:00,109,47,62,0,0,0
2023-11-15 15:15,168,71,97,0,0,0
2023-11-15 15:30,114,37,77,0,0,0
2023-11-15 15:45,153,60,93,0,0,0
2023-11-15 16:00,152,50,102,0,0,0
2023-11-15 16:15,172,77,95,0,0,0
2023-11-15 16:30,166,64,102,0,0,0
2023-11-15 16:45,155,80,75,0,0,0
2023-11-15 17:00,182,61,121,0,0,0
2023-11-15 17:15,143,54,89,0,0,0
2023-11-15 17:30,125,43,82,0,0,0
2023-11-15 17:45,176,72,104,0,0,0
2023-11-15 18:00,137,35,102,0,0,0
2023-11-15 18:15,138,46,92,0,0,0
2023-11-15 18:30,133,55,78,0,0,0
2023-11-15 18:45,117,58,59,0,0,0
2023-11-15 19:00,103,43,60,0,0,0
2023-11-15 19:15,94,35,59,0,0,0
2023-11-15 19:30,82,28,54,0,0,0
2023-11-15 19:45,110,40,70,0,0,0
2023-11-15 20:00,84,28,56,0,0,0
2023-11-15 20:15,71,29,42,0,0,0
2023-11-15 20:30,68,27,41,0,0,0
2023-11-15 20:45,48,20,28,0,0,0
2023-11-15 21:00,48,14,34,0,0,0
2023-11-15 21:15,55,19,36,0,0,0
2023-11-15 21:30,54,16,38,0,0,0
2023-11-15 21:45,48,17,31,0,0,0
2023-11-15 22:00,80,29,51,0,0,0
2023-11-15 22:15,46,17,29,0,0,0
2023-11-15 22:30,64,26,38,0,0,0
2023-11-15 22:45,35,16,19,0,0,0
2023-11-15 23:00,34,11,23,0,0,0
2023-11-15 23:15,25,7,18,0,0,0
2023-11-15 23:30,19,5,14,0,0,0
2023-11-15 23:45,21,2,19,0,0,0
2023-11-16 00:00,13,3,10,0,0,0
2023-11-16 00:15,18,7,11,0,0,0
2023-11-16 00:30,13,5,8,0,0,0
2023-11-16 00:45,7,1,6,0,0,0
2023-11-16 01:00,11,2,9,0,0,0
2023-11-16 01:15,5,0,5,0,0,0
2023-11-16 01:30,8,2,6,0,0,0
2023-11-16 01:45,10,2,8,0,0,0
2023-11-16 02:00,4,0,4,0,0,0
2023-11-16 02:15,4,0,4,0,0,0
2023-11-16 02:30,14,3,11,0,0,0
2023-11-16 02:45,6,0,6,0,0,0
2023-11-16 03:00,2,1,1,0,0,0
2023-11-16 03:15,1,0,1,0,0,0
2023-11-16 03:30,3,0,3,0,0,0
2023-11-16 03:45,6,3,3,0,0,0
2023-11-16 04:00,2,1,1,0,0,0
2023-11-16 04:15,0,0,0,0,0,0
2023-11-16 04:30,1,1,0,0,0,0
2023-11-16 04:45,2,2,0,0,0,0
2023-11-16 05:00,3,1,2,0,0,0
2023-11-16 05:15,12,5,7,0,0,0
2023-11-16 05:30,16,10,6,0,0,0
2023-11-16 05:45,22,11,11,0,0,0
2023-11-16 06:00,26,19,7,0,0,0
2023-11-16 06:15,34,25,9,0,0,0
2023-11-16 06:30,48,34,14,0,0,0
2023-11-16 06:45,64,38,26,0,0,0
2023-11-16 07:00,71,45,26,0,0,0
2023-11-16 07:15,94,54,40,0,0,0
2023-11-16 07:30,177,113,64,0,0,0
2023-11-16 07:45,197,138,59,0,0,0
2023-11-16 08:00,135,89,46,0,0,0
2023-11-16 08:15,159,104,55,0,0,0
2023-11-16 08:30,119,85,34,0,0,0
2023-11-16 08:45,146,100,46,0,0,0
2023-11-16 09:00,93,62,31,0,0,0
2023-11-16 09:15,95,61,34,0,0,0
2023-11-16 09:30,99,63,36,0,0,0
2023-11-16 09:45,123,84,39,0,0,0
2023-11-16 10:00,91,50,41,0,0,0
2023-11-16 10:15,98,48,50,0,0,0
2023-11-16 10:30,94,57,37,0,0,0
2023-11-16 10:45,118,70,48,0,0,0
2023-11-16 11:00,94,49,45,0,0,0
2023-11-16 11:15,106,52,54,0,0,0
2023-11-16 11:30,109,59,50,0,0,0
2023-11-16 11:45,147,78,69,0,0,0
2023-11-16 12:00,159,72,87,0,0,0
2023-11-16 12:15,162,73,89,0,0,0
2023-11-16 12:30,135,58,77,0,0,0
2023-11-16 12:45,130,62,68,0,0,0
2023-11-16 13:00,147,64,83,0,0,0
2023-11-16 13:15,140,59,81,0,0,0
2023-11-16 13:30,155,80,75,0,0,0
2023-11-16 13:45,174,68,106,0,0,0
2023-11-16 14:00,136,68,68,0,0,0
2023-11-16 14:15,139,61,78,0,0,0
2023-11-16 14:30,153,64,89,0,0,0
2023-11-16 14:45,207,90,117,0,0,0
2023-11-16 15:00,142,60,82,0,0,0
2023-11-16 15:15,142,58,84,0,0,0
2023-11-16 15:30,188,82,106,0,0,0
2023-11-16 15:45,241,99,142,0,0,0
2023-11-16 16:00,185,84,101,0,0,0
2023-11-16 16:15,211,82,129,0,0,0
2023-11-16 16:30,200,87,113,0,0,0
2023-11-16 16:45,188,77,111,0,0,0
2023-11-16 17:00,220,80,140,0,0,0
2023-11-16 17:15,203,74,129,0,0,0
2023-11-16 17:30,168,50,118,0,0,0
2023-11-16 17:45,185,81,104,0,0,0
2023-11-16 18:00,189,64,125,0,0,0
2023-11-16 18:15,175,62,113,0,0,0
2023-11-16 18:30,173,54,119,0,0,0
2023-11-16 18:45,142,52,90,0,0,0
2023-11-16 19:00,109,30,79,0,0,0
2023-11-16 19:15,151,66,85,0,0,0
2023-11-16 19:30,119,42,77,0,0,0
2023-11-16 19:45,113,39,74,0,0,0
2023-11-16 20:00,74,20,54,0,0,0
2023-11-16 20:15,85,33,52,0,0,0
2023-11-16 20:30,75,21,54,0,0,0
2023-11-16 20:45,60,29,31,0,0,0
2023-11-16 21:00,58,17,41,0,0,0
2023-11-16 21:15,64,23,41,0,0,0
2023-11-16 21:30,45,23,22,0,0,0
2023-11-16 21:45,52,15,37,0,0,0
2023-11-16 22:00,63,14,49,0,0,0
2023-11-16 22:15,61,22,39,0,0,0
2023-11-16 22:30,34,12,22,0,0,0
2023-11-16 22:45,52,22,30,0,0,0
2023-11-16 23:00,36,4,32,0,0,0
2023-11-16 23:15,30,4,26,0,0,0
2023-11-16 23:30,33,8,25,0,0,0
2023-11-16 23:45,16,10,6,0,0,0
2023-11-17 00:00,22,14,8,0,0,0
2023-11-17 00:15,17,5,12,0,0,0
2023-11-17 00:30,12,2,10,0,0,0
2023-11-17 00:45,4,1,3,0,0,0
2023-11-17 01:00,10,2,8,0,0,0
2023-11-17 01:15,1,1,0,0,0,0
2023-11-17 01:30,5,1,4,0,0,0
2023-11-17 01:45,4,0,4,0,0,0
2023-11-17 02:00,4,1,3,0,0,0
2023-11-17 02:15,3,1,2,0,0,0
2023-11-17 02:30,4,1,3,0,0,0
2023-11-17 02:45,2,0,2,0,0,0
2023-11-17 03:00,12,1,11,0,0,0
2023-11-17 03:15,1,0,1,0,0,0
2023-11-17 03:30,4,1,3,0,0,0
2023-11-17 03:45,5,0,5,0,0,0
2023-11-17 04:00,1,0,1,0,0,0
2023-11-17 04:15,5,1,4,0,0,0
2023-11-17 04:30,1,1,0,0,0,0
2023-11-17 04:45,2,2,0,0,0,0
2023-11-17 05:00,5,4,1,0,0,0
2023-11-17 05:15,10,6,4,0,0,0
2023-11-17 05:30,11,5,6,0,0,0
2023-11-17 05:45,21,11,10,0,0,0
2023-11-17 06:00,16,12,4,0,0,0
2023-11-17 06:15,38,30,8,0,0,0
2023-11-17 06:30,44,26,18,0,0,0
2023-11-17 06:45,42,27,15,0,0,0
2023-11-17 07:00,64,32,32,0,0,0
2023-11-17 07:15,103,60,43,0,0,0
2023-11-17 07:30,150,90,60,0,0,0
2023-11-17 07:45,158,105,53,0,0,0
2023-11-17 08:00,113,75,38,0,0,0
2023-11-17 08:15,99,65,34,0,0,0
2023-11-17 08:30,125,88,37,0,0,0
2023-11-17 08:45,132,88,44,0,0,0
2023-11-17 09:00,87,55,32,0,0,0
2023-11-17 09:15,82,53,29,0,0,0
2023-11-17 09:30,85,55,30,0,0,0
2023-11-17 09:45,110,80,30,0,0,0
2023-11-17 10:00,111,69,42,0,0,0
2023-11-17 10:15,91,60,31,0,0,0
2023-11-17 10:30,87,54,33,0,0,0
2023-11-17 10:45,113,51,62,0,0,0
2023-11-17 11:00,116,65,51,0,0,0
2023-11-17 11:15,109,57,52,0,0,0
2023-11-17 11:30,101,52,49,0,0,0
2023-11-17 11:45,153,81,72,0,0,0
2023-11-17 12:00,130,59,71,0,0,0
2023-11-17 12:15,136,56,80,0,0,0
2023-11-17 12:30,163,67,96,0,0,0
2023-11-17 12:45,156,71,85,0,0,0
2023-11-17 13:00,162,51,111,0,0,0
2023-11-17 13:15,188,70,118,0,0,0
2023-11-17 13:30,160,55,105,0,0,0
2023-11-17 13:45,175,80,95,0,0,0
2023-11-17 14:00,165,60,105,0,0,0
2023-11-17 14:15,185,69,116,0,0,0
2023-11-17 14:30,149,61,88,0,0,0
2023-11-17 14:45,196,81,115,0,0,0
2023-11-17 15:00,153,63,90,0,0,0
2023-11-17 15:15,160,76,84,0,0,0
2023-11-17 15:30,157,71,86,0,0,0
2023-11-17 15:45,162,64,98,0,0,0
2023-11-17 16:00,210,101,109,0,0,0
2023-11-17 16:15,167,65,102,0,0,0
2023-11-17 16:30,179,76,103,0,0,0
2023-11-17 16:45,163,73,90,0,0,0
2023-11-17 17:00,153,66,87,0,0,0
2023-11-17 17:15,149,55,94,0,0,0
2023-11-17 17:30,156,53,103,0,0,0
2023-11-17 17:45,159,68,91,0,0,0
2023-11-17 18:00,131,46,85,0,0,0
2023-11-17 18:15,156,56,100,0,0,0
2023-11-17 18:30,122,35,87,0,0,0
2023-11-17 18:45,134,62,72,0,0,0
2023-11-17 19:00,118,44,74,0,0,0
2023-11-17 19:15,95,38,57,0,0,0
2023-11-17 19:30,97,33,64,0,0,0
2023-11-17 19:45,121,59,62,0,0,0
2023-11-17 20:00,95,50,45,0,0,0
2023-11-17 20:15,89,39,50,0,0,0
2023-11-17 20:30,69,29,40,0,0,0
2023-11-17 20:45,63,24,39,0,0,0
2023-11-17 21:00,51,17,34,0,0,0
2023-11-17 21:15,48,11,37,0,0,0
2023-11-17 21:30,66,22,44,0,0,0
2023-11-17 21:45,37,9,28,0,0,0
2023-11-17 22:00,65,20,45,0,0,0
2023-11-17 22:15,45,18,27,0,0,0
2023-11-17 22:30,38,13,25,0,0,0
2023-11-17 22:45,38,7,31,0,0,0
2023-11-17 23:00,39,12,27,0,0,0
2023-11-17 23:15,33,10,23,0,0,0
2023-11-17 23:30,47,14,33,0,0,0
2023-11-17 23:45,43,19,24,0,0,0
2023-11-18 00:00,36,16,20,0,0,0
2023-11-18 00:15,41,16,25,0,0,0
2023-11-18 00:30,22,14,8,0,0,0
2023-11-18 00:45,41,8,33,0,0,0
2023-11-18 01:00,25,9,16,0,0,0
2023-11-18 01:15,26,16,10,0,0,0
2023-11-18 01:30,25,10,15,0,0,0
2023-11-18 01:45,20,7,13,0,0,0
2023-11-18 02:00,13,11,2,0,0,0
2023-11-18 02:15,11,5,6,0,0,0
2023-11-18 02:30,16,10,6,0,0,0
2023-11-18 02:45,20,12,8,0,0,0
2023-11-18 03:00,9,5,4,0,0,0
2023-11-18 03:15,19,11,8,0,0,0
2023-11-18 03:30,11,5,6,0,0,0
2023-11-18 03:45,6,3,3,0,0,0
2023-11-18 04:00,12,5,7,0,0,0
2023-11-18 04:15,5,1,4,0,0,0
2023-11-18 04:30,4,1,3,0,0,0
2023-11-18 04:45,4,2,2,0,0,0
2023-11-18 05:00,5,4,1,0,0,0
2023-11-18 05:15,9,8,1,0,0,0
2023-11-18 05:30,15,8,7,0,0,0
2023-11-18 05:45,2,1,1,0,0,0
2023-11-18 06:00,6,5,1,0,0,0
2023-11-18 06:15,16,10,6,0,0,0
2023-11-18 06:30,6,4,2,0,0,0
2023-11-18 06:45,12,5,7,0,0,0
2023-11-18 07:00,8,4,4,0,0,0
2023-11-18 07:15,16,14,2,0,0,0
2023-11-18 07:30,21,10,11,0,0,0
2023-11-18 07:45,17,10,7,0,0,0
2023-11-18 08:00,34,22,12,0,0,0
2023-11-18 08:15,30,23,7,0,0,0
2023-11-18 08:30,35,18,17,0,0,0
2023-11-18 08:45,60,41,19,0,0,0
2023-11-18 09:00,66,39,27,0,0,0
2023-11-18 09:15,63,40,23,0,0,0
2023-11-18 09:30,81,53,28,0,0,0
2023-11-18 09:45,131,101,30,0,0,0
2023-11-18 10:00,105,69,36,0,0,0
2023-11-18 10:15,108,71,37,0,0,0
2023-11-18 10:30,112,74,38,0,0,0
2023-11-18 10:45,131,88,43,0,0,0
2023-11-18 11:00,127,79,48,0,0,0
2023-11-18 11:15,140,86,54,0,0,0
2023-11-18 11:30,146,71,75,0,0,0
2023-11-18 11:45,201,125,76,0,0,0
2023-11-18 12:00,158,87,71,0,0,0
2023-11-18 12:15,165,71,94,0,0,0
2023-11-18 12:30,162,77,85,0,0,0
2023-11-18 12:45,128,59,69,0,0,0
2023-11-18 13:00,175,72,103,0,0,0
2023-11-18 13:15,151,51,100,0,0,0
2023-11-18 13:30,149,71,78,0,0,0
2023-11-18 13:45,131,50,81,0,0,0
2023-11-18 14:00,125,43,82,0,0,0
2023-11-18 14:15,133,44,89,0,0,0
2023-11-18 14:30,104,33,71,0,0,0
2023-11-18 14:45,115,45,70,0,0,0
2023-11-18 15:00,104,66,38,0,0,0
2023-11-18 15:15,115,52,63,0,0,0
2023-11-18 15:30,107,49,58,0,0,0
2023-11-18 15:45,61,26,35,0,0,0
2023-11-18 16:00,95,29,66,0,0,0
2023-11-18 16:15,67,22,45,0,0,0
2023-11-18 16:30,70,25,45,0,0,0
2023-11-18 16:45,74,31,43,0,0,0
2023-11-18 17:00,57,18,39,0,0,0
2023-11-18 17:15,55,22,33,0,0,0
2023-11-18 17:30,42,18,24,0,0,0
2023-11-18 17:45,53,19,34,0,0,0
2023-11-18 18:00,59,15,44,0,0,0
2023-11-18 18:15,56,17,39,0,0,0
2023-11-18 18:30,48,18,30,0,0,0
2023-11-18 18:45,61,23,38,0,0,0
2023-11-18 19:00,65,17,48,0,0,0
2023-11-18 19:15,55,24,31,0,0,0
2023-11-18 19:30,56,24,32,0,0,0
2023-11-18 19:45,43,27,16,0,0,0
2023-11-18 20:00,70,31,39,0,0,0
2023-11-18 20:15,37,11,26,0,0,0
2023-11-18 20:30,29,12,17,0,0,0
2023-11-18 20:45,29,15,14,0,0,0
2023-11-18 21:00,42,20,22,0,0,0
2023-11-18 21:15,39,20,19,0,0,0
2023-11-18 21:30,31,11,20,0,0,0
2023-11-18 21:45,21,5,16,0,0,0
2023-11-18 22:00,19,6,13,0,0,0
2023-11-18 22:15,29,13,16,0,0,0
2023-11-18 22:30,17,6,11,0,0,0
2023-11-18 22:45,29,2,27,0,0,0
2023-11-18 23:00,22,3,19,0,0,0
2023-11-18 23:15,23,6,17,0,0,0
2023-11-18 23:30,20,8,12,0,0,0
2023-11-18 23:45,25,5,20,0,0,0
2023-11-19 00:00,18,6,12,0,0,0
2023-11-19 00:15,31,11,20,0,0,0
2023-11-19 00:30,32,17,15,0,0,0
2023-11-19 00:45,23,12,11,0,0,0
2023-11-19 01:00,14,4,10,0,0,0
2023-11-19 01:15,12,9,3,0,0,0
2023-11-19 01:30,28,8,20,0,0,0
2023-11-19 01:45,13,3,10,0,0,0
2023-11-19 02:00,16,7,9,0,0,0
2023-11-19 02:15,15,4,11,0,0,0
2023-11-19 02:30,11,2,9,0,0,0
2023-11-19 02:45,8,1,7,0,0,0
2023-11-19 03:00,9,3,6,0,0,0
2023-11-19 03:15,14,5,9,0,0,0
2023-11-19 03:30,7,2,5,0,0,0
2023-11-19 03:45,10,5,5,0,0,0
2023-11-19 04:00,10,7,3,0,0,0
2023-11-19 04:15,8,1,7,0,0,0
2023-11-19 04:30,4,0,4,0,0,0
2023-11-19 04:45,1,0,1,0,0,0
2023-11-19 05:00,5,2,3,0,0,0
2023-11-19 05:15,4,2,2,0,0,0
2023-11-19 05:30,7,3,4,0,0,0
2023-11-19 05:45,0,0,0,0,0,0
2023-11-19 06:00,7,5,2,0,0,0
2023-11-19 06:15,13,8,5,0,0,0
2023-11-19 06:30,2,1,1,0,0,0
2023-11-19 06:45,0,0,0,0,0,0
2023-11-19 07:00,3,2,1,0,0,0
2023-11-19 07:15,1,0,1,0,0,0
2023-11-19 07:30,1,0,1,0,0,0
2023-11-19 07:45,8,3,5,0,0,0
2023-11-19 08:00,9,4,5,0,0,0
2023-11-19 08:15,8,3,5,0,0,0
2023-11-19 08:30,11,8,3,0,0,0
2023-11-19 08:45,20,16,4,0,0,0
2023-11-19 09:00,10,7,3,0,0,0
2023-11-19 09:15,9,6,3,0,0,0
2023-11-19 09:30,24,12,12,0,0,0
2023-11-19 09:45,34,17,17,0,0,0
2023-11-19 10:00,32,19,13,0,0,0
2023-11-19 10:15,31,11,20,0,0,0
2023-11-19 10:30,47,34,13,0,0,0
2023-11-19 10:45,44,29,15,0,0,0
2023-11-19 11:00,37,26,11,0,0,0
2023-11-19 11:15,31,19,12,0,0,0
2023-11-19 11:30,26,16,10,0,0,0
2023-11-19 11:45,59,35,24,0,0,0
2023-11-19 12:00,43,22,21,0,0,0
2023-11-19 12:15,48,24,24,0,0,0
2023-11-19 12:30,50,16,34,0,0,0
2023-11-19 12:45,72,39,33,0,0,0
2023-11-19 13:00,31,12,19,0,0,0
2023-11-19 13:15,34,15,19,0,0,0
2023-11-19 13:30,43,28,15,0,0,0
2023-11-19 13:45,68,30,38,0,0,0
2023-11-19 14:00,57,31,26,0,0,0
2023-11-19 14:15,65,41,24,0,0,0
2023-11-19 14:30,52,17,35,0,0,0
2023-11-19 14:45,80,41,39,0,0,0
2023-11-19 15:00,60,33,27,0,0,0
2023-11-19 15:15,63,30,33,0,0,0
2023-11-19 15:30,55,21,34,0,0,0
2023-11-19 15:45,63,28,35,0,0,0
2023-11-19 16:00,48,13,35,0,0,0
2023-11-19 16:15,35,13,22,0,0,0
2023-11-19 16:30,39,19,20,0,0,0
2023-11-19 16:45,53,30,23,0,0,0
2023-11-19 17:00,63,28,35,0,0,0
2023-11-19 17:15,52,28,24,0,0,0
2023-11-19 17:30,42,17,25,0,0,0
2023-11-19 17:45,61,17,44,0,0,0
2023-11-19 18:00,46,17,29,0,0,0
2023-11-19 18:15,38,19,19,0,0,0
2023-11-19 18:30,36,17,19,0,0,0
2023-11-19 18:45,31,17,14,0,0,0
2023-11-19 19:00,40,16,24,0,0,0
2023-11-19 19:15,24,11,13,0,0,0
2023-11-19 19:30,31,14,17,0,0,0
2023-11-19 19:45,34,15,19,0,0,0
2023-11-19 20:00,34,10,24,0,0,0
2023-11-19 20:15,35,16,19,0,0,0
2023-11-19 20:30,40,16,24,0,0,0
2023-11-19 20:45,11,8,3,0,0,0
2023-11-19 21:00,17,9,8,0,0,0
2023-11-19 21:15,31,9,22,0,0,0
2023-11-19 21:30,12,4,8,0,0,0
2023-11-19 21:45,15,7,8,0,0,0
2023-11-19 22:00,19,6,13,0,0,0
2023-11-19 22:15,18,12,6,0,0,0
2023-11-19 22:30,17,6,11,0,0,0
2023-11-19 22:45,10,0,10,0,0,0
2023-11-19 23:00,6,2,4,0,0,0
2023-11-19 23:15,11,1,10,0,0,0
2023-11-19 23:30,3,0,3,0,0,0
2023-11-19 23:45,2,0,2,0,0,0
2023-11-20 00:00,2,0,2,0,0,0
2023-11-20 00:15,4,3,1,0,0,0
2023-11-20 00:30,6,2,4,0,0,0
2023-11-20 00:45,0,0,0,0,0,0
2023-11-20 01:00,0,0,0,0,0,0
2023-11-20 01:15,0,0,0,0,0,0
2023-11-20 01:30,1,0,1,0,0,0
2023-11-20 01:45,2,1,1,0,0,0
2023-11-20 02:00,1,0,1,0,0,0
2023-11-20 02:15,1,0,1,0,0,0
2023-11-20 02:30,1,1,0,0,0,0
2023-11-20 02:45,1,1,0,0,0,0
2023-11-20 03:00,0,0,0,0,0,0
2023-11-20 03:15,1,1,0,0,0,0
2023-11-20 03:30,1,1,0,0,0,0
2023-11-20 03:45,2,1,1,0,0,0
2023-11-20 04:00,0,0,0,0,0,0
2023-11-20 04:15,1,0,1,0,0,0
2023-11-20 04:30,1,1,0,0,0,0
2023-11-20 04:45,2,2,0,0,0,0
2023-11-20 05:00,4,3,1,0,0,0
2023-11-20 05:15,5,4,1,0,0,0
2023-11-20 05:30,14,8,6,0,0,0
2023-11-20 05:45,9,5,4,0,0,0
2023-11-20 06:00,22,17,5,0,0,0
2023-11-20 06:15,23,22,1,0,0,0
2023-11-20 06:30,47,31,16,0,0,0
2023-11-20 06:45,60,35,25,0,0,0
2023-11-20 07:00,82,52,30,0,0,0
2023-11-20 07:15,104,63,41,0,0,0
2023-11-20 07:30,166,111,55,0,0,0
2023-11-20 07:45,188,128,60,0,0,0
2023-11-20 08:00,162,115,47,0,0,0
2023-11-20 08:15,127,94,33,0,0,0
2023-11-20 08:30,133,87,46,0,0,0
2023-11-20 08:45,136,86,50,0,0,0
2023-11-20 09:00,121,86,35,0,0,0
2023-11-20 09:15,105,71,34,0,0,0
2023-11-20 09:30,87,64,23,0,0,0
2023-11-20 09:45,131,97,34,0,0,0
2023-11-20 10:00,98,65,33,0,0,0
2023-11-20 10:15,113,70,43,0,0,0
2023-11-20 10:30,105,72,33,0,0,0
2023-11-20 10:45,83,48,35,0,0,0
2023-11-20 11:00,105,59,46,0,0,0
2023-11-20 11:15,100,58,42,0,0,0
2023-11-20 11:30,109,47,62,0,0,0
2023-11-20 11:45,124,60,64,0,0,0
2023-11-20 12:00,109,51,58,0,0,0
2023-11-20 12:15,117,57,60,0,0,0
2023-11-20 12:30,148,74,74,0,0,0
2023-11-20 12:45,132,58,74,0,0,0
2023-11-20 13:00,127,64,63,0,0,0
2023-11-20 13:15,120,55,65,0,0,0
2023-11-20 13:30,131,59,72,0,0,0
2023-11-20 13:45,141,65,76,0,0,0
2023-11-20 14:00,152,73,79,0,0,0
2023-11-20 14:15,145,72,73,0,0,0
2023-11-20 14:30,136,69,67,0,0,0
2023-11-20 14:45,182,78,104,0,0,0
2023-11-20 15:00,153,68,85,0,0,0
2023-11-20 15:15,184,72,112,0,0,0
2023-11-20 15:30,179,78,101,0,0,0
2023-11-20 15:45,189,78,111,0,0,0
2023-11-20 16:00,205,83,122,0,0,0
2023-11-20 16:15,208,83,125,0,0,0
2023-11-20 16:30,177,76,101,0,0,0
2023-11-20 16:45,174,66,108,0,0,0
2023-11-20 17:00,185,72,113,0,0,0
2023-11-20 17:15,157,61,96,0,0,0
2023-11-20 17:30,177,64,113,0,0,0
2023-11-20 17:45,212,88,124,0,0,0
2023-11-20 18:00,174,68,106,0,0,0
2023-11-20 18:15,161,57,104,0,0,0
2023-11-20 18:30,141,61,80,0,0,0
2023-11-20 18:45,124,55,69,0,0,0
2023-11-20 19:00,106,27,79,0,0,0
2023-11-20 19:15,116,36,80,0,0,0
2023-11-20 19:30,93,42,51,0,0,0
2023-11-20 19:45,110,30,80,0,0,0
2023-11-20 20:00,94,25,69,0,0,0
2023-11-20 20:15,73,22,51,0,0,0
2023-11-20 20:30,50,18,32,0,0,0
2023-11-20 20:45,50,13,37,0,0,0
2023-11-20 21:00,52,19,33,0,0,0
2023-11-20 21:15,51,13,38,0,0,0
2023-11-20 21:30,43,18,25,0,0,0
2023-11-20 21:45,56,28,28,0,0,0
2023-11-20 22:00,64,22,42,0,0,0
2023-11-20 22:15,52,9,43,0,0,0
2023-11-20 22:30,34,12,22,0,0,0
2023-11-20 22:45,26,8,18,0,0,0
2023-11-20 23:00,26,5,21,0,0,0
2023-11-20 23:15,18,3,15,0,0,0
2023-11-20 23:30,11,2,9,0,0,0
2023-11-20 23:45,16,10,6,0,0,0
2023-11-21 00:00,8,2,6,0,0,0
2023-11-21 00:15,11,5,6,0,0,0
2023-11-21 00:30,2,0,2,0,0,0
2023-11-21 00:45,4,2,2,0,0,0
2023-11-21 01:00,0,0,0,0,0,0
2023-11-21 01:15,1,1,0,0,0,0
2023-11-21 01:30,0,0,0,0,0,0
2023-11-21 01:45,1,0,1,0,0,0
2023-11-21 02:00,1,0,1,0,0,0
2023-11-21 02:15,0,0,0,0,0,0
2023-11-21 02:30,1,0,1,0,0,0
2023-11-21 02:45,0,0,0,0,0,0
2023-11-21 03:00,0,0,0,0,0,0
2023-11-21 03:15,1,0,1,0,0,0
2023-11-21 03:30,2,2,0,0,0,0
2023-11-21 03:45,0,0,0,0,0,0
2023-11-21 04:00,4,4,0,0,0,0
2023-11-21 04:15,0,0,0,0,0,0
2023-11-21 04:30,1,1,0,0,0,0
2023-11-21 04:45,2,2,0,0,0,0
2023-11-21 05:00,7,5,2,0,0,0
2023-11-21 05:15,8,6,2,0,0,0
2023-11-21 05:30,22,12,10,0,0,0
2023-11-21 05:45,7,5,2,0,0,0
2023-11-21 06:00,29,16,13,0,0,0
2023-11-21 06:15,39,31,8,0,0,0
2023-11-21 06:30,54,35,19,0,0,0
2023-11-21 06:45,65,38,27,0,0,0
2023-11-21 07:00,85,57,28,0,0,0
2023-11-21 07:15,124,78,46,0,0,0
2023-11-21 07:30,190,126,64,0,0,0
2023-11-21 07:45,194,130,64,0,0,0
2023-11-21 08:00,164,101,63,0,0,0
2023-11-21 08:15,181,118,63,0,0,0
2023-11-21 08:30,124,90,34,0,0,0
2023-11-21 08:45,149,98,51,0,0,0
2023-11-21 09:00,92,44,48,0,0,0
2023-11-21 09:15,92,52,40,0,0,0
2023-11-21 09:30,111,71,40,0,0,0
2023-11-21 09:45,111,81,30,0,0,0
2023-11-21 10:00,94,67,27,0,0,0
2023-11-21 10:15,67,46,21,0,0,0
2023-11-21 10:30,86,51,35,0,0,0
2023-11-21 10:45,83,42,41,0,0,0
2023-11-21 11:00,99,48,51,0,0,0
2023-11-21 11:15,100,41,59,0,0,0
2023-11-21 11:30,85,50,35,0,0,0
2023-11-21 11:45,134,75,59,0,0,0
2023-11-21 12:00,135,63,72,0,0,0
2023-11-21 12:15,115,60,55,0,0,0
2023-11-21 12:30,111,37,74,0,0,0
2023-11-21 12:45,112,51,61,0,0,0
2023-11-21 13:00,129,50,79,0,0,0
2023-11-21 13:15,132,58,74,0,0,0
2023-11-21 13:30,115,46,69,0,0,0
2023-11-21 13:45,165,81,84,0,0,0
2023-11-21 14:00,131,62,69,0,0,0
2023-11-21 14:15,115,49,66,0,0,0
2023-11-21 14:30,175,69,106,0,0,0
2023-11-21 14:45,158,67,91,0,0,0
2023-11-21 15:00,174,75,99,0,0,0
2023-11-21 15:15,171,82,89,0,0,0
2023-11-21 15:30,174,76,98,0,0,0
2023-11-21 15:45,179,77,102,0,0,0
2023-11-21 16:00,191,86,105,0,0,0
2023-11-21 16:15,201,80,121,0,0,0
2023-11-21 16:30,158,54,104,0,0,0
2023-11-21 16:45,183,82,101,0,0,0
2023-11-21 17:00,176,71,105,0,0,0
2023-11-21 17:15,197,68,129,0,0,0
2023-11-21 17:30,161,64,97,0,0,0
2023-11-21 17:45,182,69,113,0,0,0
2023-11-21 18:00,176,54,122,0,0,0
2023-11-21 18:15,172,55,117,0,0,0
2023-11-21 18:30,137,58,79,0,0,0
2023-11-21 18:45,165,76,89,0,0,0
2023-11-21 19:00,112,22,90,0,0,0
2023-11-21 19:15,110,40,70,0,0,0
2023-11-21 19:30,111,41,70,0,0,0
2023-11-21 19:45,104,36,68,0,0,0
2023-11-21 20:00,92,28,64,0,0,0
2023-11-21 20:15,64,16,48,0,0,0
2023-11-21 20:30,61,23,38,0,0,0
2023-11-21 20:45,48,15,33,0,0,0
2023-11-21 21:00,50,19,31,0,0,0
2023-11-21 21:15,52,5,47,0,0,0
2023-11-21 21:30,79,26,53,0,0,0
2023-11-21 21:45,62,17,45,0,0,0
2023-11-21 22:00,34,9,25,0,0,0
2023-11-21 22:15,62,18,44,0,0,0
2023-11-21 22:30,49,21,28,0,0,0
2023-11-21 22:45,37,6,31,0,0,0
2023-11-21 23:00,33,11,22,0,0,0
2023-11-21 23:15,27,8,19,0,0,0
2023-11-21 23:30,17,3,14,0,0,0
2023-11-21 23:45,16,4,12,0,0,0
2023-11-22 00:00,12,2,10,0,0,0
2023-11-22 00:15,11,2,9,0,0,0
2023-11-22 00:30,2,1,1,0,0,0
2023-11-22 00:45,5,1,4,0,0,0
2023-11-22 01:00,4,1,3,0,0,0
2023-11-22 01:15,9,2,7,0,0,0
2023-11-22 01:30,0,0,0,0,0,0
2023-11-22 01:45,3,0,3,0,0,0
2023-11-22 02:00,0,0,0,0,0,0
2023-11-22 02:15,1,0,1,0,0,0
2023-11-22 02:30,0,0,0,0,0,0
2023-11-22 02:45,3,1,2,0,0,0
2023-11-22 03:00,0,0,0,0,0,0
2023-11-22 03:15,3,3,0,0,0,0
2023-11-22 03:30,2,1,1,0,0,0
2023-11-22 03:45,2,2,0,0,0,0
2023-11-22 04:00,2,2,0,0,0,0
2023-11-22 04:15,1,0,1,0,0,0
2023-11-22 04:30,0,0,0,0,0,0
2023-11-22 04:45,2,2,0,0,0,0
2023-11-22 05:00,4,3,1,0,0,0
2023-11-22 05:15,7,5,2,0,0,0
2023-11-22 05:30,17,10,7,0,0,0
2023-11-22 05:45,13,10,3,0,0,0
2023-11-22 06:00,30,19,11,0,0,0
2023-11-22 06:15,35,27,8,0,0,0
2023-11-22 06:30,41,29,12,0,0,0
2023-11-22 06:45,62,42,20,0,0,0
2023-11-22 07:00,80,59,21,0,0,0
2023-11-22 07:15,124,83,41,0,0,0
2023-11-22 07:30,164,105,59,0,0,0
2023-11-22 07:45,204,130,74,0,0,0
2023-11-22 08:00,173,121,52,0,0,0
2023-11-22 08:15,171,112,59,0,0,0
2023-11-22 08:30,134,85,49,0,0,0
2023-11-22 08:45,144,101,43,0,0,0
2023-11-22 09:00,119,74,45,0,0,0
2023-11-22 09:15,111,76,35,0,0,0
2023-11-22 09:30,107,69,38,0,0,0
2023-11-22 09:45,132,97,35,0,0,0
2023-11-22 10:00,124,93,31,0,0,0
2023-11-22 10:15,114,63,51,0,0,0
2023-11-22 10:30,111,62,49,0,0,0
2023-11-22 10:45,119,71,48,0,0,0
2023-11-22 11:00,105,53,52,0,0,0
2023-11-22 11:15,127,63,64,0,0,0
2023-11-22 11:30,117,70,47,0,0,0
2023-11-22 11:45,152,88,64,0,0,0
2023-11-22 12:00,147,54,93,0,0,0
2023-11-22 12:15,155,76,79,0,0,0
2023-11-22 12:30,158,61,97,0,0,0
2023-11-22 12:45,146,76,70,0,0,0
2023-11-22 13:00,159,63,96,0,0,0
2023-11-22 13:15,147,63,84,0,0,0
2023-11-22 13:30,148,56,92,0,0,0
2023-11-22 13:45,170,56,114,0,0,0
2023-11-22 14:00,151,66,85,0,0,0
2023-11-22 14:15,159,55,104,0,0,0
2023-11-22 14:30,145,67,78,0,0,0
2023-11-22 14:45,194,91,103,0,0,0
2023-11-22 15:00,147,61,86,0,0,0
2023-11-22 15:15,153,69,84,0,0,0
2023-11-22 15:30,164,56,108,0,0,0
2023-11-22 15:45,205,88,117,0,0,0
2023-11-22 16:00,166,59,107,0,0,0
2023-11-22 16:15,188,84,104,0,0,0
2023-11-22 16:30,188,62,126,0,0,0
2023-11-22 16:45,180,59,121,0,0,0
2023-11-22 17:00,198,75,123,0,0,0
2023-11-22 17:15,170,70,100,0,0,0
2023-11-22 17:30,213,91,122,0,0,0
2023-11-22 17:45,224,91,133,0,0,0
2023-11-22 18:00,161,43,118,0,0,0
2023-11-22 18:15,184,71,113,0,0,0
2023-11-22 18:30,147,58,89,0,0,0
2023-11-22 18:45,133,51,82,0,0,0
2023-11-22 19:00,123,43,80,0,0,0
2023-11-22 19:15,129,57,72,0,0,0
2023-11-22 19:30,114,47,67,0,0,0
2023-11-22 19:45,126,47,79,0,0,0
2023-11-22 20:00,93,24,69,0,0,0
2023-11-22 20:15,90,21,69,0,0,0
2023-11-22 20:30,66,32,34,0,0,0
2023-11-22 20:45,57,30,27,0,0,0
2023-11-22 21:00,52,8,44,0,0,0
2023-11-22 21:15,53,14,39,0,0,0
2023-11-22 21:30,72,29,43,0,0,0
2023-11-22 21:45,69,19,50,0,0,0
2023-11-22 22:00,54,20,34,0,0,0
2023-11-22 22:15,77,21,56,0,0,0
2023-11-22 22:30,50,14,36,0,0,0
2023-11-22 22:45,45,14,31,0,0,0
2023-11-22 23:00,28,4,24,0,0,0
2023-11-22 23:15,26,9,17,0,0,0
2023-11-22 23:30,28,10,18,0,0,0
2023-11-22 23:45,26,15,11,0,0,0
2023-11-23 00:00,20,3,17,0,0,0
2023-11-23 00:15,18,2,16,0,0,0
2023-11-23 00:30,14,1,13,0,0,0
2023-11-23 00:45,6,3,3,0,0,0
2023-11-23 01:00,6,2,4,0,0,0
2023-11-23 01:15,7,3,4,0,0,0
2023-11-23 01:30,5,0,5,0,0,0
2023-11-23 01:45,8,0,8,0,0,0
2023-11-23 02:00,5,0,5,0,0,0
2023-11-23 02:15,4,0,4,0,0,0
2023-11-23 02:30,4,0,4,0,0,0
2023-11-23 02:45,5,0,5,0,0,0
2023-11-23 03:00,0,0,0,0,0,0
2023-11-23 03:15,3,0,3,0,0,0
2023-11-23 03:30,6,1,5,0,0,0
2023-11-23 03:45,2,0,2,0,0,0
2023-11-23 04:00,2,0,2,0,0,0
2023-11-23 04:15,4,0,4,0,0,0
2023-11-23 04:30,1,0,1,0,0,0
2023-11-23 04:45,2,2,0,0,0,0
2023-11-23 05:00,3,3,0,0,0,0
2023-11-23 05:15,13,6,7,0,0,0
2023-11-23 05:30,20,9,11,0,0,0
2023-11-23 05:45,12,10,2,0,0,0
2023-11-23 06:00,26,20,6,0,0,0
2023-11-23 06:15,37,31,6,0,0,0
2023-11-23 06:30,42,28,14,0,0,0
2023-11-23 06:45,85,53,32,0,0,0
2023-11-23 07:00,80,47,33,0,0,0
2023-11-23 07:15,134,92,42,0,0,0
2023-11-23 07:30,181,118,63,0,0,0
2023-11-23 07:45,185,135,50,0,0,0
2023-11-23 08:00,143,93,50,0,0,0
2023-11-23 08:15,131,78,53,0,0,0
2023-11-23 08:30,139,90,49,0,0,0
2023-11-23 08:45,147,94,53,0,0,0
2023-11-23 09:00,84,54,30,0,0,0
2023-11-23 09:15,96,62,34,0,0,0
2023-11-23 09:30,124,76,48,0,0,0
2023-11-23 09:45,140,99,41,0,0,0
2023-11-23 10:00,110,75,35,0,0,0
2023-11-23 10:15,91,58,33,0,0,0
2023-11-23 10:30,91,48,43,0,0,0
2023-11-23 10:45,94,50,44,0,0,0
2023-11-23 11:00,101,53,48,0,0,0
2023-11-23 11:15,90,47,43,0,0,0
2023-11-23 11:30,117,65,52,0,0,0
2023-11-23 11:45,128,67,61,0,0,0
2023-11-23 12:00,142,63,79,0,0,0
2023-11-23 12:15,99,47,52,0,0,0
2023-11-23 12:30,133,49,84,0,0,0
2023-11-23 12:45,132,61,71,0,0,0
2023-11-23 13:00,148,59,89,0,0,0
2023-11-23 13:15,120,47,73,0,0,0
2023-11-23 13:30,134,64,70,0,0,0
2023-11-23 13:45,175,83,92,0,0,0
2023-11-23 14:00,129,49,80,0,0,0
2023-11-23 14:15,145,64,81,0,0,0
2023-11-23 14:30,118,52,66,0,0,0
2023-11-23 14:45,158,67,91,0,0,0
2023-11-23 15:00,125,53,72,0,0,0
2023-11-23 15:15,148,67,81,0,0,0
2023-11-23 15:30,175,70,105,0,0,0
2023-11-23 15:45,204,94,110,0,0,0
2023-11-23 16:00,218,75,143,0,0,0
2023-11-23 16:15,182,73,109,0,0,0
2023-11-23 16:30,196,73,123,0,0,0
2023-11-23 16:45,201,95,106,0,0,0
2023-11-23 17:00,158,48,110,0,0,0
2023-11-23 17:15,155,55,100,0,0,0
2023-11-23 17:30,203,58,145,0,0,0
2023-11-23 17:45,169,61,108,0,0,0
2023-11-23 18:00,165,52,113,0,0,0
2023-11-23 18:15,134,42,92,0,0,0
2023-11-23 18:30,113,34,79,0,0,0
2023-11-23 18:45,117,44,73,0,0,0
2023-11-23 19:00,93,33,60,0,0,0
2023-11-23 19:15,103,35,68,0,0,0
2023-11-23 19:30,98,36,62,0,0,0
2023-11-23 19:45,71,29,42,0,0,0
2023-11-23 20:00,74,26,48,0,0,0
2023-11-23 20:15,70,24,46,0,0,0
2023-11-23 20:30,45,10,35,0,0,0
2023-11-23 20:45,48,17,31,0,0,0
2023-11-23 21:00,46,15,31,0,0,0
2023-11-23 21:15,56,13,43,0,0,0
2023-11-23 21:30,45,18,27,0,0,0
2023-11-23 21:45,42,12,30,0,0,0
2023-11-23 22:00,54,22,32,0,0,0
2023-11-23 22:15,40,8,32,0,0,0
2023-11-23 22:30,34,12,22,0,0,0
2023-11-23 22:45,33,9,24,0,0,0
2023-11-23 23:00,36,5,31,0,0,0
2023-11-23 23:15,28,18,10,0,0,0
2023-11-23 23:30,20,4,16,0,0,0
2023-11-23 23:45,14,6,8,0,0,0
2023-11-24 00:00,15,1,14,0,0,0
2023-11-24 00:15,18,4,14,0,0,0
2023-11-24 00:30,8,3,5,0,0,0
2023-11-24 00:45,4,3,1,0,0,0
2023-11-24 01:00,1,0,1,0,0,0
2023-11-24 01:15,3,0,3,0,0,0
2023-11-24 01:30,1,0,1,0,0,0
2023-11-24 01:45,0,0,0,0,0,0
2023-11-24 02:00,5,3,2,0,0,0
2023-11-24 02:15,4,2,2,0,0,0
2023-11-24 02:30,1,0,1,0,0,0
2023-11-24 02:45,2,0,2,0,0,0
2023-11-24 03:00,4,0,4,0,0,0
2023-11-24 03:15,2,0,2,0,0,0
2023-11-24 03:30,1,1,0,0,0,0
2023-11-24 03:45,3,0,3,0,0,0
2023-11-24 04:00,1,1,0,0,0,0
2023-11-24 04:15,0,0,0,0,0,0
2023-11-24 04:30,1,1,0,0,0,0
2023-11-24 04:45,2,2,0,0,0,0
2023-11-24 05:00,5,4,1,0,0,0
2023-11-24 05:15,5,2,3,0,0,0
2023-11-24 05:30,12,6,6,0,0,0
2023-11-24 05:45,15,11,4,0,0,0
2023-11-24 06:00,14,9,5,0,0,0
2023-11-24 06:15,29,21,8,0,0,0
2023-11-24 06:30,37,24,13,0,0,0
2023-11-24 06:45,56,35,21,0,0,0
2023-11-24 07:00,66,39,27,0,0,0
2023-11-24 07:15,91,52,39,0,0,0
2023-11-24 07:30,157,103,54,0,0,0
2023-11-24 07:45,169,110,59,0,0,0
2023-11-24 08:00,128,84,44,0,0,0
2023-11-24 08:15,130,79,51,0,0,0
2023-11-24 08:30,99,63,36,0,0,0
2023-11-24 08:45,123,70,53,0,0,0
2023-11-24 09:00,86,56,30,0,0,0
2023-11-24 09:15,79,48,31,0,0,0
2023-11-24 09:30,87,63,24,0,0,0
2023-11-24 09:45,91,59,32,0,0,0
2023-11-24 10:00,84,52,32,0,0,0
2023-11-24 10:15,58,31,27,0,0,0
2023-11-24 10:30,64,28,36,0,0,0
2023-11-24 10:45,79,42,37,0,0,0
2023-11-24 11:00,76,34,42,0,0,0
2023-11-24 11:15,83,43,40,0,0,0
2023-11-24 11:30,98,52,46,0,0,0
2023-11-24 11:45,125,59,66,0,0,0
2023-11-24 12:00,119,60,59,0,0,0
2023-11-24 12:15,139,60,79,0,0,0
2023-11-24 12:30,148,62,86,0,0,0
2023-11-24 12:45,141,56,85,0,0,0
2023-11-24 13:00,149,54,95,0,0,0
2023-11-24 13:15,140,59,81,0,0,0
2023-11-24 13:30,120,43,77,0,0,0
2023-11-24 13:45,146,73,73,0,0,0
2023-11-24 14:00,133,38,95,0,0,0
2023-11-24 14:15,146,51,95,0,0,0
2023-11-24 14:30,133,62,71,0,0,0
2023-11-24 14:45,134,61,73,0,0,0
2023-11-24 15:00,128,45,83,0,0,0
2023-11-24 15:15,132,44,88,0,0,0
2023-11-24 15:30,125,48,77,0,0,0
2023-11-24 15:45,137,63,74,0,0,0
2023-11-24 16:00,119,37,82,0,0,0
2023-11-24 16:15,138,56,82,0,0,0
2023-11-24 16:30,148,62,86,0,0,0
2023-11-24 16:45,119,53,66,0,0,0
2023-11-24 17:00,112,52,60,0,0,0
2023-11-24 17:15,108,52,56,0,0,0
2023-11-24 17:30,97,41,56,0,0,0
2023-11-24 17:45,124,50,74,0,0,0
2023-11-24 18:00,111,40,71,0,0,0
2023-11-24 18:15,97,31,66,0,0,0
2023-11-24 18:30,114,33,81,0,0,0
2023-11-24 18:45,132,51,81,0,0,0
2023-11-24 19:00,107,30,77,0,0,0
2023-11-24 19:15,75,26,49,0,0,0
2023-11-24 19:30,61,14,47,0,0,0
2023-11-24 19:45,78,33,45,0,0,0
2023-11-24 20:00,87,34,53,0,0,0
2023-11-24 20:15,65,32,33,0,0,0
2023-11-24 20:30,45,21,24,0,0,0
2023-11-24 20:45,34,17,17,0,0,0
2023-11-24 21:00,47,20,27,0,0,0
2023-11-24 21:15,46,16,30,0,0,0
2023-11-24 21:30,48,21,27,0,0,0
2023-11-24 21:45,37,19,18,0,0,0
2023-11-24 22:00,23,13,10,0,0,0
2023-11-24 22:15,40,12,28,0,0,0
2023-11-24 22:30,37,17,20,0,0,0
2023-11-24 22:45,39,21,18,0,0,0
2023-11-24 23:00,50,18,32,0,0,0
2023-11-24 23:15,36,13,23,0,0,0
2023-11-24 23:30,33,9,24,0,0,0
2023-11-24 23:45,27,8,19,0,0,0
2023-11-25 00:00,38,22,16,0,0,0
2023-11-25 00:15,35,14,21,0,0,0
2023-11-25 00:30,25,9,16,0,0,0
2023-11-25 00:45,31,9,22,0,0,0
2023-11-25 01:00,30,5,25,0,0,0
2023-11-25 01:15,19,5,14,0,0,0
2023-11-25 01:30,14,8,6,0,0,0
2023-11-25 01:45,15,3,12,0,0,0
2023-11-25 02:00,15,9,6,0,0,0
2023-11-25 02:15,17,3,14,0,0,0
2023-11-25 02:30,10,1,9,0,0,0
2023-11-25 02:45,15,2,13,0,0,0
2023-11-25 03:00,7,1,6,0,0,0
2023-11-25 03:15,14,0,14,0,0,0
2023-11-25 03:30,14,3,11,0,0,0
2023-11-25 03:45,5,3,2,0,0,0
2023-11-25 04:00,6,2,4,0,0,0
2023-11-25 04:15,4,0,4,0,0,0
2023-11-25 04:30,0,0,0,0,0,0
2023-11-25 04:45,2,0,2,0,0,0
2023-11-25 05:00,4,2,2,0,0,0
2023-11-25 05:15,1,1,0,0,0,0
2023-11-25 05:30,10,5,5,0,0,0
2023-11-25 05:45,9,4,5,0,0,0
2023-11-25 06:00,5,3,2,0,0,0
2023-11-25 06:15,5,4,1,0,0,0
2023-11-25 06:30,6,4,2,0,0,0
2023-11-25 06:45,14,11,3,0,0,0
2023-11-25 07:00,14,9,5,0,0,0
2023-11-25 07:15,11,5,6,0,0,0
2023-11-25 07:30,20,12,8,0,0,0
2023-11-25 07:45,20,9,11,0,0,0
2023-11-25 08:00,19,18,1,0,0,0
2023-11-25 08:15,20,13,7,0,0,0
2023-11-25 08:30,41,29,12,0,0,0
2023-11-25 08:45,59,34,25,0,0,0
2023-11-25 09:00,48,29,19,0,0,0
2023-11-25 09:15,64,43,21,0,0,0
2023-11-25 09:30,57,39,18,0,0,0
2023-11-25 09:45,76,57,19,0,0,0
2023-11-25 10:00,51,40,11,0,0,0
2023-11-25 10:15,58,43,15,0,0,0
2023-11-25 10:30,71,45,26,0,0,0
2023-11-25 10:45,104,66,38,0,0,0
2023-11-25 11:00,82,58,24,0,0,0
2023-11-25 11:15,107,63,44,0,0,0
2023-11-25 11:30,109,62,47,0,0,0
2023-11-25 11:45,146,71,75,0,0,0
2023-11-25 12:00,126,77,49,0,0,0
2023-11-25 12:15,116,63,53,0,0,0
2023-11-25 12:30,106,42,64,0,0,0
2023-11-25 12:45,105,59,46,0,0,0
2023-11-25 13:00,112,45,67,0,0,0
2023-11-25 13:15,73,31,42,0,0,0
2023-11-25 13:30,135,72,63,0,0,0
2023-11-25 13:45,104,53,51,0,0,0
2023-11-25 14:00,96,39,57,0,0,0
2023-11-25 14:15,119,62,57,0,0,0
2023-11-25 14:30,99,44,55,0,0,0
2023-11-25 14:45,123,52,71,0,0,0
2023-11-25 15:00,71,26,45,0,0,0
2023-11-25 15:15,97,44,53,0,0,0
2023-11-25 15:30,85,37,48,0,0,0
2023-11-25 15:45,140,62,78,0,0,0
2023-11-25 16:00,81,34,47,0,0,0
2023-11-25 16:15,100,36,64,0,0,0
2023-11-25 16:30,123,46,77,0,0,0
2023-11-25 16:45,71,29,42,0,0,0
2023-11-25 17:00,86,35,51,0,0,0
2023-11-25 17:15,92,25,67,0,0,0
2023-11-25 17:30,98,35,63,0,0,0
2023-11-25 17:45,118,48,70,0,0,0
2023-11-25 18:00,99,31,68,0,0,0
2023-11-25 18:15,110,36,74,0,0,0
2023-11-25 18:30,108,35,73,0,0,0
2023-11-25 18:45,135,47,88,0,0,0
2023-11-25 19:00,88,28,60,0,0,0
2023-11-25 19:15,80,20,60,0,0,0
2023-11-25 19:30,66,33,33,0,0,0
2023-11-25 19:45,70,26,44,0,0,0
2023-11-25 20:00,80,25,55,0,0,0
2023-11-25 20:15,44,24,20,0,0,0
2023-11-25 20:30,45,18,27,0,0,0
2023-11-25 20:45,38,19,19,0,0,0
2023-11-25 21:00,34,14,20,0,0,0
2023-11-25 21:15,44,14,30,0,0,0
2023-11-25 21:30,89,73,16,0,0,0
2023-11-25 21:45,82,58,24,0,0,0
2023-11-25 22:00,40,24,16,0,0,0
2023-11-25 22:15,28,11,17,0,0,0
2023-11-25 22:30,22,10,12,0,0,0
2023-11-25 22:45,51,18,33,0,0,0
2023-11-25 23:00,41,14,27,0,0,0
2023-11-25 23:15,31,14,17,0,0,0
2023-11-25 23:30,33,17,16,0,0,0
2023-11-25 23:45,32,11,21,0,0,0
2023-11-26 00:00,41,19,22,0,0,0
2023-11-26 00:15,45,13,32,0,0,0
2023-11-26 00:30,16,7,9,0,0,0
2023-11-26 00:45,22,9,13,0,0,0
2023-11-26 01:00,24,11,13,0,0,0
2023-11-26 01:15,24,7,17,0,0,0
2023-11-26 01:30,26,6,20,0,0,0
2023-11-26 01:45,22,12,10,0,0,0
2023-11-26 02:00,16,12,4,0,0,0
2023-11-26 02:15,20,7,13,0,0,0
2023-11-26 02:30,17,7,10,0,0,0
2023-11-26 02:45,17,1,16,0,0,0
2023-11-26 03:00,21,9,12,0,0,0
2023-11-26 03:15,7,0,7,0,0,0
2023-11-26 03:30,7,5,2,0,0,0
2023-11-26 03:45,10,4,6,0,0,0
2023-11-26 04:00,10,4,6,0,0,0
2023-11-26 04:15,0,0,0,0,0,0
2023-11-26 04:30,3,2,1,0,0,0
2023-11-26 04:45,7,3,4,0,0,0
2023-11-26 05:00,3,1,2,0,0,0
2023-11-26 05:15,1,1,0,0,0,0
2023-11-26 05:30,9,5,4,0,0,0
2023-11-26 05:45,9,2,7,0,0,0
2023-11-26 06:00,5,1,4,0,0,0
2023-11-26 06:15,3,1,2,0,0,0
2023-11-26 06:30,7,3,4,0,0,0
2023-11-26 06:45,3,3,0,0,0,0
2023-11-26 07:00,4,3,1,0,0,0
2023-11-26 07:15,4,1,3,0,0,0
2023-11-26 07:30,3,1,2,0,0,0
2023-11-26 07:45,8,4,4,0,0,0
2023-11-26 08:00,9,4,5,0,0,0
2023-11-26 08:15,5,3,2,0,0,0
2023-11-26 08:30,16,10,6,0,0,0
2023-11-26 08:45,17,6,11,0,0,0
2023-11-26 09:00,19,13,6,0,0,0
2023-11-26 09:15,26,15,11,0,0,0
2023-11-26 09:30,25,15,10,0,0,0
2023-11-26 09:45,48,27,21,0,0,0
2023-11-26 10:00,22,15,7,0,0,0
2023-11-26 10:15,32,25,7,0,0,0
2023-11-26 10:30,47,28,19,0,0,0
2023-11-26 10:45,43,22,21,0,0,0
2023-11-26 11:00,42,19,23,0,0,0
2023-11-26 11:15,35,20,15,0,0,0
2023-11-26 11:30,34,15,19,0,0,0
2023-11-26 11:45,41,19,22,0,0,0
2023-11-26 12:00,38,19,19,0,0,0
2023-11-26 12:15,33,18,15,0,0,0
2023-11-26 12:30,59,31,28,0,0,0
2023-11-26 12:45,63,32,31,0,0,0
2023-11-26 13:00,63,25,38,0,0,0
2023-11-26 13:15,44,21,23,0,0,0
2023-11-26 13:30,77,36,41,0,0,0
2023-11-26 13:45,61,26,35,0,0,0
2023-11-26 14:00,50,19,31,0,0,0
2023-11-26 14:15,44,19,25,0,0,0
2023-11-26 14:30,68,35,33,0,0,0
2023-11-26 14:45,41,22,19,0,0,0
2023-11-26 15:00,65,38,27,0,0,0
2023-11-26 15:15,72,39,33,0,0,0
2023-11-26 15:30,52,20,32,0,0,0
2023-11-26 15:45,51,17,34,0,0,0
2023-11-26 16:00,49,18,31,0,0,0
2023-11-26 16:15,54,13,41,0,0,0
2023-11-26 16:30,43,18,25,0,0,0
2023-11-26 16:45,41,15,26,0,0,0
2023-11-26 17:00,70,31,39,0,0,0
2023-11-26 17:15,48,11,37,0,0,0
2023-11-26 17:30,46,13,33,0,0,0
2023-11-26 17:45,75,27,48,0,0,0
2023-11-26 18:00,62,20,42,0,0,0
2023-11-26 18:15,91,18,73,0,0,0
2023-11-26 18:30,108,17,91,0,0,0
2023-11-26 18:45,115,20,95,0,0,0
2023-11-26 19:00,58,6,52,0,0,0
2023-11-26 19:15,41,16,25,0,0,0
2023-11-26 19:30,35,14,21,0,0,0
2023-11-26 19:45,38,9,29,0,0,0
2023-11-26 20:00,38,18,20,0,0,0
2023-11-26 20:15,34,12,22,0,0,0
2023-11-26 20:30,28,10,18,0,0,0
2023-11-26 20:45,26,9,17,0,0,0
2023-11-26 21:00,13,7,6,0,0,0
2023-11-26 21:15,19,11,8,0,0,0
2023-11-26 21:30,70,49,21,0,0,0
2023-11-26 21:45,187,176,11,0,0,0
2023-11-26 22:00,44,38,6,0,0,0
2023-11-26 22:15,28,17,11,0,0,0
2023-11-26 22:30,20,8,12,0,0,0
2023-11-26 22:45,8,3,5,0,0,0
2023-11-26 23:00,17,7,10,0,0,0
2023-11-26 23:15,17,6,11,0,0,0
2023-11-26 23:30,7,5,2,0,0,0
2023-11-26 23:45,6,4,2,0,0,0
2023-11-27 00:00,7,2,5,0,0,0
2023-11-27 00:15,4,2,2,0,0,0
2023-11-27 00:30,6,3,3,0,0,0
2023-11-27 00:45,6,1,5,0,0,0
2023-11-27 01:00,0,0,0,0,0,0
2023-11-27 01:15,0,0,0,0,0,0
2023-11-27 01:30,1,0,1,0,0,0
2023-11-27 01:45,5,3,2,0,0,0
2023-11-27 02:00,3,0,3,0,0,0
2023-11-27 02:15,0,0,0,0,0,0
2023-11-27 02:30,1,1,0,0,0,0
2023-11-27 02:45,2,0,2,0,0,0
2023-11-27 03:00,0,0,0,0,0,0
2023-11-27 03:15,0,0,0,0,0,0
2023-11-27 03:30,2,2,0,0,0,0
2023-11-27 03:45,0,0,0,0,0,0
2023-11-27 04:00,1,1,0,0,0,0
2023-11-27 04:15,0,0,0,0,0,0
2023-11-27 04:30,2,2,0,0,0,0
2023-11-27 04:45,3,3,0,0,0,0
2023-11-27 05:00,2,2,0,0,0,0
2023-11-27 05:15,11,6,5,0,0,0
2023-11-27 05:30,12,6,6,0,0,0
2023-11-27 05:45,9,8,1,0,0,0
2023-11-27 06:00,11,7,4,0,0,0
2023-11-27 06:15,24,22,2,0,0,0
2023-11-27 06:30,33,25,8,0,0,0
2023-11-27 06:45,45,26,19,0,0,0
2023-11-27 07:00,51,30,21,0,0,0
2023-11-27 07:15,99,60,39,0,0,0
2023-11-27 07:30,114,67,47,0,0,0
2023-11-27 07:45,148,91,57,0,0,0
2023-11-27 08:00,107,71,36,0,0,0
2023-11-27 08:15,93,70,23,0,0,0
2023-11-27 08:30,111,66,45,0,0,0
2023-11-27 08:45,83,58,25,0,0,0
2023-11-27 09:00,74,48,26,0,0,0
2023-11-27 09:15,77,46,31,0,0,0
2023-11-27 09:30,67,40,27,0,0,0
2023-11-27 09:45,81,63,18,0,0,0
2023-11-27 10:00,68,43,25,0,0,0
2023-11-27 10:15,59,37,22,0,0,0
2023-11-27 10:30,57,28,29,0,0,0
2023-11-27 10:45,58,29,29,0,0,0
2023-11-27 11:00,51,21,30,0,0,0
2023-11-27 11:15,66,23,43,0,0,0
2023-11-27 11:30,57,30,27,0,0,0
2023-11-27 11:45,68,41,27,0,0,0
2023-11-27 12:00,68,33,35,0,0,0
2023-11-27 12:15,77,28,49,0,0,0
2023-11-27 12:30,71,30,41,0,0,0
2023-11-27 12:45,73,36,37,0,0,0
2023-11-27 13:00,80,33,47,0,0,0
2023-11-27 13:15,71,24,47,0,0,0
2023-11-27 13:30,73,29,44,0,0,0
2023-11-27 13:45,72,36,36,0,0,0
2023-11-27 14:00,87,30,57,0,0,0
2023-11-27 14:15,89,29,60,0,0,0
2023-11-27 14:30,99,38,61,0,0,0
2023-11-27 14:45,93,39,54,0,0,0
2023-11-27 15:00,90,39,51,0,0,0
2023-11-27 15:15,86,37,49,0,0,0
2023-11-27 15:30,103,39,64,0,0,0
2023-11-27 15:45,118,53,65,0,0,0
2023-11-27 16:00,101,29,72,0,0,0
2023-11-27 16:15,122,35,87,0,0,0
2023-11-27 16:30,104,39,65,0,0,0
2023-11-27 16:45,135,49,86,0,0,0
2023-11-27 17:00,100,45,55,0,0,0
2023-11-27 17:15,111,31,80,0,0,0
2023-11-27 17:30,97,37,60,0,0,0
2023-11-27 17:45,142,55,87,0,0,0
2023-11-27 18:00,121,53,68,0,0,0
2023-11-27 18:15,118,47,71,0,0,0
2023-11-27 18:30,87,35,52,0,0,0
2023-11-27 18:45,102,27,75,0,0,0
2023-11-27 19:00,82,20,62,0,0,0
2023-11-27 19:15,65,25,40,0,0,0
2023-11-27 19:30,64,24,40,0,0,0
2023-11-27 19:45,79,19,60,0,0,0
2023-11-27 20:00,74,18,56,0,0,0
2023-11-27 20:15,56,12,44,0,0,0
2023-11-27 20:30,48,14,34,0,0,0
2023-11-27 20:45,32,5,27,0,0,0
2023-11-27 21:00,32,7,25,0,0,0
2023-11-27 21:15,33,13,20,0,0,0
2023-11-27 21:30,32,4,28,0,0,0
2023-11-27 21:45,39,8,31,0,0,0
2023-11-27 22:00,33,9,24,0,0,0
2023-11-27 22:15,43,14,29,0,0,0
2023-11-27 22:30,31,4,27,0,0,0
2023-11-27 22:45,13,3,10,0,0,0
2023-11-27 23:00,24,0,24,0,0,0
2023-11-27 23:15,4,0,4,0,0,0
2023-11-27 23:30,13,2,11,0,0,0
2023-11-27 23:45,5,5,0,0,0,0
2023-11-28 00:00,4,0,4,0,0,0
2023-11-28 00:15,2,1,1,0,0,0
2023-11-28 00:30,2,0,2,0,0,0
2023-11-28 00:45,6,4,2,0,0,0
2023-11-28 01:00,3,0,3,0,0,0
2023-11-28 01:15,0,0,0,0,0,0
2023-11-28 01:30,0,0,0,0,0,0
2023-11-28 01:45,0,0,0,0,0,0
2023-11-28 02:00,1,0,1,0,0,0
2023-11-28 02:15,0,0,0,0,0,0
2023-11-28 02:30,2,0,2,0,0,0
2023-11-28 02:45,2,0,2,0,0,0
2023-11-28 03:00,0,0,0,0,0,0
2023-11-28 03:15,1,1,0,0,0,0
2023-11-28 03:30,5,5,0,0,0,0
2023-11-28 03:45,0,0,0,0,0,0
2023-11-28 04:00,0,0,0,0,0,0
2023-11-28 04:15,1,1,0,0,0,0
2023-11-28 04:30,1,1,0,0,0,0
2023-11-28 04:45,3,3,0,0,0,0
2023-11-28 05:00,8,7,1,0,0,0
2023-11-28 05:15,7,5,2,0,0,0
2023-11-28 05:30,11,6,5,0,0,0
2023-11-28 05:45,20,14,6,0,0,0
2023-11-28 06:00,20,11,9,0,0,0
2023-11-28 06:15,19,18,1,0,0,0
2023-11-28 06:30,47,34,13,0,0,0
2023-11-28 06:45,55,30,25,0,0,0
2023-11-28 07:00,70,45,25,0,0,0
2023-11-28 07:15,117,70,47,0,0,0
2023-11-28 07:30,169,104,65,0,0,0
2023-11-28 07:45,181,124,57,0,0,0
2023-11-28 08:00,148,93,55,0,0,0
2023-11-28 08:15,165,107,58,0,0,0
2023-11-28 08:30,109,74,35,0,0,0
2023-11-28 08:45,132,93,39,0,0,0
2023-11-28 09:00,89,59,30,0,0,0
2023-11-28 09:15,84,54,30,0,0,0
2023-11-28 09:30,90,53,37,0,0,0
2023-11-28 09:45,126,90,36,0,0,0
2023-11-28 10:00,105,70,35,0,0,0
2023-11-28 10:15,98,55,43,0,0,0
2023-11-28 10:30,68,43,25,0,0,0
2023-11-28 10:45,104,66,38,0,0,0
2023-11-28 11:00,78,39,39,0,0,0
2023-11-28 11:15,102,48,54,0,0,0
2023-11-28 11:30,90,48,42,0,0,0
2023-11-28 11:45,115,69,46,0,0,0
2023-11-28 12:00,134,60,74,0,0,0
2023-11-28 12:15,152,65,87,0,0,0
2023-11-28 12:30,122,41,81,0,0,0
2023-11-28 12:45,121,57,64,0,0,0
2023-11-28 13:00,126,42,84,0,0,0
2023-11-28 13:15,131,40,91,0,0,0
2023-11-28 13:30,120,49,71,0,0,0
2023-11-28 13:45,142,71,71,0,0,0
2023-11-28 14:00,149,72,77,0,0,0
2023-11-28 14:15,130,50,80,0,0,0
2023-11-28 14:30,88,35,53,0,0,0
2023-11-28 14:45,157,67,90,0,0,0
2023-11-28 15:00,152,58,94,0,0,0
2023-11-28 15:15,143,69,74,0,0,0
2023-11-28 15:30,157,60,97,0,0,0
2023-11-28 15:45,186,64,122,0,0,0
2023-11-28 16:00,179,78,101,0,0,0
2023-11-28 16:15,198,84,114,0,0,0
2023-11-28 16:30,177,76,101,0,0,0
2023-11-28 16:45,197,82,115,0,0,0
2023-11-28 17:00,206,85,121,0,0,0
2023-11-28 17:15,181,81,100,0,0,0
2023-11-28 17:30,138,55,83,0,0,0
2023-11-28 17:45,181,85,96,0,0,0
2023-11-28 18:00,178,78,100,0,0,0
2023-11-28 18:15,162,66,96,0,0,0
2023-11-28 18:30,145,52,93,0,0,0
2023-11-28 18:45,146,57,89,0,0,0
2023-11-28 19:00,91,33,58,0,0,0
2023-11-28 19:15,141,50,91,0,0,0
2023-11-28 19:30,109,44,65,0,0,0
2023-11-28 19:45,125,39,86,0,0,0
2023-11-28 20:00,112,33,79,0,0,0
2023-11-28 20:15,109,23,86,0,0,0
2023-11-28 20:30,68,15,53,0,0,0
2023-11-28 20:45,57,11,46,0,0,0
2023-11-28 21:00,34,3,31,0,0,0
2023-11-28 21:15,63,11,52,0,0,0
2023-11-28 21:30,58,19,39,0,0,0
2023-11-28 21:45,68,14,54,0,0,0
2023-11-28 22:00,59,8,51,0,0,0
2023-11-28 22:15,61,17,44,0,0,0
2023-11-28 22:30,22,3,19,0,0,0
2023-11-28 22:45,26,8,18,0,0,0
2023-11-28 23:00,34,8,26,0,0,0
2023-11-28 23:15,30,8,22,0,0,0
2023-11-28 23:30,28,11,17,0,0,0
2023-11-28 23:45,23,7,16,0,0,0
2023-11-29 00:00,3,2,1,0,0,0
2023-11-29 00:15,6,2,4,0,0,0
2023-11-29 00:30,6,4,2,0,0,0
2023-11-29 00:45,4,0,4,0,0,0
2023-11-29 01:00,6,1,5,0,0,0
2023-11-29 01:15,3,2,1,0,0,0
2023-11-29 01:30,0,0,0,0,0,0
2023-11-29 01:45,1,0,1,0,0,0
2023-11-29 02:00,1,1,0,0,0,0
2023-11-29 02:15,0,0,0,0,0,0
2023-11-29 02:30,0,0,0,0,0,0
2023-11-29 02:45,4,2,2,0,0,0
2023-11-29 03:00,0,0,0,0,0,0
2023-11-29 03:15,0,0,0,0,0,0
2023-11-29 03:30,1,0,1,0,0,0
2023-11-29 03:45,1,0,1,0,0,0
2023-11-29 04:00,3,2,1,0,0,0
2023-11-29 04:15,2,2,0,0,0,0
2023-11-29 04:30,0,0,0,0,0,0
2023-11-29 04:45,3,3,0,0,0,0
2023-11-29 05:00,6,4,2,0,0,0
2023-11-29 05:15,12,6,6,0,0,0
2023-11-29 05:30,13,11,2,0,0,0
2023-11-29 05:45,17,12,5,0,0,0
2023-11-29 06:00,21,17,4,0,0,0
2023-11-29 06:15,19,16,3,0,0,0
2023-11-29 06:30,30,16,14,0,0,0
2023-11-29 06:45,41,32,9,0,0,0
2023-11-29 07:00,54,36,18,0,0,0
2023-11-29 07:15,100,60,40,0,0,0
2023-11-29 07:30,144,100,44,0,0,0
2023-11-29 07:45,177,120,57,0,0,0
2023-11-29 08:00,137,91,46,0,0,0
2023-11-29 08:15,127,90,37,0,0,0
2023-11-29 08:30,112,75,37,0,0,0
2023-11-29 08:45,114,80,34,0,0,0
2023-11-29 09:00,95,57,38,0,0,0
2023-11-29 09:15,74,55,19,0,0,0
2023-11-29 09:30,54,34,20,0,0,0
2023-11-29 09:45,102,83,19,0,0,0
2023-11-29 10:00,85,63,22,0,0,0
2023-11-29 10:15,75,46,29,0,0,0
2023-11-29 10:30,58,32,26,0,0,0
2023-11-29 10:45,69,39,30,0,0,0
2023-11-29 11:00,55,29,26,0,0,0
2023-11-29 11:15,67,32,35,0,0,0
2023-11-29 11:30,83,47,36,0,0,0
2023-11-29 11:45,107,46,61,0,0,0
2023-11-29 12:00,99,51,48,0,0,0
2023-11-29 12:15,113,49,64,0,0,0
2023-11-29 12:30,113,40,73,0,0,0
2023-11-29 12:45,118,54,64,0,0,0
2023-11-29 13:00,118,54,64,0,0,0
2023-11-29 13:15,124,48,76,0,0,0
2023-11-29 13:30,90,31,59,0,0,0
2023-11-29 13:45,133,49,84,0,0,0
2023-11-29 14:00,101,42,59,0,0,0
2023-11-29 14:15,117,48,69,0,0,0
2023-11-29 14:30,107,40,67,0,0,0
2023-11-29 14:45,144,61,83,0,0,0
2023-11-29 15:00,140,60,80,0,0,0
2023-11-29 15:15,123,44,79,0,0,0
2023-11-29 15:30,105,43,62,0,0,0
2023-11-29 15:45,160,76,84,0,0,0
2023-11-29 16:00,157,57,100,0,0,0
2023-11-29 16:15,143,50,93,0,0,0
2023-11-29 16:30,122,55,67,0,0,0
2023-11-29 16:45,155,63,92,0,0,0
2023-11-29 17:00,150,69,81,0,0,0
2023-11-29 17:15,185,83,102,0,0,0
2023-11-29 17:30,142,53,89,0,0,0
2023-11-29 17:45,169,73,96,0,0,0
2023-11-29 18:00,165,59,106,0,0,0
2023-11-29 18:15,158,67,91,0,0,0
2023-11-29 18:30,117,48,69,0,0,0
2023-11-29 18:45,108,44,64,0,0,0
2023-11-29 19:00,106,36,70,0,0,0
2023-11-29 19:15,109,45,64,0,0,0
2023-11-29 19:30,80,18,62,0,0,0
2023-11-29 19:45,101,31,70,0,0,0
2023-11-29 20:00,94,28,66,0,0,0
2023-11-29 20:15,124,20,104,0,0,0
2023-11-29 20:30,70,11,59,0,0,0
2023-11-29 20:45,66,21,45,0,0,0
2023-11-29 21:00,44,12,32,0,0,0
2023-11-29 21:15,57,14,43,0,0,0
2023-11-29 21:30,45,11,34,0,0,0
2023-11-29 21:45,57,16,41,0,0,0
2023-11-29 22:00,63,19,44,0,0,0
2023-11-29 22:15,38,12,26,0,0,0
2023-11-29 22:30,53,22,31,0,0,0
2023-11-29 22:45,27,3,24,0,0,0
2023-11-29 23:00,44,17,27,0,0,0
2023-11-29 23:15,26,11,15,0,0,0
2023-11-29 23:30,17,6,11,0,0,0
2023-11-29 23:45,13,5,8,0,0,0
