Datetime,100034980 (Hammer Straße),101034980 (Hammer Straße stadteinwärts),102034980 (Hammer Straße stadtauswärts),100034980-status,101034980-status,102034980-status
2025-01-01 00:00,0,0,0,0,0,0
2025-01-01 00:15,6,1,5,0,0,0
2025-01-01 00:30,14,3,11,0,0,0
2025-01-01 00:45,6,3,3,0,0,0
2025-01-01 01:00,37,21,16,0,0,0
2025-01-01 01:15,19,3,16,0,0,0
2025-01-01 01:30,32,13,19,0,0,0
2025-01-01 01:45,33,10,23,0,0,0
2025-01-01 02:00,33,16,17,0,0,0
2025-01-01 02:15,41,15,26,0,0,0
2025-01-01 02:30,61,12,49,0,0,0
2025-01-01 02:45,39,14,25,0,0,0
2025-01-01 03:00,39,19,20,0,0,0
2025-01-01 03:15,28,7,21,0,0,0
2025-01-01 03:30,28,10,18,0,0,0
2025-01-01 03:45,23,11,12,0,0,0
2025-01-01 04:00,23,9,14,0,0,0
2025-01-01 04:15,30,6,24,0,0,0
2025-01-01 04:30,30,13,17,0,0,0
2025-01-01 04:45,15,4,11,0,0,0
2025-01-01 05:00,12,2,10,0,0,0
2025-01-01 05:15,10,1,9,0,0,0
2025-01-01 05:30,3,2,1,0,0,0
2025-01-01 05:45,9,4,5,0,0,0
2025-01-01 06:00,5,4,1,0,0,0
2025-01-01 06:15,5,0,5,0,0,0
2025-01-01 06:30,5,1,4,0,0,0
2025-01-01 06:45,1,1,0,0,0,0
2025-01-01 07:00,3,2,1,0,0,0
2025-01-01 07:15,1,0,1,0,0,0
2025-01-01 07:30,3,0,3,0,0,0
2025-01-01 07:45,4,3,1,0,0,0
2025-01-01 08:00,5,4,1,0,0,0
2025-01-01 08:15,3,1,2,0,0,0
2025-01-01 08:30,1,0,1,0,0,0
2025-01-01 08:45,4,1,3,0,0,0
2025-01-01 09:00,10,6,4,0,0,0
2025-01-01 09:15,7,5,2,0,0,0
2025-01-01 09:30,5,3,2,0,0,0
2025-01-01 09:45,7,5,2,0,0,0
2025-01-01 10:00,5,1,4,0,0,0
2025-01-01 10:15,8,3,5,0,0,0
2025-01-01 10:30,10,3,7,0,0,0
2025-01-01 10:45,8,4,4,0,0,0
2025-01-01 11:00,9,7,2,0,0,0
2025-01-01 11:15,3,2,1,0,0,0
2025-01-01 11:30,11,9,2,0,0,0
2025-01-01 11:45,19,8,11,0,0,0
2025-01-01 12:00,22,13,9,0,0,0
2025-01-01 12:15,16,6,10,0,0,0
2025-01-01 12:30,16,7,9,0,0,0
2025-01-01 12:45,15,5,10,0,0,0
2025-01-01 13:00,21,3,18,0,0,0
2025-01-01 13:15,22,9,13,0,0,0
2025-01-01 13:30,29,16,13,0,0,0
2025-01-01 13:45,17,6,11,0,0,0
2025-01-01 14:00,24,15,9,0,0,0
2025-01-01 14:15,25,12,13,0,0,0
2025-01-01 14:30,19,9,10,0,0,0
2025-01-01 14:45,23,7,16,0,0,0
2025-01-01 15:00,22,14,8,0,0,0
2025-01-01 15:15,35,22,13,0,0,0
2025-01-01 15:30,28,20,8,0,0,0
2025-01-01 15:45,21,11,10,0,0,0
2025-01-01 16:00,20,8,12,0,0,0
2025-01-01 16:15,26,13,13,0,0,0
2025-01-01 16:30,18,11,7,0,0,0
2025-01-01 16:45,23,11,12,0,0,0
2025-01-01 17:00,19,5,14,0,0,0
2025-01-01 17:15,30,10,20,0,0,0
2025-01-01 17:30,21,10,11,0,0,0
2025-01-01 17:45,18,10,8,0,0,0
2025-01-01 18:00,15,1,14,0,0,0
2025-01-01 18:15,23,11,12,0,0,0
2025-01-01 18:30,25,11,14,0,0,0
2025-01-01 18:45,21,9,12,0,0,0
2025-01-01 19:00,18,8,10,0,0,0
2025-01-01 19:15,18,11,7,0,0,0
2025-01-01 19:30,11,5,6,0,0,0
2025-01-01 19:45,9,3,6,0,0,0
2025-01-01 20:00,18,8,10,0,0,0
2025-01-01 20:15,16,8,8,0,0,0
2025-01-01 20:30,12,6,6,0,0,0
2025-01-01 20:45,17,8,9,0,0,0
2025-01-01 21:00,12,4,8,0,0,0
2025-01-01 21:15,4,3,1,0,0,0
2025-01-01 21:30,7,4,3,0,0,0
2025-01-01 21:45,7,3,4,0,0,0
2025-01-01 22:00,7,2,5,0,0,0
2025-01-01 22:15,5,2,3,0,0,0
2025-01-01 22:30,6,2,4,0,0,0
2025-01-01 22:45,4,1,3,0,0,0
2025-01-01 23:00,1,0,1,0,0,0
2025-01-01 23:15,2,0,2,0,0,0
2025-01-01 23:30,2,1,1,0,0,0
2025-01-01 23:45,1,0,1,0,0,0
2025-01-02 00:00,2,1,1,0,0,0
2025-01-02 00:15,0,0,0,0,0,0
2025-01-02 00:30,1,0,1,0,0,0
2025-01-02 00:45,0,0,0,0,0,0
2025-01-02 01:00,1,0,1,0,0,0
2025-01-02 01:15,0,0,0,0,0,0
2025-01-02 01:30,1,1,0,0,0,0
2025-01-02 01:45,0,0,0,0,0,0
2025-01-02 02:00,0,0,0,0,0,0
2025-01-02 02:15,1,1,0,0,0,0
2025-01-02 02:30,1,1,0,0,0,0
2025-01-02 02:45,0,0,0,0,0,0
2025-01-02 03:00,0,0,0,0,0,0
2025-01-02 03:15,0,0,0,0,0,0
2025-01-02 03:30,0,0,0,0,0,0
2025-01-02 03:45,0,0,0,0,0,0
2025-01-02 04:00,0,0,0,0,0,0
2025-01-02 04:15,0,0,0,0,0,0
2025-01-02 04:30,3,1,2,0,0,0
2025-01-02 04:45,2,2,0,0,0,0
2025-01-02 05:00,2,1,1,0,0,0
2025-01-02 05:15,5,1,4,0,0,0
2025-01-02 05:30,9,7,2,0,0,0
2025-01-02 05:45,9,6,3,0,0,0
2025-01-02 06:00,20,9,11,0,0,0
2025-01-02 06:15,22,14,8,0,0,0
2025-01-02 06:30,34,20,14,0,0,0
2025-01-02 06:45,22,11,11,0,0,0
2025-01-02 07:00,35,19,16,0,0,0
2025-01-02 07:15,56,39,17,0,0,0
2025-01-02 07:30,65,36,29,0,0,0
2025-01-02 07:45,90,54,36,0,0,0
2025-01-02 08:00,56,42,14,0,0,0
2025-01-02 08:15,56,32,24,0,0,0
2025-01-02 08:30,65,36,29,0,0,0
2025-01-02 08:45,80,51,29,0,0,0
2025-01-02 09:00,68,40,28,0,0,0
2025-01-02 09:15,46,33,13,0,0,0
2025-01-02 09:30,45,26,19,0,0,0
2025-01-02 09:45,63,43,20,0,0,0
2025-01-02 10:00,64,34,30,0,0,0
2025-01-02 10:15,73,46,27,0,0,0
2025-01-02 10:30,93,57,36,0,0,0
2025-01-02 10:45,79,42,37,0,0,0
2025-01-02 11:00,100,56,44,0,0,0
2025-01-02 11:15,96,55,41,0,0,0
2025-01-02 11:30,79,39,40,0,0,0
2025-01-02 11:45,84,36,48,0,0,0
2025-01-02 12:00,94,38,56,0,0,0
2025-01-02 12:15,98,45,53,0,0,0
2025-01-02 12:30,96,48,48,0,0,0
2025-01-02 12:45,103,53,50,0,0,0
2025-01-02 13:00,97,54,43,0,0,0
2025-01-02 13:15,98,42,56,0,0,0
2025-01-02 13:30,116,63,53,0,0,0
2025-01-02 13:45,132,74,58,0,0,0
2025-01-02 14:00,98,45,53,0,0,0
2025-01-02 14:15,132,60,72,0,0,0
2025-01-02 14:30,115,52,63,0,0,0
2025-01-02 14:45,123,54,69,0,0,0
2025-01-02 15:00,134,60,74,0,0,0
2025-01-02 15:15,150,67,83,0,0,0
2025-01-02 15:30,116,51,65,0,0,0
2025-01-02 15:45,146,65,81,0,0,0
2025-01-02 16:00,150,58,92,0,0,0
2025-01-02 16:15,152,51,101,0,0,0
2025-01-02 16:30,171,73,98,0,0,0
2025-01-02 16:45,136,50,86,0,0,0
2025-01-02 17:00,122,54,68,0,0,0
2025-01-02 17:15,122,45,77,0,0,0
2025-01-02 17:30,118,48,70,0,0,0
2025-01-02 17:45,136,45,91,0,0,0
2025-01-02 18:00,105,42,63,0,0,0
2025-01-02 18:15,101,31,70,0,0,0
2025-01-02 18:30,83,21,62,0,0,0
2025-01-02 18:45,76,26,50,0,0,0
2025-01-02 19:00,85,36,49,0,0,0
2025-01-02 19:15,60,30,30,0,0,0
2025-01-02 19:30,61,21,40,0,0,0
2025-01-02 19:45,41,10,31,0,0,0
2025-01-02 20:00,37,7,30,0,0,0
2025-01-02 20:15,50,20,30,0,0,0
2025-01-02 20:30,29,14,15,0,0,0
2025-01-02 20:45,14,9,5,0,0,0
2025-01-02 21:00,22,5,17,0,0,0
2025-01-02 21:15,28,12,16,0,0,0
2025-01-02 21:30,21,8,13,0,0,0
2025-01-02 21:45,11,5,6,0,0,0
2025-01-02 22:00,35,9,26,0,0,0
2025-01-02 22:15,48,8,40,0,0,0
2025-01-02 22:30,18,4,14,0,0,0
2025-01-02 22:45,19,7,12,0,0,0
2025-01-02 23:00,13,3,10,0,0,0
2025-01-02 23:15,16,2,14,0,0,0
2025-01-02 23:30,9,5,4,0,0,0
2025-01-02 23:45,12,2,10,0,0,0
2025-01-03 00:00,15,2,13,0,0,0
2025-01-03 00:15,5,2,3,0,0,0
2025-01-03 00:30,8,5,3,0,0,0
2025-01-03 00:45,5,0,5,0,0,0
2025-01-03 01:00,6,2,4,0,0,0
2025-01-03 01:15,4,0,4,0,0,0
2025-01-03 01:30,5,1,4,0,0,0
2025-01-03 01:45,1,1,0,0,0,0
2025-01-03 02:00,0,0,0,0,0,0
2025-01-03 02:15,1,0,1,0,0,0
2025-01-03 02:30,1,1,0,0,0,0
2025-01-03 02:45,0,0,0,0,0,0
2025-01-03 03:00,1,1,0,0,0,0
2025-01-03 03:15,4,4,0,0,0,0
2025-01-03 03:30,2,0,2,0,0,0
2025-01-03 03:45,1,1,0,0,0,0
2025-01-03 04:00,0,0,0,0,0,0
2025-01-03 04:15,1,1,0,0,0,0
2025-01-03 04:30,2,1,1,0,0,0
2025-01-03 04:45,2,2,0,0,0,0
2025-01-03 05:00,3,1,2,0,0,0
2025-01-03 05:15,5,2,3,0,0,0
2025-01-03 05:30,5,1,4,0,0,0
2025-01-03 05:45,13,11,2,0,0,0
2025-01-03 06:00,11,5,6,0,0,0
2025-01-03 06:15,23,12,11,0,0,0
2025-01-03 06:30,28,16,12,0,0,0
2025-01-03 06:45,34,15,19,0,0,0
2025-01-03 07:00,43,20,23,0,0,0
2025-01-03 07:15,47,31,16,0,0,0
2025-01-03 07:30,61,39,22,0,0,0
2025-01-03 07:45,94,64,30,0,0,0
2025-01-03 08:00,70,44,26,0,0,0
2025-01-03 08:15,65,40,25,0,0,0
2025-01-03 08:30,54,32,22,0,0,0
2025-01-03 08:45,74,45,29,0,0,0
2025-01-03 09:00,39,22,17,0,0,0
2025-01-03 09:15,61,40,21,0,0,0
2025-01-03 09:30,57,37,20,0,0,0
2025-01-03 09:45,78,58,20,0,0,0
2025-01-03 10:00,59,40,19,0,0,0
2025-01-03 10:15,64,42,22,0,0,0
2025-01-03 10:30,70,42,28,0,0,0
2025-01-03 10:45,90,51,39,0,0,0
2025-01-03 11:00,69,39,30,0,0,0
2025-01-03 11:15,83,47,36,0,0,0
2025-01-03 11:30,71,37,34,0,0,0
2025-01-03 11:45,103,55,48,0,0,0
2025-01-03 12:00,102,52,50,0,0,0
2025-01-03 12:15,98,49,49,0,0,0
2025-01-03 12:30,87,41,46,0,0,0
2025-01-03 12:45,92,43,49,0,0,0
2025-01-03 13:00,113,34,79,0,0,0
2025-01-03 13:15,102,47,55,0,0,0
2025-01-03 13:30,101,49,52,0,0,0
2025-01-03 13:45,137,76,61,0,0,0
2025-01-03 14:00,92,30,62,0,0,0
2025-01-03 14:15,110,58,52,0,0,0
2025-01-03 14:30,79,30,49,0,0,0
2025-01-03 14:45,149,65,84,0,0,0
2025-01-03 15:00,89,34,55,0,0,0
2025-01-03 15:15,95,38,57,0,0,0
2025-01-03 15:30,109,47,62,0,0,0
2025-01-03 15:45,133,60,73,0,0,0
2025-01-03 16:00,76,24,52,0,0,0
2025-01-03 16:15,99,40,59,0,0,0
2025-01-03 16:30,94,43,51,0,0,0
2025-01-03 16:45,109,58,51,0,0,0
2025-01-03 17:00,89,51,38,0,0,0
2025-01-03 17:15,95,40,55,0,0,0
2025-01-03 17:30,77,26,51,0,0,0
2025-01-03 17:45,99,47,52,0,0,0
2025-01-03 18:00,72,25,47,0,0,0
2025-01-03 18:15,89,31,58,0,0,0
2025-01-03 18:30,63,14,49,0,0,0
2025-01-03 18:45,86,30,56,0,0,0
2025-01-03 19:00,78,32,46,0,0,0
2025-01-03 19:15,63,12,51,0,0,0
2025-01-03 19:30,41,20,21,0,0,0
2025-01-03 19:45,46,22,24,0,0,0
2025-01-03 20:00,52,17,35,0,0,0
2025-01-03 20:15,38,12,26,0,0,0
2025-01-03 20:30,30,17,13,0,0,0
2025-01-03 20:45,32,10,22,0,0,0
2025-01-03 21:00,33,8,25,0,0,0
2025-01-03 21:15,20,10,10,0,0,0
2025-01-03 21:30,32,12,20,0,0,0
2025-01-03 21:45,25,9,16,0,0,0
2025-01-03 22:00,21,9,12,0,0,0
2025-01-03 22:15,20,9,11,0,0,0
2025-01-03 22:30,24,8,16,0,0,0
2025-01-03 22:45,25,6,19,0,0,0
2025-01-03 23:00,21,9,12,0,0,0
2025-01-03 23:15,22,11,11,0,0,0
2025-01-03 23:30,19,5,14,0,0,0
2025-01-03 23:45,25,12,13,0,0,0
2025-01-04 00:00,26,9,17,0,0,0
2025-01-04 00:15,31,5,26,0,0,0
2025-01-04 00:30,9,2,7,0,0,0
2025-01-04 00:45,14,4,10,0,0,0
2025-01-04 01:00,16,6,10,0,0,0
2025-01-04 01:15,10,3,7,0,0,0
2025-01-04 01:30,5,2,3,0,0,0
2025-01-04 01:45,5,1,4,0,0,0
2025-01-04 02:00,2,1,1,0,0,0
2025-01-04 02:15,1,1,0,0,0,0
2025-01-04 02:30,6,4,2,0,0,0
2025-01-04 02:45,2,1,1,0,0,0
2025-01-04 03:00,2,0,2,0,0,0
2025-01-04 03:15,0,0,0,0,0,0
2025-01-04 03:30,0,0,0,0,0,0
2025-01-04 03:45,1,0,1,0,0,0
2025-01-04 04:00,1,1,0,0,0,0
2025-01-04 04:15,1,0,1,0,0,0
2025-01-04 04:30,0,0,0,0,0,0
2025-01-04 04:45,1,0,1,0,0,0
2025-01-04 05:00,3,1,2,0,0,0
2025-01-04 05:15,3,3,0,0,0,0
2025-01-04 05:30,8,3,5,0,0,0
2025-01-04 05:45,8,4,4,0,0,0
2025-01-04 06:00,7,4,3,0,0,0
2025-01-04 06:15,4,2,2,0,0,0
2025-01-04 06:30,4,2,2,0,0,0
2025-01-04 06:45,5,2,3,0,0,0
2025-01-04 07:00,4,1,3,0,0,0
2025-01-04 07:15,10,8,2,0,0,0
2025-01-04 07:30,8,4,4,0,0,0
2025-01-04 07:45,14,9,5,0,0,0
2025-01-04 08:00,8,5,3,0,0,0
2025-01-04 08:15,15,10,5,0,0,0
2025-01-04 08:30,21,18,3,0,0,0
2025-01-04 08:45,37,20,17,0,0,0
2025-01-04 09:00,35,26,9,0,0,0
2025-01-04 09:15,41,27,14,0,0,0
2025-01-04 09:30,46,36,10,0,0,0
2025-01-04 09:45,69,50,19,0,0,0
2025-01-04 10:00,71,53,18,0,0,0
2025-01-04 10:15,106,69,37,0,0,0
2025-01-04 10:30,88,47,41,0,0,0
2025-01-04 10:45,105,78,27,0,0,0
2025-01-04 11:00,94,62,32,0,0,0
2025-01-04 11:15,104,72,32,0,0,0
2025-01-04 11:30,102,56,46,0,0,0
2025-01-04 11:45,118,57,61,0,0,0
2025-01-04 12:00,127,79,48,0,0,0
2025-01-04 12:15,123,71,52,0,0,0
2025-01-04 12:30,125,70,55,0,0,0
2025-01-04 12:45,113,60,53,0,0,0
2025-01-04 13:00,128,69,59,0,0,0
2025-01-04 13:15,160,71,89,0,0,0
2025-01-04 13:30,145,63,82,0,0,0
2025-01-04 13:45,124,54,70,0,0,0
2025-01-04 14:00,134,65,69,0,0,0
2025-01-04 14:15,130,52,78,0,0,0
2025-01-04 14:30,118,44,74,0,0,0
2025-01-04 14:45,121,44,77,0,0,0
2025-01-04 15:00,104,41,63,0,0,0
2025-01-04 15:15,114,50,64,0,0,0
2025-01-04 15:30,92,40,52,0,0,0
2025-01-04 15:45,107,46,61,0,0,0
2025-01-04 16:00,107,44,63,0,0,0
2025-01-04 16:15,91,40,51,0,0,0
2025-01-04 16:30,92,42,50,0,0,0
2025-01-04 16:45,91,31,60,0,0,0
2025-01-04 17:00,82,30,52,0,0,0
2025-01-04 17:15,108,52,56,0,0,0
2025-01-04 17:30,107,44,63,0,0,0
2025-01-04 17:45,84,36,48,0,0,0
2025-01-04 18:00,97,15,82,0,0,0
2025-01-04 18:15,69,32,37,0,0,0
2025-01-04 18:30,62,16,46,0,0,0
2025-01-04 18:45,67,21,46,0,0,0
2025-01-04 19:00,63,21,42,0,0,0
2025-01-04 19:15,33,16,17,0,0,0
2025-01-04 19:30,59,24,35,0,0,0
2025-01-04 19:45,64,19,45,0,0,0
2025-01-04 20:00,57,32,25,0,0,0
2025-01-04 20:15,43,13,30,0,0,0
2025-01-04 20:30,47,22,25,0,0,0
2025-01-04 20:45,29,15,14,0,0,0
2025-01-04 21:00,32,7,25,0,0,0
2025-01-04 21:15,23,11,12,0,0,0
2025-01-04 21:30,24,6,18,0,0,0
2025-01-04 21:45,31,19,12,0,0,0
2025-01-04 22:00,42,27,15,0,0,0
2025-01-04 22:15,33,22,11,0,0,0
2025-01-04 22:30,20,7,13,0,0,0
2025-01-04 22:45,21,13,8,0,0,0
2025-01-04 23:00,30,13,17,0,0,0
2025-01-04 23:15,12,4,8,0,0,0
2025-01-04 23:30,23,8,15,0,0,0
2025-01-04 23:45,20,9,11,0,0,0
2025-01-05 00:00,21,11,10,0,0,0
2025-01-05 00:15,31,12,19,0,0,0
2025-01-05 00:30,41,5,36,0,0,0
2025-01-05 00:45,35,9,26,0,0,0
2025-01-05 01:00,11,7,4,0,0,0
2025-01-05 01:15,22,1,21,0,0,0
2025-01-05 01:30,7,4,3,0,0,0
2025-01-05 01:45,5,1,4,0,0,0
2025-01-05 02:00,3,3,0,0,0,0
2025-01-05 02:15,6,2,4,0,0,0
2025-01-05 02:30,7,4,3,0,0,0
2025-01-05 02:45,3,1,2,0,0,0
2025-01-05 03:00,7,2,5,0,0,0
2025-01-05 03:15,6,2,4,0,0,0
2025-01-05 03:30,2,1,1,0,0,0
2025-01-05 03:45,4,2,2,0,0,0
2025-01-05 04:00,6,4,2,0,0,0
2025-01-05 04:15,1,0,1,0,0,0
2025-01-05 04:30,0,0,0,0,0,0
2025-01-05 04:45,5,3,2,0,0,0
2025-01-05 05:00,0,0,0,0,0,0
2025-01-05 05:15,5,3,2,0,0,0
2025-01-05 05:30,5,2,3,0,0,0
2025-01-05 05:45,0,0,0,0,0,0
2025-01-05 06:00,5,4,1,0,0,0
2025-01-05 06:15,1,1,0,0,0,0
2025-01-05 06:30,4,3,1,0,0,0
2025-01-05 06:45,4,2,2,0,0,0
2025-01-05 07:00,0,0,0,0,0,0
2025-01-05 07:15,0,0,0,0,0,0
2025-01-05 07:30,8,2,6,0,0,0
2025-01-05 07:45,6,2,4,0,0,0
2025-01-05 08:00,2,2,0,0,0,0
2025-01-05 08:15,2,2,0,0,0,0
2025-01-05 08:30,3,1,2,0,0,0
2025-01-05 08:45,4,1,3,0,0,0
2025-01-05 09:00,9,4,5,0,0,0
2025-01-05 09:15,9,5,4,0,0,0
2025-01-05 09:30,9,7,2,0,0,0
2025-01-05 09:45,15,6,9,0,0,0
2025-01-05 10:00,15,8,7,0,0,0
2025-01-05 10:15,18,9,9,0,0,0
2025-01-05 10:30,9,3,6,0,0,0
2025-01-05 10:45,13,6,7,0,0,0
2025-01-05 11:00,19,12,7,0,0,0
2025-01-05 11:15,14,6,8,0,0,0
2025-01-05 11:30,11,7,4,0,0,0
2025-01-05 11:45,22,13,9,0,0,0
2025-01-05 12:00,12,7,5,0,0,0
2025-01-05 12:15,17,7,10,0,0,0
2025-01-05 12:30,23,12,11,0,0,0
2025-01-05 12:45,24,11,13,0,0,0
2025-01-05 13:00,30,11,19,0,0,0
2025-01-05 13:15,16,6,10,0,0,0
2025-01-05 13:30,27,12,15,0,0,0
2025-01-05 13:45,23,10,13,0,0,0
2025-01-05 14:00,23,13,10,0,0,0
2025-01-05 14:15,18,9,9,0,0,0
2025-01-05 14:30,20,7,13,0,0,0
2025-01-05 14:45,28,14,14,0,0,0
2025-01-05 15:00,18,9,9,0,0,0
2025-01-05 15:15,20,15,5,0,0,0
2025-01-05 15:30,20,11,9,0,0,0
2025-01-05 15:45,25,10,15,0,0,0
2025-01-05 16:00,23,9,14,0,0,0
2025-01-05 16:15,23,9,14,0,0,0
2025-01-05 16:30,21,4,17,0,0,0
2025-01-05 16:45,25,13,12,0,0,0
2025-01-05 17:00,14,3,11,0,0,0
2025-01-05 17:15,15,8,7,0,0,0
2025-01-05 17:30,26,14,12,0,0,0
2025-01-05 17:45,27,14,13,0,0,0
2025-01-05 18:00,25,10,15,0,0,0
2025-01-05 18:15,22,7,15,0,0,0
2025-01-05 18:30,24,9,15,0,0,0
2025-01-05 18:45,29,12,17,0,0,0
2025-01-05 19:00,24,9,15,0,0,0
2025-01-05 19:15,23,8,15,0,0,0
2025-01-05 19:30,19,8,11,0,0,0
2025-01-05 19:45,34,14,20,0,0,0
2025-01-05 20:00,22,6,16,0,0,0
2025-01-05 20:15,18,7,11,0,0,0
2025-01-05 20:30,18,7,11,0,0,0
2025-01-05 20:45,20,4,16,0,0,0
2025-01-05 21:00,9,5,4,0,0,0
2025-01-05 21:15,14,4,10,0,0,0
2025-01-05 21:30,11,6,5,0,0,0
2025-01-05 21:45,17,7,10,0,0,0
2025-01-05 22:00,6,3,3,0,0,0
2025-01-05 22:15,8,4,4,0,0,0
2025-01-05 22:30,11,5,6,0,0,0
2025-01-05 22:45,13,3,10,0,0,0
2025-01-05 23:00,10,1,9,0,0,0
2025-01-05 23:15,8,3,5,0,0,0
2025-01-05 23:30,4,2,2,0,0,0
2025-01-05 23:45,6,1,5,0,0,0
2025-01-06 00:00,2,2,0,0,0,0
2025-01-06 00:15,5,2,3,0,0,0
2025-01-06 00:30,2,0,2,0,0,0
2025-01-06 00:45,6,4,2,0,0,0
2025-01-06 01:00,1,1,0,0,0,0
2025-01-06 01:15,0,0,0,0,0,0
2025-01-06 01:30,0,0,0,0,0,0
2025-01-06 01:45,1,1,0,0,0,0
2025-01-06 02:00,0,0,0,0,0,0
2025-01-06 02:15,0,0,0,0,0,0
2025-01-06 02:30,2,1,1,0,0,0
2025-01-06 02:45,0,0,0,0,0,0
2025-01-06 03:00,0,0,0,0,0,0
2025-01-06 03:15,0,0,0,0,0,0
2025-01-06 03:30,0,0,0,0,0,0
2025-01-06 03:45,2,2,0,0,0,0
2025-01-06 04:00,2,2,0,0,0,0
2025-01-06 04:15,1,1,0,0,0,0
2025-01-06 04:30,1,0,1,0,0,0
2025-01-06 04:45,2,1,1,0,0,0
2025-01-06 05:00,3,3,0,0,0,0
2025-01-06 05:15,10,7,3,0,0,0
2025-01-06 05:30,10,7,3,0,0,0
2025-01-06 05:45,10,7,3,0,0,0
2025-01-06 06:00,17,7,10,0,0,0
2025-01-06 06:15,33,26,7,0,0,0
2025-01-06 06:30,38,26,12,0,0,0
2025-01-06 06:45,57,38,19,0,0,0
2025-01-06 07:00,49,36,13,0,0,0
2025-01-06 07:15,69,39,30,0,0,0
2025-01-06 07:30,92,59,33,0,0,0
2025-01-06 07:45,150,98,52,0,0,0
2025-01-06 08:00,113,80,33,0,0,0
2025-01-06 08:15,112,76,36,0,0,0
2025-01-06 08:30,95,63,32,0,0,0
2025-01-06 08:45,95,73,22,0,0,0
2025-01-06 09:00,102,64,38,0,0,0
2025-01-06 09:15,69,46,23,0,0,0
2025-01-06 09:30,70,40,30,0,0,0
2025-01-06 09:45,90,64,26,0,0,0
2025-01-06 10:00,63,42,21,0,0,0
2025-01-06 10:15,70,43,27,0,0,0
2025-01-06 10:30,69,42,27,0,0,0
2025-01-06 10:45,82,53,29,0,0,0
2025-01-06 11:00,65,29,36,0,0,0
2025-01-06 11:15,62,29,33,0,0,0
2025-01-06 11:30,75,37,38,0,0,0
2025-01-06 11:45,91,46,45,0,0,0
2025-01-06 12:00,97,41,56,0,0,0
2025-01-06 12:15,97,45,52,0,0,0
2025-01-06 12:30,81,35,46,0,0,0
2025-01-06 12:45,83,36,47,0,0,0
2025-01-06 13:00,98,41,57,0,0,0
2025-01-06 13:15,106,42,64,0,0,0
2025-01-06 13:30,105,54,51,0,0,0
2025-01-06 13:45,125,79,46,0,0,0
2025-01-06 14:00,98,48,50,0,0,0
2025-01-06 14:15,100,49,51,0,0,0
2025-01-06 14:30,128,56,72,0,0,0
2025-01-06 14:45,129,58,71,0,0,0
2025-01-06 15:00,100,37,63,0,0,0
2025-01-06 15:15,108,47,61,0,0,0
2025-01-06 15:30,116,64,52,0,0,0
2025-01-06 15:45,115,54,61,0,0,0
2025-01-06 16:00,127,49,78,0,0,0
2025-01-06 16:15,130,60,70,0,0,0
2025-01-06 16:30,132,44,88,0,0,0
2025-01-06 16:45,119,41,78,0,0,0
2025-01-06 17:00,109,35,74,0,0,0
2025-01-06 17:15,147,49,98,0,0,0
2025-01-06 17:30,93,28,65,0,0,0
2025-01-06 17:45,120,38,82,0,0,0
2025-01-06 18:00,86,26,60,0,0,0
2025-01-06 18:15,118,34,84,0,0,0
2025-01-06 18:30,89,28,61,0,0,0
2025-01-06 18:45,99,28,71,0,0,0
2025-01-06 19:00,72,11,61,0,0,0
2025-01-06 19:15,93,18,75,0,0,0
2025-01-06 19:30,88,25,63,0,0,0
2025-01-06 19:45,54,21,33,0,0,0
2025-01-06 20:00,62,14,48,0,0,0
2025-01-06 20:15,28,11,17,0,0,0
2025-01-06 20:30,25,3,22,0,0,0
2025-01-06 20:45,29,6,23,0,0,0
2025-01-06 21:00,23,6,17,0,0,0
2025-01-06 21:15,26,11,15,0,0,0
2025-01-06 21:30,24,11,13,0,0,0
2025-01-06 21:45,26,14,12,0,0,0
2025-01-06 22:00,38,26,12,0,0,0
2025-01-06 22:15,103,82,21,0,0,0
2025-01-06 22:30,31,13,18,0,0,0
2025-01-06 22:45,23,10,13,0,0,0
2025-01-06 23:00,12,7,5,0,0,0
2025-01-06 23:15,17,6,11,0,0,0
2025-01-06 23:30,10,2,8,0,0,0
2025-01-06 23:45,3,2,1,0,0,0
2025-01-07 00:00,4,2,2,0,0,0
2025-01-07 00:15,8,4,4,0,0,0
2025-01-07 00:30,6,4,2,0,0,0
2025-01-07 00:45,5,2,3,0,0,0
2025-01-07 01:00,2,1,1,0,0,0
2025-01-07 01:15,0,0,0,0,0,0
2025-01-07 01:30,1,0,1,0,0,0
2025-01-07 01:45,0,0,0,0,0,0
2025-01-07 02:00,0,0,0,0,0,0
2025-01-07 02:15,2,0,2,0,0,0
2025-01-07 02:30,0,0,0,0,0,0
2025-01-07 02:45,0,0,0,0,0,0
2025-01-07 03:00,0,0,0,0,0,0
2025-01-07 03:15,0,0,0,0,0,0
2025-01-07 03:30,1,1,0,0,0,0
2025-01-07 03:45,2,2,0,0,0,0
2025-01-07 04:00,0,0,0,0,0,0
2025-01-07 04:15,1,0,1,0,0,0
2025-01-07 04:30,3,2,1,0,0,0
2025-01-07 04:45,3,3,0,0,0,0
2025-01-07 05:00,5,4,1,0,0,0
2025-01-07 05:15,11,3,8,0,0,0
2025-01-07 05:30,9,5,4,0,0,0
2025-01-07 05:45,12,7,5,0,0,0
2025-01-07 06:00,23,15,8,0,0,0
2025-01-07 06:15,40,31,9,0,0,0
2025-01-07 06:30,41,22,19,0,0,0
2025-01-07 06:45,76,43,33,0,0,0
2025-01-07 07:00,79,44,35,0,0,0
2025-01-07 07:15,117,73,44,0,0,0
2025-01-07 07:30,163,103,60,0,0,0
2025-01-07 07:45,168,107,61,0,0,0
2025-01-07 08:00,166,121,45,0,0,0
2025-01-07 08:15,142,99,43,0,0,0
2025-01-07 08:30,122,81,41,0,0,0
2025-01-07 08:45,126,86,40,0,0,0
2025-01-07 09:00,109,70,39,0,0,0
2025-01-07 09:15,96,66,30,0,0,0
2025-01-07 09:30,81,55,26,0,0,0
2025-01-07 09:45,134,101,33,0,0,0
2025-01-07 10:00,91,59,32,0,0,0
2025-01-07 10:15,89,47,42,0,0,0
2025-01-07 10:30,71,44,27,0,0,0
2025-01-07 10:45,91,50,41,0,0,0
2025-01-07 11:00,73,29,44,0,0,0
2025-01-07 11:15,93,52,41,0,0,0
2025-01-07 11:30,88,45,43,0,0,0
2025-01-07 11:45,121,67,54,0,0,0
2025-01-07 12:00,93,42,51,0,0,0
2025-01-07 12:15,112,45,67,0,0,0
2025-01-07 12:30,86,31,55,0,0,0
2025-01-07 12:45,108,39,69,0,0,0
2025-01-07 13:00,94,29,65,0,0,0
2025-01-07 13:15,103,45,58,0,0,0
2025-01-07 13:30,103,40,63,0,0,0
2025-01-07 13:45,145,60,85,0,0,0
2025-01-07 14:00,97,35,62,0,0,0
2025-01-07 14:15,126,54,72,0,0,0
2025-01-07 14:30,140,65,75,0,0,0
2025-01-07 14:45,151,68,83,0,0,0
2025-01-07 15:00,136,50,86,0,0,0
2025-01-07 15:15,147,55,92,0,0,0
2025-01-07 15:30,154,69,85,0,0,0
2025-01-07 15:45,182,66,116,0,0,0
2025-01-07 16:00,169,63,106,0,0,0
2025-01-07 16:15,175,71,104,0,0,0
2025-01-07 16:30,198,96,102,0,0,0
2025-01-07 16:45,168,60,108,0,0,0
2025-01-07 17:00,162,63,99,0,0,0
2025-01-07 17:15,168,64,104,0,0,0
2025-01-07 17:30,169,69,100,0,0,0
2025-01-07 17:45,187,73,114,0,0,0
2025-01-07 18:00,166,44,122,0,0,0
2025-01-07 18:15,169,64,105,0,0,0
2025-01-07 18:30,94,19,75,0,0,0
2025-01-07 18:45,113,49,64,0,0,0
2025-01-07 19:00,109,31,78,0,0,0
2025-01-07 19:15,88,36,52,0,0,0
2025-01-07 19:30,65,16,49,0,0,0
2025-01-07 19:45,88,39,49,0,0,0
2025-01-07 20:00,60,24,36,0,0,0
2025-01-07 20:15,40,12,28,0,0,0
2025-01-07 20:30,45,13,32,0,0,0
2025-01-07 20:45,33,8,25,0,0,0
2025-01-07 21:00,44,10,34,0,0,0
2025-01-07 21:15,32,13,19,0,0,0
2025-01-07 21:30,35,12,23,0,0,0
2025-01-07 21:45,28,12,16,0,0,0
2025-01-07 22:00,30,10,20,0,0,0
2025-01-07 22:15,41,14,27,0,0,0
2025-01-07 22:30,31,5,26,0,0,0
2025-01-07 22:45,19,8,11,0,0,0
2025-01-07 23:00,19,7,12,0,0,0
2025-01-07 23:15,16,5,11,0,0,0
2025-01-07 23:30,9,2,7,0,0,0
2025-01-07 23:45,14,6,8,0,0,0
2025-01-08 00:00,12,5,7,0,0,0
2025-01-08 00:15,6,2,4,0,0,0
2025-01-08 00:30,1,0,1,0,0,0
2025-01-08 00:45,4,1,3,0,0,0
2025-01-08 01:00,4,2,2,0,0,0
2025-01-08 01:15,4,1,3,0,0,0
2025-01-08 01:30,0,0,0,0,0,0
2025-01-08 01:45,0,0,0,0,0,0
2025-01-08 02:00,0,0,0,0,0,0
2025-01-08 02:15,1,0,1,0,0,0
2025-01-08 02:30,0,0,0,0,0,0
2025-01-08 02:45,0,0,0,0,0,0
2025-01-08 03:00,0,0,0,0,0,0
2025-01-08 03:15,0,0,0,0,0,0
2025-01-08 03:30,0,0,0,0,0,0
2025-01-08 03:45,0,0,0,0,0,0
2025-01-08 04:00,2,1,1,0,0,0
2025-01-08 04:15,0,0,0,0,0,0
2025-01-08 04:30,3,1,2,0,0,0
2025-01-08 04:45,4,4,0,0,0,0
2025-01-08 05:00,3,3,0,0,0,0
2025-01-08 05:15,13,5,8,0,0,0
2025-01-08 05:30,13,8,5,0,0,0
2025-01-08 05:45,18,9,9,0,0,0
2025-01-08 06:00,20,17,3,0,0,0
2025-01-08 06:15,43,29,14,0,0,0
2025-01-08 06:30,46,29,17,0,0,0
2025-01-08 06:45,63,36,27,0,0,0
2025-01-08 07:00,85,43,42,0,0,0
2025-01-08 07:15,120,70,50,0,0,0
2025-01-08 07:30,185,122,63,0,0,0
2025-01-08 07:45,195,124,71,0,0,0
2025-01-08 08:00,153,106,47,0,0,0
2025-01-08 08:15,172,112,60,0,0,0
2025-01-08 08:30,128,82,46,0,0,0
2025-01-08 08:45,136,92,44,0,0,0
2025-01-08 09:00,130,86,44,0,0,0
2025-01-08 09:15,103,71,32,0,0,0
2025-01-08 09:30,119,84,35,0,0,0
2025-01-08 09:45,126,90,36,0,0,0
2025-01-08 10:00,114,70,44,0,0,0
2025-01-08 10:15,94,56,38,0,0,0
2025-01-08 10:30,103,70,33,0,0,0
2025-01-08 10:45,113,61,52,0,0,0
2025-01-08 11:00,102,48,54,0,0,0
2025-01-08 11:15,91,41,50,0,0,0
2025-01-08 11:30,119,54,65,0,0,0
2025-01-08 11:45,130,65,65,0,0,0
2025-01-08 12:00,161,66,95,0,0,0
2025-01-08 12:15,127,54,73,0,0,0
2025-01-08 12:30,145,58,87,0,0,0
2025-01-08 12:45,152,62,90,0,0,0
2025-01-08 13:00,128,51,77,0,0,0
2025-01-08 13:15,112,57,55,0,0,0
2025-01-08 13:30,114,50,64,0,0,0
2025-01-08 13:45,149,76,73,0,0,0
2025-01-08 14:00,122,45,77,0,0,0
2025-01-08 14:15,125,52,73,0,0,0
2025-01-08 14:30,140,58,82,0,0,0
2025-01-08 14:45,181,76,105,0,0,0
2025-01-08 15:00,133,52,81,0,0,0
2025-01-08 15:15,158,58,100,0,0,0
2025-01-08 15:30,153,54,99,0,0,0
2025-01-08 15:45,150,65,85,0,0,0
2025-01-08 16:00,201,78,123,0,0,0
2025-01-08 16:15,191,76,115,0,0,0
2025-01-08 16:30,165,59,106,0,0,0
2025-01-08 16:45,202,86,116,0,0,0
2025-01-08 17:00,181,69,112,0,0,0
2025-01-08 17:15,192,66,126,0,0,0
2025-01-08 17:30,179,63,116,0,0,0
2025-01-08 17:45,162,60,102,0,0,0
2025-01-08 18:00,145,40,105,0,0,0
2025-01-08 18:15,140,42,98,0,0,0
2025-01-08 18:30,116,31,85,0,0,0
2025-01-08 18:45,121,34,87,0,0,0
2025-01-08 19:00,111,40,71,0,0,0
2025-01-08 19:15,105,51,54,0,0,0
2025-01-08 19:30,95,29,66,0,0,0
2025-01-08 19:45,82,30,52,0,0,0
2025-01-08 20:00,62,25,37,0,0,0
2025-01-08 20:15,64,23,41,0,0,0
2025-01-08 20:30,62,24,38,0,0,0
2025-01-08 20:45,63,26,37,0,0,0
2025-01-08 21:00,51,16,35,0,0,0
2025-01-08 21:15,57,17,40,0,0,0
2025-01-08 21:30,46,11,35,0,0,0
2025-01-08 21:45,55,20,35,0,0,0
2025-01-08 22:00,47,17,30,0,0,0
2025-01-08 22:15,47,13,34,0,0,0
2025-01-08 22:30,51,15,36,0,0,0
2025-01-08 22:45,28,10,18,0,0,0
2025-01-08 23:00,23,6,17,0,0,0
2025-01-08 23:15,20,4,16,0,0,0
2025-01-08 23:30,16,6,10,0,0,0
2025-01-08 23:45,10,4,6,0,0,0
2025-01-09 00:00,14,6,8,0,0,0
2025-01-09 00:15,8,4,4,0,0,0
2025-01-09 00:30,4,0,4,0,0,0
2025-01-09 00:45,1,0,1,0,0,0
2025-01-09 01:00,3,2,1,0,0,0
2025-01-09 01:15,9,0,9,0,0,0
2025-01-09 01:30,5,2,3,0,0,0
2025-01-09 01:45,4,0,4,0,0,0
2025-01-09 02:00,1,1,0,0,0,0
2025-01-09 02:15,0,0,0,0,0,0
2025-01-09 02:30,0,0,0,0,0,0
2025-01-09 02:45,1,0,1,0,0,0
2025-01-09 03:00,1,1,0,0,0,0
2025-01-09 03:15,4,1,3,0,0,0
2025-01-09 03:30,4,2,2,0,0,0
2025-01-09 03:45,0,0,0,0,0,0
2025-01-09 04:00,3,1,2,0,0,0
2025-01-09 04:15,0,0,0,0,0,0
2025-01-09 04:30,2,0,2,0,0,0
2025-01-09 04:45,4,4,0,0,0,0
2025-01-09 05:00,6,4,2,0,0,0
2025-01-09 05:15,8,2,6,0,0,0
2025-01-09 05:30,7,5,2,0,0,0
2025-01-09 05:45,13,6,7,0,0,0
2025-01-09 06:00,15,11,4,0,0,0
2025-01-09 06:15,21,14,7,0,0,0
2025-01-09 06:30,40,21,19,0,0,0
2025-01-09 06:45,57,37,20,0,0,0
2025-01-09 07:00,61,36,25,0,0,0
2025-01-09 07:15,91,54,37,0,0,0
2025-01-09 07:30,160,96,64,0,0,0
2025-01-09 07:45,190,123,67,0,0,0
2025-01-09 08:00,116,78,38,0,0,0
2025-01-09 08:15,121,77,44,0,0,0
2025-01-09 08:30,97,63,34,0,0,0
2025-01-09 08:45,108,61,47,0,0,0
2025-01-09 09:00,69,50,19,0,0,0
2025-01-09 09:15,72,47,25,0,0,0
2025-01-09 09:30,70,46,24,0,0,0
2025-01-09 09:45,91,61,30,0,0,0
2025-01-09 10:00,55,39,16,0,0,0
2025-01-09 10:15,62,37,25,0,0,0
2025-01-09 10:30,54,35,19,0,0,0
2025-01-09 10:45,52,31,21,0,0,0
2025-01-09 11:00,55,28,27,0,0,0
2025-01-09 11:15,49,20,29,0,0,0
2025-01-09 11:30,51,19,32,0,0,0
2025-01-09 11:45,87,39,48,0,0,0
2025-01-09 12:00,69,30,39,0,0,0
2025-01-09 12:15,64,26,38,0,0,0
2025-01-09 12:30,62,22,40,0,0,0
2025-01-09 12:45,65,29,36,0,0,0
2025-01-09 13:00,86,40,46,0,0,0
2025-01-09 13:15,80,25,55,0,0,0
2025-01-09 13:30,66,26,40,0,0,0
2025-01-09 13:45,75,26,49,0,0,0
2025-01-09 14:00,86,44,42,0,0,0
2025-01-09 14:15,68,21,47,0,0,0
2025-01-09 14:30,84,39,45,0,0,0
2025-01-09 14:45,126,50,76,0,0,0
2025-01-09 15:00,94,32,62,0,0,0
2025-01-09 15:15,103,45,58,0,0,0
2025-01-09 15:30,110,43,67,0,0,0
2025-01-09 15:45,139,67,72,0,0,0
2025-01-09 16:00,168,66,102,0,0,0
2025-01-09 16:15,120,52,68,0,0,0
2025-01-09 16:30,124,44,80,0,0,0
2025-01-09 16:45,151,53,98,0,0,0
2025-01-09 17:00,137,59,78,0,0,0
2025-01-09 17:15,137,51,86,0,0,0
2025-01-09 17:30,123,47,76,0,0,0
2025-01-09 17:45,159,66,93,0,0,0
2025-01-09 18:00,123,39,84,0,0,0
2025-01-09 18:15,109,40,69,0,0,0
2025-01-09 18:30,97,44,53,0,0,0
2025-01-09 18:45,108,50,58,0,0,0
2025-01-09 19:00,77,28,49,0,0,0
2025-01-09 19:15,79,24,55,0,0,0
2025-01-09 19:30,46,21,25,0,0,0
2025-01-09 19:45,86,20,66,0,0,0
2025-01-09 20:00,55,19,36,0,0,0
2025-01-09 20:15,48,15,33,0,0,0
2025-01-09 20:30,50,22,28,0,0,0
2025-01-09 20:45,36,12,24,0,0,0
2025-01-09 21:00,37,18,19,0,0,0
2025-01-09 21:15,24,13,11,0,0,0
2025-01-09 21:30,36,22,14,0,0,0
2025-01-09 21:45,29,6,23,0,0,0
2025-01-09 22:00,47,14,33,0,0,0
2025-01-09 22:15,52,16,36,0,0,0
2025-01-09 22:30,35,7,28,0,0,0
2025-01-09 22:45,25,6,19,0,0,0
2025-01-09 23:00,15,7,8,0,0,0
2025-01-09 23:15,18,6,12,0,0,0
2025-01-09 23:30,18,4,14,0,0,0
2025-01-09 23:45,13,0,13,0,0,0
2025-01-10 00:00,10,4,6,0,0,0
2025-01-10 00:15,7,2,5,0,0,0
2025-01-10 00:30,7,4,3,0,0,0
2025-01-10 00:45,4,1,3,0,0,0
2025-01-10 01:00,1,0,1,0,0,0
2025-01-10 01:15,3,1,2,0,0,0
2025-01-10 01:30,1,0,1,0,0,0
2025-01-10 01:45,2,0,2,0,0,0
2025-01-10 02:00,0,0,0,0,0,0
2025-01-10 02:15,0,0,0,0,0,0
2025-01-10 02:30,0,0,0,0,0,0
2025-01-10 02:45,1,0,1,0,0,0
2025-01-10 03:00,1,0,1,0,0,0
2025-01-10 03:15,0,0,0,0,0,0
2025-01-10 03:30,0,0,0,0,0,0
2025-01-10 03:45,2,1,1,0,0,0
2025-01-10 04:00,1,1,0,0,0,0
2025-01-10 04:15,4,4,0,0,0,0
2025-01-10 04:30,3,2,1,0,0,0
2025-01-10 04:45,4,4,0,0,0,0
2025-01-10 05:00,3,1,2,0,0,0
2025-01-10 05:15,6,1,5,0,0,0
2025-01-10 05:30,13,11,2,0,0,0
2025-01-10 05:45,9,7,2,0,0,0
2025-01-10 06:00,11,5,6,0,0,0
2025-01-10 06:15,32,24,8,0,0,0
2025-01-10 06:30,31,19,12,0,0,0
2025-01-10 06:45,44,28,16,0,0,0
2025-01-10 07:00,48,29,19,0,0,0
2025-01-10 07:15,98,57,41,0,0,0
2025-01-10 07:30,143,101,42,0,0,0
2025-01-10 07:45,140,88,52,0,0,0
2025-01-10 08:00,125,96,29,0,0,0
2025-01-10 08:15,116,74,42,0,0,0
2025-01-10 08:30,113,84,29,0,0,0
2025-01-10 08:45,110,74,36,0,0,0
2025-01-10 09:00,90,57,33,0,0,0
2025-01-10 09:15,92,63,29,0,0,0
2025-01-10 09:30,89,63,26,0,0,0
2025-01-10 09:45,117,90,27,0,0,0
2025-01-10 10:00,99,55,44,0,0,0
2025-01-10 10:15,88,55,33,0,0,0
2025-01-10 10:30,88,39,49,0,0,0
2025-01-10 10:45,103,58,45,0,0,0
2025-01-10 11:00,104,53,51,0,0,0
2025-01-10 11:15,81,47,34,0,0,0
2025-01-10 11:30,92,41,51,0,0,0
2025-01-10 11:45,107,56,51,0,0,0
2025-01-10 12:00,98,50,48,0,0,0
2025-01-10 12:15,117,44,73,0,0,0
2025-01-10 12:30,122,49,73,0,0,0
2025-01-10 12:45,116,52,64,0,0,0
2025-01-10 13:00,146,58,88,0,0,0
2025-01-10 13:15,137,59,78,0,0,0
2025-01-10 13:30,151,55,96,0,0,0
2025-01-10 13:45,122,47,75,0,0,0
2025-01-10 14:00,152,72,80,0,0,0
2025-01-10 14:15,158,60,98,0,0,0
2025-01-10 14:30,151,59,92,0,0,0
2025-01-10 14:45,192,88,104,0,0,0
2025-01-10 15:00,158,72,86,0,0,0
2025-01-10 15:15,167,81,86,0,0,0
2025-01-10 15:30,174,80,94,0,0,0
2025-01-10 15:45,147,81,66,0,0,0
2025-01-10 16:00,127,47,80,0,0,0
2025-01-10 16:15,159,61,98,0,0,0
2025-01-10 16:30,123,55,68,0,0,0
2025-01-10 16:45,149,62,87,0,0,0
2025-01-10 17:00,121,44,77,0,0,0
2025-01-10 17:15,120,55,65,0,0,0
2025-01-10 17:30,122,46,76,0,0,0
2025-01-10 17:45,125,52,73,0,0,0
2025-01-10 18:00,131,54,77,0,0,0
2025-01-10 18:15,117,57,60,0,0,0
2025-01-10 18:30,110,41,69,0,0,0
2025-01-10 18:45,125,65,60,0,0,0
2025-01-10 19:00,94,39,55,0,0,0
2025-01-10 19:15,87,35,52,0,0,0
2025-01-10 19:30,81,41,40,0,0,0
2025-01-10 19:45,95,34,61,0,0,0
2025-01-10 20:00,72,28,44,0,0,0
2025-01-10 20:15,88,43,45,0,0,0
2025-01-10 20:30,52,20,32,0,0,0
2025-01-10 20:45,50,15,35,0,0,0
2025-01-10 21:00,45,19,26,0,0,0
2025-01-10 21:15,61,32,29,0,0,0
2025-01-10 21:30,42,8,34,0,0,0
2025-01-10 21:45,37,8,29,0,0,0
2025-01-10 22:00,40,11,29,0,0,0
2025-01-10 22:15,47,18,29,0,0,0
2025-01-10 22:30,32,8,24,0,0,0
2025-01-10 22:45,47,24,23,0,0,0
2025-01-10 23:00,62,20,42,0,0,0
2025-01-10 23:15,39,7,32,0,0,0
2025-01-10 23:30,41,14,27,0,0,0
2025-01-10 23:45,21,10,11,0,0,0
2025-01-11 00:00,26,10,16,0,0,0
2025-01-11 00:15,30,9,21,0,0,0
2025-01-11 00:30,22,8,14,0,0,0
2025-01-11 00:45,27,11,16,0,0,0
2025-01-11 01:00,25,9,16,0,0,0
2025-01-11 01:15,19,5,14,0,0,0
2025-01-11 01:30,9,0,9,0,0,0
2025-01-11 01:45,23,3,20,0,0,0
2025-01-11 02:00,5,4,1,0,0,0
2025-01-11 02:15,11,4,7,0,0,0
2025-01-11 02:30,8,4,4,0,0,0
2025-01-11 02:45,7,2,5,0,0,0
2025-01-11 03:00,4,1,3,0,0,0
2025-01-11 03:15,6,1,5,0,0,0
2025-01-11 03:30,5,2,3,0,0,0
2025-01-11 03:45,2,2,0,0,0,0
2025-01-11 04:00,3,0,3,0,0,0
2025-01-11 04:15,1,0,1,0,0,0
2025-01-11 04:30,3,2,1,0,0,0
2025-01-11 04:45,3,0,3,0,0,0
2025-01-11 05:00,4,2,2,0,0,0
2025-01-11 05:15,8,2,6,0,0,0
2025-01-11 05:30,6,4,2,0,0,0
2025-01-11 05:45,5,5,0,0,0,0
2025-01-11 06:00,9,4,5,0,0,0
2025-01-11 06:15,8,6,2,0,0,0
2025-01-11 06:30,5,2,3,0,0,0
2025-01-11 06:45,9,5,4,0,0,0
2025-01-11 07:00,11,9,2,0,0,0
2025-01-11 07:15,7,3,4,0,0,0
2025-01-11 07:30,7,4,3,0,0,0
2025-01-11 07:45,25,13,12,0,0,0
2025-01-11 08:00,18,14,4,0,0,0
2025-01-11 08:15,28,15,13,0,0,0
2025-01-11 08:30,32,20,12,0,0,0
2025-01-11 08:45,50,39,11,0,0,0
2025-01-11 09:00,42,30,12,0,0,0
2025-01-11 09:15,39,25,14,0,0,0
2025-01-11 09:30,58,44,14,0,0,0
2025-01-11 09:45,104,71,33,0,0,0
2025-01-11 10:00,62,40,22,0,0,0
2025-01-11 10:15,82,54,28,0,0,0
2025-01-11 10:30,77,53,24,0,0,0
2025-01-11 10:45,112,71,41,0,0,0
2025-01-11 11:00,113,76,37,0,0,0
2025-01-11 11:15,111,69,42,0,0,0
2025-01-11 11:30,90,60,30,0,0,0
2025-01-11 11:45,123,72,51,0,0,0
2025-01-11 12:00,134,61,73,0,0,0
2025-01-11 12:15,152,84,68,0,0,0
2025-01-11 12:30,133,61,72,0,0,0
2025-01-11 12:45,143,97,46,0,0,0
2025-01-11 13:00,131,69,62,0,0,0
2025-01-11 13:15,177,91,86,0,0,0
2025-01-11 13:30,158,96,62,0,0,0
2025-01-11 13:45,129,79,50,0,0,0
2025-01-11 14:00,137,73,64,0,0,0
2025-01-11 14:15,119,49,70,0,0,0
2025-01-11 14:30,119,52,67,0,0,0
2025-01-11 14:45,142,43,99,0,0,0
2025-01-11 15:00,104,33,71,0,0,0
2025-01-11 15:15,111,40,71,0,0,0
2025-01-11 15:30,96,37,59,0,0,0
2025-01-11 15:45,83,35,48,0,0,0
2025-01-11 16:00,91,37,54,0,0,0
2025-01-11 16:15,99,54,45,0,0,0
2025-01-11 16:30,101,32,69,0,0,0
2025-01-11 16:45,118,48,70,0,0,0
2025-01-11 17:00,112,37,75,0,0,0
2025-01-11 17:15,81,39,42,0,0,0
2025-01-11 17:30,109,42,67,0,0,0
2025-01-11 17:45,108,48,60,0,0,0
2025-01-11 18:00,89,31,58,0,0,0
2025-01-11 18:15,97,30,67,0,0,0
2025-01-11 18:30,78,28,50,0,0,0
2025-01-11 18:45,92,49,43,0,0,0
2025-01-11 19:00,65,30,35,0,0,0
2025-01-11 19:15,61,24,37,0,0,0
2025-01-11 19:30,71,35,36,0,0,0
2025-01-11 19:45,62,28,34,0,0,0
2025-01-11 20:00,56,32,24,0,0,0
2025-01-11 20:15,53,19,34,0,0,0
2025-01-11 20:30,59,22,37,0,0,0
2025-01-11 20:45,41,15,26,0,0,0
2025-01-11 21:00,36,16,20,0,0,0
2025-01-11 21:15,26,6,20,0,0,0
2025-01-11 21:30,37,10,27,0,0,0
2025-01-11 21:45,34,11,23,0,0,0
2025-01-11 22:00,45,9,36,0,0,0
2025-01-11 22:15,36,11,25,0,0,0
2025-01-11 22:30,30,8,22,0,0,0
2025-01-11 22:45,42,19,23,0,0,0
2025-01-11 23:00,30,7,23,0,0,0
2025-01-11 23:15,41,17,24,0,0,0
2025-01-11 23:30,23,6,17,0,0,0
2025-01-11 23:45,27,8,19,0,0,0
2025-01-12 00:00,26,9,17,0,0,0
2025-01-12 00:15,22,14,8,0,0,0
2025-01-12 00:30,26,8,18,0,0,0
2025-01-12 00:45,28,6,22,0,0,0
2025-01-12 01:00,17,2,15,0,0,0
2025-01-12 01:15,15,5,10,0,0,0
2025-01-12 01:30,20,4,16,0,0,0
2025-01-12 01:45,17,6,11,0,0,0
2025-01-12 02:00,11,2,9,0,0,0
2025-01-12 02:15,17,7,10,0,0,0
2025-01-12 02:30,10,3,7,0,0,0
2025-01-12 02:45,15,6,9,0,0,0
2025-01-12 03:00,8,5,3,0,0,0
2025-01-12 03:15,6,2,4,0,0,0
2025-01-12 03:30,9,2,7,0,0,0
2025-01-12 03:45,1,0,1,0,0,0
2025-01-12 04:00,0,0,0,0,0,0
2025-01-12 04:15,6,0,6,0,0,0
2025-01-12 04:30,8,2,6,0,0,0
2025-01-12 04:45,3,0,3,0,0,0
2025-01-12 05:00,0,0,0,0,0,0
2025-01-12 05:15,0,0,0,0,0,0
2025-01-12 05:30,3,2,1,0,0,0
2025-01-12 05:45,3,1,2,0,0,0
2025-01-12 06:00,5,1,4,0,0,0
2025-01-12 06:15,7,4,3,0,0,0
2025-01-12 06:30,2,0,2,0,0,0
2025-01-12 06:45,6,3,3,0,0,0
2025-01-12 07:00,2,0,2,0,0,0
2025-01-12 07:15,2,1,1,0,0,0
2025-01-12 07:30,5,1,4,0,0,0
2025-01-12 07:45,8,3,5,0,0,0
2025-01-12 08:00,8,6,2,0,0,0
2025-01-12 08:15,9,5,4,0,0,0
2025-01-12 08:30,17,11,6,0,0,0
2025-01-12 08:45,13,10,3,0,0,0
2025-01-12 09:00,16,11,5,0,0,0
2025-01-12 09:15,18,12,6,0,0,0
2025-01-12 09:30,16,12,4,0,0,0
2025-01-12 09:45,56,43,13,0,0,0
2025-01-12 10:00,32,23,9,0,0,0
2025-01-12 10:15,31,16,15,0,0,0
2025-01-12 10:30,24,12,12,0,0,0
2025-01-12 10:45,31,15,16,0,0,0
2025-01-12 11:00,27,16,11,0,0,0
2025-01-12 11:15,25,16,9,0,0,0
2025-01-12 11:30,29,15,14,0,0,0
2025-01-12 11:45,56,31,25,0,0,0
2025-01-12 12:00,40,12,28,0,0,0
2025-01-12 12:15,42,27,15,0,0,0
2025-01-12 12:30,57,32,25,0,0,0
2025-01-12 12:45,51,33,18,0,0,0
2025-01-12 13:00,48,23,25,0,0,0
2025-01-12 13:15,45,23,22,0,0,0
2025-01-12 13:30,57,28,29,0,0,0
2025-01-12 13:45,75,38,37,0,0,0
2025-01-12 14:00,56,31,25,0,0,0
2025-01-12 14:15,35,17,18,0,0,0
2025-01-12 14:30,60,24,36,0,0,0
2025-01-12 14:45,71,35,36,0,0,0
2025-01-12 15:00,55,28,27,0,0,0
2025-01-12 15:15,56,22,34,0,0,0
2025-01-12 15:30,60,15,45,0,0,0
2025-01-12 15:45,71,27,44,0,0,0
2025-01-12 16:00,55,31,24,0,0,0
2025-01-12 16:15,47,18,29,0,0,0
2025-01-12 16:30,58,20,38,0,0,0
2025-01-12 16:45,68,25,43,0,0,0
2025-01-12 17:00,37,16,21,0,0,0
2025-01-12 17:15,53,15,38,0,0,0
2025-01-12 17:30,59,20,39,0,0,0
2025-01-12 17:45,76,26,50,0,0,0
2025-01-12 18:00,58,28,30,0,0,0
2025-01-12 18:15,60,28,32,0,0,0
2025-01-12 18:30,38,15,23,0,0,0
2025-01-12 18:45,49,24,25,0,0,0
2025-01-12 19:00,45,25,20,0,0,0
2025-01-12 19:15,37,21,16,0,0,0
2025-01-12 19:30,40,14,26,0,0,0
2025-01-12 19:45,54,20,34,0,0,0
2025-01-12 20:00,47,16,31,0,0,0
2025-01-12 20:15,46,23,23,0,0,0
2025-01-12 20:30,31,13,18,0,0,0
2025-01-12 20:45,28,5,23,0,0,0
2025-01-12 21:00,36,12,24,0,0,0
2025-01-12 21:15,17,7,10,0,0,0
2025-01-12 21:30,18,7,11,0,0,0
2025-01-12 21:45,29,13,16,0,0,0
2025-01-12 22:00,17,4,13,0,0,0
2025-01-12 22:15,24,12,12,0,0,0
2025-01-12 22:30,21,10,11,0,0,0
2025-01-12 22:45,14,6,8,0,0,0
2025-01-12 23:00,18,4,14,0,0,0
2025-01-12 23:15,6,1,5,0,0,0
2025-01-12 23:30,4,1,3,0,0,0
2025-01-12 23:45,2,0,2,0,0,0
2025-01-13 00:00,5,2,3,0,0,0
2025-01-13 00:15,5,1,4,0,0,0
2025-01-13 00:30,4,3,1,0,0,0
2025-01-13 00:45,4,3,1,0,0,0
2025-01-13 01:00,0,0,0,0,0,0
2025-01-13 01:15,1,1,0,0,0,0
2025-01-13 01:30,1,0,1,0,0,0
2025-01-13 01:45,2,2,0,0,0,0
2025-01-13 02:00,1,1,0,0,0,0
2025-01-13 02:15,0,0,0,0,0,0
2025-01-13 02:30,0,0,0,0,0,0
2025-01-13 02:45,1,1,0,0,0,0
2025-01-13 03:00,0,0,0,0,0,0
2025-01-13 03:15,0,0,0,0,0,0
2025-01-13 03:30,1,1,0,0,0,0
2025-01-13 03:45,0,0,0,0,0,0
2025-01-13 04:00,0,0,0,0,0,0
2025-01-13 04:15,2,1,1,0,0,0
2025-01-13 04:30,1,1,0,0,0,0
2025-01-13 04:45,3,3,0,0,0,0
2025-01-13 05:00,2,0,2,0,0,0
2025-01-13 05:15,10,5,5,0,0,0
2025-01-13 05:30,8,6,2,0,0,0
2025-01-13 05:45,13,11,2,0,0,0
2025-01-13 06:00,18,11,7,0,0,0
2025-01-13 06:15,28,23,5,0,0,0
2025-01-13 06:30,45,28,17,0,0,0
2025-01-13 06:45,54,28,26,0,0,0
2025-01-13 07:00,70,32,38,0,0,0
2025-01-13 07:15,101,67,34,0,0,0
2025-01-13 07:30,160,103,57,0,0,0
2025-01-13 07:45,199,138,61,0,0,0
2025-01-13 08:00,155,104,51,0,0,0
2025-01-13 08:15,147,96,51,0,0,0
2025-01-13 08:30,122,83,39,0,0,0
2025-01-13 08:45,145,98,47,0,0,0
2025-01-13 09:00,96,64,32,0,0,0
2025-01-13 09:15,86,55,31,0,0,0
2025-01-13 09:30,87,50,37,0,0,0
2025-01-13 09:45,121,90,31,0,0,0
2025-01-13 10:00,116,80,36,0,0,0
2025-01-13 10:15,80,51,29,0,0,0
2025-01-13 10:30,65,33,32,0,0,0
2025-01-13 10:45,78,44,34,0,0,0
2025-01-13 11:00,94,39,55,0,0,0
2025-01-13 11:15,85,37,48,0,0,0
2025-01-13 11:30,86,45,41,0,0,0
2025-01-13 11:45,118,65,53,0,0,0
2025-01-13 12:00,96,56,40,0,0,0
2025-01-13 12:15,112,55,57,0,0,0
2025-01-13 12:30,102,45,57,0,0,0
2025-01-13 12:45,120,56,64,0,0,0
2025-01-13 13:00,131,42,89,0,0,0
2025-01-13 13:15,112,49,63,0,0,0
2025-01-13 13:30,123,57,66,0,0,0
2025-01-13 13:45,126,58,68,0,0,0
2025-01-13 14:00,121,51,70,0,0,0
2025-01-13 14:15,123,47,76,0,0,0
2025-01-13 14:30,124,54,70,0,0,0
2025-01-13 14:45,127,60,67,0,0,0
2025-01-13 15:00,134,59,75,0,0,0
2025-01-13 15:15,141,47,94,0,0,0
2025-01-13 15:30,141,50,91,0,0,0
2025-01-13 15:45,198,83,115,0,0,0
2025-01-13 16:00,185,71,114,0,0,0
2025-01-13 16:15,176,72,104,0,0,0
2025-01-13 16:30,169,68,101,0,0,0
2025-01-13 16:45,168,72,96,0,0,0
2025-01-13 17:00,159,60,99,0,0,0
2025-01-13 17:15,153,52,101,0,0,0
2025-01-13 17:30,158,59,99,0,0,0
2025-01-13 17:45,185,59,126,0,0,0
2025-01-13 18:00,158,50,108,0,0,0
2025-01-13 18:15,141,46,95,0,0,0
2025-01-13 18:30,103,32,71,0,0,0
2025-01-13 18:45,121,46,75,0,0,0
2025-01-13 19:00,77,25,52,0,0,0
2025-01-13 19:15,105,37,68,0,0,0
2025-01-13 19:30,96,30,66,0,0,0
2025-01-13 19:45,83,36,47,0,0,0
2025-01-13 20:00,79,32,47,0,0,0
2025-01-13 20:15,53,17,36,0,0,0
2025-01-13 20:30,44,14,30,0,0,0
2025-01-13 20:45,51,14,37,0,0,0
2025-01-13 21:00,43,15,28,0,0,0
2025-01-13 21:15,49,19,30,0,0,0
2025-01-13 21:30,42,10,32,0,0,0
2025-01-13 21:45,41,15,26,0,0,0
2025-01-13 22:00,54,17,37,0,0,0
2025-01-13 22:15,26,7,19,0,0,0
2025-01-13 22:30,29,9,20,0,0,0
2025-01-13 22:45,22,7,15,0,0,0
2025-01-13 23:00,30,7,23,0,0,0
2025-01-13 23:15,22,7,15,0,0,0
2025-01-13 23:30,13,3,10,0,0,0
2025-01-13 23:45,12,3,9,0,0,0
2025-01-14 00:00,12,6,6,0,0,0
2025-01-14 00:15,4,1,3,0,0,0
2025-01-14 00:30,1,0,1,0,0,0
2025-01-14 00:45,7,1,6,0,0,0
2025-01-14 01:00,0,0,0,0,0,0
2025-01-14 01:15,4,2,2,0,0,0
2025-01-14 01:30,0,0,0,0,0,0
2025-01-14 01:45,0,0,0,0,0,0
2025-01-14 02:00,0,0,0,0,0,0
2025-01-14 02:15,1,0,1,0,0,0
2025-01-14 02:30,0,0,0,0,0,0
2025-01-14 02:45,0,0,0,0,0,0
2025-01-14 03:00,0,0,0,0,0,0
2025-01-14 03:15,1,0,1,0,0,0
2025-01-14 03:30,1,1,0,0,0,0
2025-01-14 03:45,0,0,0,0,0,0
2025-01-14 04:00,1,1,0,0,0,0
2025-01-14 04:15,4,3,1,0,0,0
2025-01-14 04:30,3,1,2,0,0,0
2025-01-14 04:45,3,3,0,0,0,0
2025-01-14 05:00,4,3,1,0,0,0
2025-01-14 05:15,7,6,1,0,0,0
2025-01-14 05:30,13,7,6,0,0,0
2025-01-14 05:45,22,14,8,0,0,0
2025-01-14 06:00,14,11,3,0,0,0
2025-01-14 06:15,37,31,6,0,0,0
2025-01-14 06:30,40,24,16,0,0,0
2025-01-14 06:45,64,39,25,0,0,0
2025-01-14 07:00,78,44,34,0,0,0
2025-01-14 07:15,102,63,39,0,0,0
2025-01-14 07:30,165,107,58,0,0,0
2025-01-14 07:45,183,121,62,0,0,0
2025-01-14 08:00,187,138,49,0,0,0
2025-01-14 08:15,180,119,61,0,0,0
2025-01-14 08:30,113,85,28,0,0,0
2025-01-14 08:45,145,92,53,0,0,0
2025-01-14 09:00,117,75,42,0,0,0
2025-01-14 09:15,82,57,25,0,0,0
2025-01-14 09:30,81,58,23,0,0,0
2025-01-14 09:45,124,85,39,0,0,0
2025-01-14 10:00,103,61,42,0,0,0
2025-01-14 10:15,86,53,33,0,0,0
2025-01-14 10:30,65,41,24,0,0,0
2025-01-14 10:45,88,53,35,0,0,0
2025-01-14 11:00,80,38,42,0,0,0
2025-01-14 11:15,83,33,50,0,0,0
2025-01-14 11:30,88,50,38,0,0,0
2025-01-14 11:45,121,55,66,0,0,0
2025-01-14 12:00,107,52,55,0,0,0
2025-01-14 12:15,110,44,66,0,0,0
2025-01-14 12:30,119,34,85,0,0,0
2025-01-14 12:45,111,55,56,0,0,0
2025-01-14 13:00,111,49,62,0,0,0
2025-01-14 13:15,120,48,72,0,0,0
2025-01-14 13:30,114,40,74,0,0,0
2025-01-14 13:45,158,71,87,0,0,0
2025-01-14 14:00,131,53,78,0,0,0
2025-01-14 14:15,116,47,69,0,0,0
2025-01-14 14:30,112,49,63,0,0,0
2025-01-14 14:45,133,57,76,0,0,0
2025-01-14 15:00,138,56,82,0,0,0
2025-01-14 15:15,127,50,77,0,0,0
2025-01-14 15:30,133,52,81,0,0,0
2025-01-14 15:45,168,84,84,0,0,0
2025-01-14 16:00,142,51,91,0,0,0
2025-01-14 16:15,151,58,93,0,0,0
2025-01-14 16:30,150,63,87,0,0,0
2025-01-14 16:45,171,69,102,0,0,0
2025-01-14 17:00,155,58,97,0,0,0
2025-01-14 17:15,142,55,87,0,0,0
2025-01-14 17:30,145,52,93,0,0,0
2025-01-14 17:45,193,96,97,0,0,0
2025-01-14 18:00,169,61,108,0,0,0
2025-01-14 18:15,146,71,75,0,0,0
2025-01-14 18:30,104,29,75,0,0,0
2025-01-14 18:45,113,38,75,0,0,0
2025-01-14 19:00,107,35,72,0,0,0
2025-01-14 19:15,99,37,62,0,0,0
2025-01-14 19:30,75,30,45,0,0,0
2025-01-14 19:45,84,32,52,0,0,0
2025-01-14 20:00,64,21,43,0,0,0
2025-01-14 20:15,60,18,42,0,0,0
2025-01-14 20:30,43,12,31,0,0,0
2025-01-14 20:45,47,13,34,0,0,0
2025-01-14 21:00,43,14,29,0,0,0
2025-01-14 21:15,39,17,22,0,0,0
2025-01-14 21:30,51,20,31,0,0,0
2025-01-14 21:45,58,20,38,0,0,0
2025-01-14 22:00,50,9,41,0,0,0
2025-01-14 22:15,42,17,25,0,0,0
2025-01-14 22:30,58,15,43,0,0,0
2025-01-14 22:45,27,8,19,0,0,0
2025-01-14 23:00,30,8,22,0,0,0
2025-01-14 23:15,16,5,11,0,0,0
2025-01-14 23:30,10,2,8,0,0,0
2025-01-14 23:45,14,6,8,0,0,0
2025-01-15 00:00,12,3,9,0,0,0
2025-01-15 00:15,6,1,5,0,0,0
2025-01-15 00:30,5,0,5,0,0,0
2025-01-15 00:45,7,2,5,0,0,0
2025-01-15 01:00,4,0,4,0,0,0
2025-01-15 01:15,0,0,0,0,0,0
2025-01-15 01:30,2,0,2,0,0,0
2025-01-15 01:45,0,0,0,0,0,0
2025-01-15 02:00,1,0,1,0,0,0
2025-01-15 02:15,2,0,2,0,0,0
2025-01-15 02:30,0,0,0,0,0,0
2025-01-15 02:45,0,0,0,0,0,0
2025-01-15 03:00,0,0,0,0,0,0
2025-01-15 03:15,0,0,0,0,0,0
2025-01-15 03:30,1,1,0,0,0,0
2025-01-15 03:45,1,0,1,0,0,0
2025-01-15 04:00,0,0,0,0,0,0
2025-01-15 04:15,1,1,0,0,0,0
2025-01-15 04:30,2,1,1,0,0,0
2025-01-15 04:45,2,2,0,0,0,0
2025-01-15 05:00,5,4,1,0,0,0
2025-01-15 05:15,10,8,2,0,0,0
2025-01-15 05:30,14,8,6,0,0,0
2025-01-15 05:45,13,7,6,0,0,0
2025-01-15 06:00,18,14,4,0,0,0
2025-01-15 06:15,28,22,6,0,0,0
2025-01-15 06:30,39,26,13,0,0,0
2025-01-15 06:45,61,39,22,0,0,0
2025-01-15 07:00,76,44,32,0,0,0
2025-01-15 07:15,118,70,48,0,0,0
2025-01-15 07:30,148,78,70,0,0,0
2025-01-15 07:45,178,118,60,0,0,0
2025-01-15 08:00,176,129,47,0,0,0
2025-01-15 08:15,152,104,48,0,0,0
2025-01-15 08:30,137,85,52,0,0,0
2025-01-15 08:45,163,114,49,0,0,0
2025-01-15 09:00,123,92,31,0,0,0
2025-01-15 09:15,100,69,31,0,0,0
2025-01-15 09:30,96,60,36,0,0,0
2025-01-15 09:45,112,78,34,0,0,0
2025-01-15 10:00,102,60,42,0,0,0
2025-01-15 10:15,93,65,28,0,0,0
2025-01-15 10:30,95,51,44,0,0,0
2025-01-15 10:45,82,48,34,0,0,0
2025-01-15 11:00,98,37,61,0,0,0
2025-01-15 11:15,90,49,41,0,0,0
2025-01-15 11:30,99,55,44,0,0,0
2025-01-15 11:45,131,59,72,0,0,0
2025-01-15 12:00,125,64,61,0,0,0
2025-01-15 12:15,120,53,67,0,0,0
2025-01-15 12:30,119,48,71,0,0,0
2025-01-15 12:45,124,53,71,0,0,0
2025-01-15 13:00,108,33,75,0,0,0
2025-01-15 13:15,145,51,94,0,0,0
2025-01-15 13:30,100,41,59,0,0,0
2025-01-15 13:45,129,50,79,0,0,0
2025-01-15 14:00,164,69,95,0,0,0
2025-01-15 14:15,129,51,78,0,0,0
2025-01-15 14:30,113,39,74,0,0,0
2025-01-15 14:45,143,57,86,0,0,0
2025-01-15 15:00,141,48,93,0,0,0
2025-01-15 15:15,130,44,86,0,0,0
2025-01-15 15:30,137,58,79,0,0,0
2025-01-15 15:45,167,74,93,0,0,0
2025-01-15 16:00,165,65,100,0,0,0
2025-01-15 16:15,183,84,99,0,0,0
2025-01-15 16:30,137,60,77,0,0,0
2025-01-15 16:45,152,52,100,0,0,0
2025-01-15 17:00,177,60,117,0,0,0
2025-01-15 17:15,161,61,100,0,0,0
2025-01-15 17:30,137,50,87,0,0,0
2025-01-15 17:45,197,79,118,0,0,0
2025-01-15 18:00,152,44,108,0,0,0
2025-01-15 18:15,150,46,104,0,0,0
2025-01-15 18:30,124,44,80,0,0,0
2025-01-15 18:45,140,60,80,0,0,0
2025-01-15 19:00,117,30,87,0,0,0
2025-01-15 19:15,87,31,56,0,0,0
2025-01-15 19:30,82,26,56,0,0,0
2025-01-15 19:45,98,37,61,0,0,0
2025-01-15 20:00,84,28,56,0,0,0
2025-01-15 20:15,61,22,39,0,0,0
2025-01-15 20:30,55,11,44,0,0,0
2025-01-15 20:45,71,36,35,0,0,0
2025-01-15 21:00,61,27,34,0,0,0
2025-01-15 21:15,67,27,40,0,0,0
2025-01-15 21:30,54,24,30,0,0,0
2025-01-15 21:45,72,19,53,0,0,0
2025-01-15 22:00,58,28,30,0,0,0
2025-01-15 22:15,44,11,33,0,0,0
2025-01-15 22:30,55,22,33,0,0,0
2025-01-15 22:45,42,19,23,0,0,0
2025-01-15 23:00,26,7,19,0,0,0
2025-01-15 23:15,33,11,22,0,0,0
2025-01-15 23:30,24,14,10,0,0,0
2025-01-15 23:45,10,6,4,0,0,0
2025-01-16 00:00,12,4,8,0,0,0
2025-01-16 00:15,5,1,4,0,0,0
2025-01-16 00:30,4,2,2,0,0,0
2025-01-16 00:45,3,2,1,0,0,0
2025-01-16 01:00,6,3,3,0,0,0
2025-01-16 01:15,8,3,5,0,0,0
2025-01-16 01:30,10,5,5,0,0,0
2025-01-16 01:45,3,0,3,0,0,0
2025-01-16 02:00,0,0,0,0,0,0
2025-01-16 02:15,0,0,0,0,0,0
2025-01-16 02:30,2,2,0,0,0,0
2025-01-16 02:45,4,0,4,0,0,0
2025-01-16 03:00,4,0,4,0,0,0
2025-01-16 03:15,1,0,1,0,0,0
2025-01-16 03:30,3,3,0,0,0,0
2025-01-16 03:45,0,0,0,0,0,0
2025-01-16 04:00,1,0,1,0,0,0
2025-01-16 04:15,2,2,0,0,0,0
2025-01-16 04:30,4,2,2,0,0,0
2025-01-16 04:45,2,2,0,0,0,0
2025-01-16 05:00,3,3,0,0,0,0
2025-01-16 05:15,10,6,4,0,0,0
2025-01-16 05:30,15,6,9,0,0,0
2025-01-16 05:45,12,5,7,0,0,0
2025-01-16 06:00,14,10,4,0,0,0
2025-01-16 06:15,28,18,10,0,0,0
2025-01-16 06:30,33,24,9,0,0,0
2025-01-16 06:45,60,37,23,0,0,0
2025-01-16 07:00,90,51,39,0,0,0
2025-01-16 07:15,111,73,38,0,0,0
2025-01-16 07:30,180,117,63,0,0,0
2025-01-16 07:45,179,122,57,0,0,0
2025-01-16 08:00,157,101,56,0,0,0
2025-01-16 08:15,149,103,46,0,0,0
2025-01-16 08:30,123,80,43,0,0,0
2025-01-16 08:45,118,76,42,0,0,0
2025-01-16 09:00,103,65,38,0,0,0
2025-01-16 09:15,87,56,31,0,0,0
2025-01-16 09:30,100,62,38,0,0,0
2025-01-16 09:45,140,107,33,0,0,0
2025-01-16 10:00,101,61,40,0,0,0
2025-01-16 10:15,93,63,30,0,0,0
2025-01-16 10:30,77,48,29,0,0,0
2025-01-16 10:45,85,44,41,0,0,0
2025-01-16 11:00,53,23,30,0,0,0
2025-01-16 11:15,92,51,41,0,0,0
2025-01-16 11:30,98,54,44,0,0,0
2025-01-16 11:45,128,67,61,0,0,0
2025-01-16 12:00,106,57,49,0,0,0
2025-01-16 12:15,110,55,55,0,0,0
2025-01-16 12:30,97,38,59,0,0,0
2025-01-16 12:45,120,59,61,0,0,0
2025-01-16 13:00,116,46,70,0,0,0
2025-01-16 13:15,128,45,83,0,0,0
2025-01-16 13:30,123,58,65,0,0,0
2025-01-16 13:45,153,75,78,0,0,0
2025-01-16 14:00,122,40,82,0,0,0
2025-01-16 14:15,93,29,64,0,0,0
2025-01-16 14:30,130,50,80,0,0,0
2025-01-16 14:45,169,75,94,0,0,0
2025-01-16 15:00,138,63,75,0,0,0
2025-01-16 15:15,125,64,61,0,0,0
2025-01-16 15:30,152,54,98,0,0,0
2025-01-16 15:45,184,82,102,0,0,0
2025-01-16 16:00,165,57,108,0,0,0
2025-01-16 16:15,185,59,126,0,0,0
2025-01-16 16:30,165,53,112,0,0,0
2025-01-16 16:45,173,73,100,0,0,0
2025-01-16 17:00,171,66,105,0,0,0
2025-01-16 17:15,206,78,128,0,0,0
2025-01-16 17:30,169,62,107,0,0,0
2025-01-16 17:45,171,79,92,0,0,0
2025-01-16 18:00,149,54,95,0,0,0
2025-01-16 18:15,164,44,120,0,0,0
2025-01-16 18:30,143,55,88,0,0,0
2025-01-16 18:45,118,48,70,0,0,0
2025-01-16 19:00,116,38,78,0,0,0
2025-01-16 19:15,100,45,55,0,0,0
2025-01-16 19:30,75,26,49,0,0,0
2025-01-16 19:45,101,46,55,0,0,0
2025-01-16 20:00,73,15,58,0,0,0
2025-01-16 20:15,63,21,42,0,0,0
2025-01-16 20:30,59,21,38,0,0,0
2025-01-16 20:45,38,15,23,0,0,0
2025-01-16 21:00,47,13,34,0,0,0
2025-01-16 21:15,52,19,33,0,0,0
2025-01-16 21:30,42,15,27,0,0,0
2025-01-16 21:45,58,12,46,0,0,0
2025-01-16 22:00,61,17,44,0,0,0
2025-01-16 22:15,57,16,41,0,0,0
2025-01-16 22:30,51,10,41,0,0,0
2025-01-16 22:45,38,13,25,0,0,0
2025-01-16 23:00,38,13,25,0,0,0
2025-01-16 23:15,25,11,14,0,0,0
2025-01-16 23:30,25,9,16,0,0,0
2025-01-16 23:45,11,3,8,0,0,0
2025-01-17 00:00,8,4,4,0,0,0
2025-01-17 00:15,13,4,9,0,0,0
2025-01-17 00:30,7,3,4,0,0,0
2025-01-17 00:45,6,3,3,0,0,0
2025-01-17 01:00,3,0,3,0,0,0
2025-01-17 01:15,8,3,5,0,0,0
2025-01-17 01:30,6,4,2,0,0,0
2025-01-17 01:45,1,1,0,0,0,0
2025-01-17 02:00,2,2,0,0,0,0
2025-01-17 02:15,0,0,0,0,0,0
2025-01-17 02:30,3,2,1,0,0,0
2025-01-17 02:45,5,5,0,0,0,0
2025-01-17 03:00,0,0,0,0,0,0
2025-01-17 03:15,0,0,0,0,0,0
2025-01-17 03:30,1,1,0,0,0,0
2025-01-17 03:45,2,1,1,0,0,0
2025-01-17 04:00,0,0,0,0,0,0
2025-01-17 04:15,2,2,0,0,0,0
2025-01-17 04:30,0,0,0,0,0,0
2025-01-17 04:45,4,4,0,0,0,0
2025-01-17 05:00,1,0,1,0,0,0
2025-01-17 05:15,7,3,4,0,0,0
2025-01-17 05:30,14,7,7,0,0,0
2025-01-17 05:45,11,7,4,0,0,0
2025-01-17 06:00,15,9,6,0,0,0
2025-01-17 06:15,32,21,11,0,0,0
2025-01-17 06:30,38,23,15,0,0,0
2025-01-17 06:45,46,23,23,0,0,0
2025-01-17 07:00,69,40,29,0,0,0
2025-01-17 07:15,92,67,25,0,0,0
2025-01-17 07:30,154,101,53,0,0,0
2025-01-17 07:45,177,119,58,0,0,0
2025-01-17 08:00,155,113,42,0,0,0
2025-01-17 08:15,108,68,40,0,0,0
2025-01-17 08:30,96,67,29,0,0,0
2025-01-17 08:45,133,90,43,0,0,0
2025-01-17 09:00,90,53,37,0,0,0
2025-01-17 09:15,85,56,29,0,0,0
2025-01-17 09:30,83,53,30,0,0,0
2025-01-17 09:45,127,92,35,0,0,0
2025-01-17 10:00,90,52,38,0,0,0
2025-01-17 10:15,77,41,36,0,0,0
2025-01-17 10:30,65,40,25,0,0,0
2025-01-17 10:45,101,63,38,0,0,0
2025-01-17 11:00,98,47,51,0,0,0
2025-01-17 11:15,94,58,36,0,0,0
2025-01-17 11:30,84,43,41,0,0,0
2025-01-17 11:45,125,64,61,0,0,0
2025-01-17 12:00,96,43,53,0,0,0
2025-01-17 12:15,123,53,70,0,0,0
2025-01-17 12:30,129,62,67,0,0,0
2025-01-17 12:45,139,56,83,0,0,0
2025-01-17 13:00,143,57,86,0,0,0
2025-01-17 13:15,116,46,70,0,0,0
2025-01-17 13:30,140,66,74,0,0,0
2025-01-17 13:45,149,69,80,0,0,0
2025-01-17 14:00,144,59,85,0,0,0
2025-01-17 14:15,135,53,82,0,0,0
2025-01-17 14:30,125,48,77,0,0,0
2025-01-17 14:45,137,65,72,0,0,0
2025-01-17 15:00,148,56,92,0,0,0
2025-01-17 15:15,152,63,89,0,0,0
2025-01-17 15:30,138,61,77,0,0,0
2025-01-17 15:45,141,57,84,0,0,0
2025-01-17 16:00,142,67,75,0,0,0
2025-01-17 16:15,152,63,89,0,0,0
2025-01-17 16:30,135,59,76,0,0,0
2025-01-17 16:45,120,53,67,0,0,0
2025-01-17 17:00,143,69,74,0,0,0
2025-01-17 17:15,133,62,71,0,0,0
2025-01-17 17:30,130,56,74,0,0,0
2025-01-17 17:45,145,62,83,0,0,0
2025-01-17 18:00,152,55,97,0,0,0
2025-01-17 18:15,114,36,78,0,0,0
2025-01-17 18:30,119,50,69,0,0,0
2025-01-17 18:45,148,78,70,0,0,0
2025-01-17 19:00,102,30,72,0,0,0
2025-01-17 19:15,101,44,57,0,0,0
2025-01-17 19:30,73,18,55,0,0,0
2025-01-17 19:45,88,49,39,0,0,0
2025-01-17 20:00,73,25,48,0,0,0
2025-01-17 20:15,71,21,50,0,0,0
2025-01-17 20:30,62,21,41,0,0,0
2025-01-17 20:45,57,19,38,0,0,0
2025-01-17 21:00,63,29,34,0,0,0
2025-01-17 21:15,49,16,33,0,0,0
2025-01-17 21:30,40,10,30,0,0,0
2025-01-17 21:45,40,14,26,0,0,0
2025-01-17 22:00,41,13,28,0,0,0
2025-01-17 22:15,42,23,19,0,0,0
2025-01-17 22:30,80,25,55,0,0,0
2025-01-17 22:45,47,21,26,0,0,0
2025-01-17 23:00,56,18,38,0,0,0
2025-01-17 23:15,34,12,22,0,0,0
2025-01-17 23:30,36,16,20,0,0,0
2025-01-17 23:45,45,21,24,0,0,0
2025-01-18 00:00,35,11,24,0,0,0
2025-01-18 00:15,26,9,17,0,0,0
2025-01-18 00:30,25,7,18,0,0,0
2025-01-18 00:45,15,5,10,0,0,0
2025-01-18 01:00,34,18,16,0,0,0
2025-01-18 01:15,11,2,9,0,0,0
2025-01-18 01:30,15,8,7,0,0,0
2025-01-18 01:45,8,3,5,0,0,0
2025-01-18 02:00,9,0,9,0,0,0
2025-01-18 02:15,12,2,10,0,0,0
2025-01-18 02:30,7,1,6,0,0,0
2025-01-18 02:45,7,2,5,0,0,0
2025-01-18 03:00,14,9,5,0,0,0
2025-01-18 03:15,10,2,8,0,0,0
2025-01-18 03:30,6,0,6,0,0,0
2025-01-18 03:45,2,0,2,0,0,0
2025-01-18 04:00,4,1,3,0,0,0
2025-01-18 04:15,1,0,1,0,0,0
2025-01-18 04:30,6,1,5,0,0,0
2025-01-18 04:45,1,1,0,0,0,0
2025-01-18 05:00,2,1,1,0,0,0
2025-01-18 05:15,3,1,2,0,0,0
2025-01-18 05:30,6,3,3,0,0,0
2025-01-18 05:45,1,0,1,0,0,0
2025-01-18 06:00,6,2,4,0,0,0
2025-01-18 06:15,9,5,4,0,0,0
2025-01-18 06:30,4,2,2,0,0,0
2025-01-18 06:45,8,8,0,0,0,0
2025-01-18 07:00,3,3,0,0,0,0
2025-01-18 07:15,12,5,7,0,0,0
2025-01-18 07:30,12,6,6,0,0,0
2025-01-18 07:45,32,19,13,0,0,0
2025-01-18 08:00,25,14,11,0,0,0
2025-01-18 08:15,30,20,10,0,0,0
2025-01-18 08:30,46,32,14,0,0,0
2025-01-18 08:45,55,34,21,0,0,0
2025-01-18 09:00,54,40,14,0,0,0
2025-01-18 09:15,54,34,20,0,0,0
2025-01-18 09:30,69,49,20,0,0,0
2025-01-18 09:45,101,75,26,0,0,0
2025-01-18 10:00,79,52,27,0,0,0
2025-01-18 10:15,85,55,30,0,0,0
2025-01-18 10:30,90,56,34,0,0,0
2025-01-18 10:45,113,71,42,0,0,0
2025-01-18 11:00,131,54,77,0,0,0
2025-01-18 11:15,138,65,73,0,0,0
2025-01-18 11:30,155,56,99,0,0,0
2025-01-18 11:45,236,54,182,0,0,0
2025-01-18 12:00,246,66,180,0,0,0
2025-01-18 12:15,200,74,126,0,0,0
2025-01-18 12:30,176,63,113,0,0,0
2025-01-18 12:45,140,75,65,0,0,0
2025-01-18 13:00,118,59,59,0,0,0
2025-01-18 13:15,115,66,49,0,0,0
2025-01-18 13:30,108,54,54,0,0,0
2025-01-18 13:45,144,67,77,0,0,0
2025-01-18 14:00,108,58,50,0,0,0
2025-01-18 14:15,94,32,62,0,0,0
2025-01-18 14:30,109,55,54,0,0,0
2025-01-18 14:45,153,77,76,0,0,0
2025-01-18 15:00,176,87,89,0,0,0
2025-01-18 15:15,258,196,62,0,0,0
2025-01-18 15:30,240,171,69,0,0,0
2025-01-18 15:45,134,77,57,0,0,0
2025-01-18 16:00,115,60,55,0,0,0
2025-01-18 16:15,104,58,46,0,0,0
2025-01-18 16:30,115,44,71,0,0,0
2025-01-18 16:45,107,49,58,0,0,0
2025-01-18 17:00,107,40,67,0,0,0
2025-01-18 17:15,110,41,69,0,0,0
2025-01-18 17:30,115,53,62,0,0,0
2025-01-18 17:45,101,47,54,0,0,0
2025-01-18 18:00,94,32,62,0,0,0
2025-01-18 18:15,98,38,60,0,0,0
2025-01-18 18:30,97,35,62,0,0,0
2025-01-18 18:45,83,27,56,0,0,0
2025-01-18 19:00,101,43,58,0,0,0
2025-01-18 19:15,70,26,44,0,0,0
2025-01-18 19:30,54,20,34,0,0,0
2025-01-18 19:45,64,25,39,0,0,0
2025-01-18 20:00,66,31,35,0,0,0
2025-01-18 20:15,44,18,26,0,0,0
2025-01-18 20:30,54,21,33,0,0,0
2025-01-18 20:45,61,29,32,0,0,0
2025-01-18 21:00,54,23,31,0,0,0
2025-01-18 21:15,30,11,19,0,0,0
2025-01-18 21:30,33,13,20,0,0,0
2025-01-18 21:45,38,17,21,0,0,0
2025-01-18 22:00,23,13,10,0,0,0
2025-01-18 22:15,27,6,21,0,0,0
2025-01-18 22:30,33,19,14,0,0,0
2025-01-18 22:45,41,12,29,0,0,0
2025-01-18 23:00,40,18,22,0,0,0
2025-01-18 23:15,48,26,22,0,0,0
2025-01-18 23:30,44,18,26,0,0,0
2025-01-18 23:45,26,5,21,0,0,0
2025-01-19 00:00,36,10,26,0,0,0
2025-01-19 00:15,30,8,22,0,0,0
2025-01-19 00:30,24,8,16,0,0,0
2025-01-19 00:45,25,13,12,0,0,0
2025-01-19 01:00,21,10,11,0,0,0
2025-01-19 01:15,16,7,9,0,0,0
2025-01-19 01:30,25,9,16,0,0,0
2025-01-19 01:45,14,2,12,0,0,0
2025-01-19 02:00,12,3,9,0,0,0
2025-01-19 02:15,8,3,5,0,0,0
2025-01-19 02:30,12,4,8,0,0,0
2025-01-19 02:45,3,0,3,0,0,0
2025-01-19 03:00,9,2,7,0,0,0
2025-01-19 03:15,7,1,6,0,0,0
2025-01-19 03:30,3,3,0,0,0,0
2025-01-19 03:45,2,0,2,0,0,0
2025-01-19 04:00,8,1,7,0,0,0
2025-01-19 04:15,4,2,2,0,0,0
2025-01-19 04:30,2,0,2,0,0,0
2025-01-19 04:45,2,0,2,0,0,0
2025-01-19 05:00,0,0,0,0,0,0
2025-01-19 05:15,1,0,1,0,0,0
2025-01-19 05:30,5,1,4,0,0,0
2025-01-19 05:45,4,1,3,0,0,0
2025-01-19 06:00,5,2,3,0,0,0
2025-01-19 06:15,4,4,0,0,0,0
2025-01-19 06:30,5,3,2,0,0,0
2025-01-19 06:45,4,4,0,0,0,0
2025-01-19 07:00,2,0,2,0,0,0
2025-01-19 07:15,1,1,0,0,0,0
2025-01-19 07:30,4,1,3,0,0,0
2025-01-19 07:45,8,5,3,0,0,0
2025-01-19 08:00,9,5,4,0,0,0
2025-01-19 08:15,6,4,2,0,0,0
2025-01-19 08:30,11,9,2,0,0,0
2025-01-19 08:45,16,14,2,0,0,0
2025-01-19 09:00,10,6,4,0,0,0
2025-01-19 09:15,12,8,4,0,0,0
2025-01-19 09:30,18,14,4,0,0,0
2025-01-19 09:45,42,36,6,0,0,0
2025-01-19 10:00,33,28,5,0,0,0
2025-01-19 10:15,49,23,26,0,0,0
2025-01-19 10:30,37,20,17,0,0,0
2025-01-19 10:45,38,29,9,0,0,0
2025-01-19 11:00,28,19,9,0,0,0
2025-01-19 11:15,36,16,20,0,0,0
2025-01-19 11:30,25,11,14,0,0,0
2025-01-19 11:45,38,15,23,0,0,0
2025-01-19 12:00,37,16,21,0,0,0
2025-01-19 12:15,36,11,25,0,0,0
2025-01-19 12:30,29,13,16,0,0,0
2025-01-19 12:45,46,22,24,0,0,0
2025-01-19 13:00,37,17,20,0,0,0
2025-01-19 13:15,42,20,22,0,0,0
2025-01-19 13:30,48,23,25,0,0,0
2025-01-19 13:45,65,27,38,0,0,0
2025-01-19 14:00,40,20,20,0,0,0
2025-01-19 14:15,64,25,39,0,0,0
2025-01-19 14:30,53,26,27,0,0,0
2025-01-19 14:45,48,30,18,0,0,0
2025-01-19 15:00,59,27,32,0,0,0
2025-01-19 15:15,54,23,31,0,0,0
2025-01-19 15:30,57,26,31,0,0,0
2025-01-19 15:45,45,25,20,0,0,0
2025-01-19 16:00,54,23,31,0,0,0
2025-01-19 16:15,47,19,28,0,0,0
2025-01-19 16:30,52,31,21,0,0,0
2025-01-19 16:45,56,23,33,0,0,0
2025-01-19 17:00,69,17,52,0,0,0
2025-01-19 17:15,93,22,71,0,0,0
2025-01-19 17:30,77,21,56,0,0,0
2025-01-19 17:45,55,22,33,0,0,0
2025-01-19 18:00,56,19,37,0,0,0
2025-01-19 18:15,40,18,22,0,0,0
2025-01-19 18:30,44,19,25,0,0,0
2025-01-19 18:45,58,23,35,0,0,0
2025-01-19 19:00,46,21,25,0,0,0
2025-01-19 19:15,36,15,21,0,0,0
2025-01-19 19:30,32,12,20,0,0,0
2025-01-19 19:45,33,20,13,0,0,0
2025-01-19 20:00,65,44,21,0,0,0
2025-01-19 20:15,134,99,35,0,0,0
2025-01-19 20:30,30,11,19,0,0,0
2025-01-19 20:45,24,7,17,0,0,0
2025-01-19 21:00,34,11,23,0,0,0
2025-01-19 21:15,20,6,14,0,0,0
2025-01-19 21:30,21,9,12,0,0,0
2025-01-19 21:45,31,21,10,0,0,0
2025-01-19 22:00,22,6,16,0,0,0
2025-01-19 22:15,14,7,7,0,0,0
2025-01-19 22:30,15,4,11,0,0,0
2025-01-19 22:45,9,3,6,0,0,0
2025-01-19 23:00,16,2,14,0,0,0
2025-01-19 23:15,3,3,0,0,0,0
2025-01-19 23:30,4,0,4,0,0,0
2025-01-19 23:45,3,0,3,0,0,0
2025-01-20 00:00,9,3,6,0,0,0
2025-01-20 00:15,8,6,2,0,0,0
2025-01-20 00:30,0,0,0,0,0,0
2025-01-20 00:45,0,0,0,0,0,0
2025-01-20 01:00,1,0,1,0,0,0
2025-01-20 01:15,1,0,1,0,0,0
2025-01-20 01:30,1,1,0,0,0,0
2025-01-20 01:45,0,0,0,0,0,0
2025-01-20 02:00,1,0,1,0,0,0
2025-01-20 02:15,0,0,0,0,0,0
2025-01-20 02:30,0,0,0,0,0,0
2025-01-20 02:45,0,0,0,0,0,0
2025-01-20 03:00,0,0,0,0,0,0
2025-01-20 03:15,0,0,0,0,0,0
2025-01-20 03:30,0,0,0,0,0,0
2025-01-20 03:45,0,0,0,0,0,0
2025-01-20 04:00,2,2,0,0,0,0
2025-01-20 04:15,2,2,0,0,0,0
2025-01-20 04:30,2,1,1,0,0,0
2025-01-20 04:45,4,4,0,0,0,0
2025-01-20 05:00,1,1,0,0,0,0
2025-01-20 05:15,6,4,2,0,0,0
2025-01-20 05:30,16,6,10,0,0,0
2025-01-20 05:45,14,8,6,0,0,0
2025-01-20 06:00,16,11,5,0,0,0
2025-01-20 06:15,43,34,9,0,0,0
2025-01-20 06:30,38,26,12,0,0,0
2025-01-20 06:45,68,40,28,0,0,0
2025-01-20 07:00,75,45,30,0,0,0
2025-01-20 07:15,105,68,37,0,0,0
2025-01-20 07:30,133,87,46,0,0,0
2025-01-20 07:45,168,127,41,0,0,0
2025-01-20 08:00,155,106,49,0,0,0
2025-01-20 08:15,137,97,40,0,0,0
2025-01-20 08:30,124,78,46,0,0,0
2025-01-20 08:45,137,96,41,0,0,0
2025-01-20 09:00,89,60,29,0,0,0
2025-01-20 09:15,84,57,27,0,0,0
2025-01-20 09:30,78,47,31,0,0,0
2025-01-20 09:45,125,85,40,0,0,0
2025-01-20 10:00,80,51,29,0,0,0
2025-01-20 10:15,62,43,19,0,0,0
2025-01-20 10:30,58,27,31,0,0,0
2025-01-20 10:45,84,54,30,0,0,0
2025-01-20 11:00,76,37,39,0,0,0
2025-01-20 11:15,87,37,50,0,0,0
2025-01-20 11:30,90,44,46,0,0,0
2025-01-20 11:45,84,51,33,0,0,0
2025-01-20 12:00,100,50,50,0,0,0
2025-01-20 12:15,96,48,48,0,0,0
2025-01-20 12:30,92,39,53,0,0,0
2025-01-20 12:45,105,46,59,0,0,0
2025-01-20 13:00,104,36,68,0,0,0
2025-01-20 13:15,106,49,57,0,0,0
2025-01-20 13:30,96,40,56,0,0,0
2025-01-20 13:45,147,76,71,0,0,0
2025-01-20 14:00,101,47,54,0,0,0
2025-01-20 14:15,99,42,57,0,0,0
2025-01-20 14:30,109,48,61,0,0,0
2025-01-20 14:45,128,66,62,0,0,0
2025-01-20 15:00,112,49,63,0,0,0
2025-01-20 15:15,124,60,64,0,0,0
2025-01-20 15:30,123,52,71,0,0,0
2025-01-20 15:45,152,72,80,0,0,0
2025-01-20 16:00,158,56,102,0,0,0
2025-01-20 16:15,152,62,90,0,0,0
2025-01-20 16:30,159,66,93,0,0,0
2025-01-20 16:45,167,69,98,0,0,0
2025-01-20 17:00,167,60,107,0,0,0
2025-01-20 17:15,159,59,100,0,0,0
2025-01-20 17:30,154,51,103,0,0,0
2025-01-20 17:45,158,58,100,0,0,0
2025-01-20 18:00,114,36,78,0,0,0
2025-01-20 18:15,124,49,75,0,0,0
2025-01-20 18:30,115,37,78,0,0,0
2025-01-20 18:45,112,45,67,0,0,0
2025-01-20 19:00,78,24,54,0,0,0
2025-01-20 19:15,61,25,36,0,0,0
2025-01-20 19:30,58,16,42,0,0,0
2025-01-20 19:45,84,29,55,0,0,0
2025-01-20 20:00,71,22,49,0,0,0
2025-01-20 20:15,55,17,38,0,0,0
2025-01-20 20:30,47,13,34,0,0,0
2025-01-20 20:45,55,15,40,0,0,0
2025-01-20 21:00,45,16,29,0,0,0
2025-01-20 21:15,28,11,17,0,0,0
2025-01-20 21:30,41,14,27,0,0,0
2025-01-20 21:45,38,12,26,0,0,0
2025-01-20 22:00,29,7,22,0,0,0
2025-01-20 22:15,21,9,12,0,0,0
2025-01-20 22:30,29,9,20,0,0,0
2025-01-20 22:45,28,11,17,0,0,0
2025-01-20 23:00,26,9,17,0,0,0
2025-01-20 23:15,8,3,5,0,0,0
2025-01-20 23:30,9,4,5,0,0,0
2025-01-20 23:45,19,5,14,0,0,0
2025-01-21 00:00,11,1,10,0,0,0
2025-01-21 00:15,3,0,3,0,0,0
2025-01-21 00:30,6,2,4,0,0,0
2025-01-21 00:45,3,2,1,0,0,0
2025-01-21 01:00,5,1,4,0,0,0
2025-01-21 01:15,1,0,1,0,0,0
2025-01-21 01:30,1,1,0,0,0,0
2025-01-21 01:45,0,0,0,0,0,0
2025-01-21 02:00,1,0,1,0,0,0
2025-01-21 02:15,0,0,0,0,0,0
2025-01-21 02:30,2,1,1,0,0,0
2025-01-21 02:45,0,0,0,0,0,0
2025-01-21 03:00,0,0,0,0,0,0
2025-01-21 03:15,2,1,1,0,0,0
2025-01-21 03:30,0,0,0,0,0,0
2025-01-21 03:45,2,1,1,0,0,0
2025-01-21 04:00,1,1,0,0,0,0
2025-01-21 04:15,3,3,0,0,0,0
2025-01-21 04:30,3,2,1,0,0,0
2025-01-21 04:45,4,4,0,0,0,0
2025-01-21 05:00,3,2,1,0,0,0
2025-01-21 05:15,6,2,4,0,0,0
2025-01-21 05:30,7,4,3,0,0,0
2025-01-21 05:45,24,16,8,0,0,0
2025-01-21 06:00,23,15,8,0,0,0
2025-01-21 06:15,36,29,7,0,0,0
2025-01-21 06:30,44,29,15,0,0,0
2025-01-21 06:45,66,35,31,0,0,0
2025-01-21 07:00,75,44,31,0,0,0
2025-01-21 07:15,96,64,32,0,0,0
2025-01-21 07:30,171,115,56,0,0,0
2025-01-21 07:45,173,116,57,0,0,0
2025-01-21 08:00,156,123,33,0,0,0
2025-01-21 08:15,161,110,51,0,0,0
2025-01-21 08:30,115,82,33,0,0,0
2025-01-21 08:45,131,83,48,0,0,0
2025-01-21 09:00,93,61,32,0,0,0
2025-01-21 09:15,96,57,39,0,0,0
2025-01-21 09:30,83,62,21,0,0,0
2025-01-21 09:45,116,79,37,0,0,0
2025-01-21 10:00,107,66,41,0,0,0
2025-01-21 10:15,77,38,39,0,0,0
2025-01-21 10:30,79,42,37,0,0,0
2025-01-21 10:45,93,49,44,0,0,0
2025-01-21 11:00,93,43,50,0,0,0
2025-01-21 11:15,81,42,39,0,0,0
2025-01-21 11:30,95,51,44,0,0,0
2025-01-21 11:45,105,57,48,0,0,0
2025-01-21 12:00,87,47,40,0,0,0
2025-01-21 12:15,117,55,62,0,0,0
2025-01-21 12:30,105,53,52,0,0,0
2025-01-21 12:45,147,66,81,0,0,0
2025-01-21 13:00,108,42,66,0,0,0
2025-01-21 13:15,120,59,61,0,0,0
2025-01-21 13:30,125,50,75,0,0,0
2025-01-21 13:45,145,74,71,0,0,0
2025-01-21 14:00,137,58,79,0,0,0
2025-01-21 14:15,112,46,66,0,0,0
2025-01-21 14:30,137,57,80,0,0,0
2025-01-21 14:45,144,62,82,0,0,0
2025-01-21 15:00,136,60,76,0,0,0
2025-01-21 15:15,124,53,71,0,0,0
2025-01-21 15:30,135,52,83,0,0,0
2025-01-21 15:45,156,65,91,0,0,0
2025-01-21 16:00,171,73,98,0,0,0
2025-01-21 16:15,156,62,94,0,0,0
2025-01-21 16:30,158,65,93,0,0,0
2025-01-21 16:45,171,72,99,0,0,0
2025-01-21 17:00,183,65,118,0,0,0
2025-01-21 17:15,167,59,108,0,0,0
2025-01-21 17:30,163,71,92,0,0,0
2025-01-21 17:45,180,73,107,0,0,0
2025-01-21 18:00,152,53,99,0,0,0
2025-01-21 18:15,166,65,101,0,0,0
2025-01-21 18:30,126,45,81,0,0,0
2025-01-21 18:45,127,51,76,0,0,0
2025-01-21 19:00,102,38,64,0,0,0
2025-01-21 19:15,96,49,47,0,0,0
2025-01-21 19:30,75,27,48,0,0,0
2025-01-21 19:45,95,30,65,0,0,0
2025-01-21 20:00,79,21,58,0,0,0
2025-01-21 20:15,75,22,53,0,0,0
2025-01-21 20:30,43,13,30,0,0,0
2025-01-21 20:45,41,13,28,0,0,0
2025-01-21 21:00,38,12,26,0,0,0
2025-01-21 21:15,52,24,28,0,0,0
2025-01-21 21:30,43,12,31,0,0,0
2025-01-21 21:45,35,11,24,0,0,0
2025-01-21 22:00,43,9,34,0,0,0
2025-01-21 22:15,43,12,31,0,0,0
2025-01-21 22:30,41,14,27,0,0,0
2025-01-21 22:45,25,11,14,0,0,0
2025-01-21 23:00,45,10,35,0,0,0
2025-01-21 23:15,17,5,12,0,0,0
2025-01-21 23:30,13,7,6,0,0,0
2025-01-21 23:45,12,5,7,0,0,0
2025-01-22 00:00,12,4,8,0,0,0
2025-01-22 00:15,5,1,4,0,0,0
2025-01-22 00:30,8,2,6,0,0,0
2025-01-22 00:45,2,1,1,0,0,0
2025-01-22 01:00,2,1,1,0,0,0
2025-01-22 01:15,2,0,2,0,0,0
2025-01-22 01:30,3,2,1,0,0,0
2025-01-22 01:45,1,1,0,0,0,0
2025-01-22 02:00,0,0,0,0,0,0
2025-01-22 02:15,0,0,0,0,0,0
2025-01-22 02:30,1,0,1,0,0,0
2025-01-22 02:45,0,0,0,0,0,0
2025-01-22 03:00,1,0,1,0,0,0
2025-01-22 03:15,0,0,0,0,0,0
2025-01-22 03:30,0,0,0,0,0,0
2025-01-22 03:45,0,0,0,0,0,0
2025-01-22 04:00,2,2,0,0,0,0
2025-01-22 04:15,2,2,0,0,0,0
2025-01-22 04:30,3,2,1,0,0,0
2025-01-22 04:45,4,4,0,0,0,0
2025-01-22 05:00,4,4,0,0,0,0
2025-01-22 05:15,10,4,6,0,0,0
2025-01-22 05:30,8,7,1,0,0,0
2025-01-22 05:45,16,9,7,0,0,0
2025-01-22 06:00,19,12,7,0,0,0
2025-01-22 06:15,41,30,11,0,0,0
2025-01-22 06:30,45,24,21,0,0,0
2025-01-22 06:45,65,36,29,0,0,0
2025-01-22 07:00,80,41,39,0,0,0
2025-01-22 07:15,118,72,46,0,0,0
2025-01-22 07:30,166,106,60,0,0,0
2025-01-22 07:45,183,120,63,0,0,0
2025-01-22 08:00,153,92,61,0,0,0
2025-01-22 08:15,175,108,67,0,0,0
2025-01-22 08:30,147,97,50,0,0,0
2025-01-22 08:45,150,96,54,0,0,0
2025-01-22 09:00,129,82,47,0,0,0
2025-01-22 09:15,100,64,36,0,0,0
2025-01-22 09:30,93,62,31,0,0,0
2025-01-22 09:45,156,104,52,0,0,0
2025-01-22 10:00,112,69,43,0,0,0
2025-01-22 10:15,95,61,34,0,0,0
2025-01-22 10:30,88,50,38,0,0,0
2025-01-22 10:45,105,65,40,0,0,0
2025-01-22 11:00,97,44,53,0,0,0
2025-01-22 11:15,92,56,36,0,0,0
2025-01-22 11:30,96,42,54,0,0,0
2025-01-22 11:45,149,76,73,0,0,0
2025-01-22 12:00,125,64,61,0,0,0
2025-01-22 12:15,132,68,64,0,0,0
2025-01-22 12:30,130,48,82,0,0,0
2025-01-22 12:45,137,61,76,0,0,0
2025-01-22 13:00,136,57,79,0,0,0
2025-01-22 13:15,134,48,86,0,0,0
2025-01-22 13:30,131,61,70,0,0,0
2025-01-22 13:45,138,59,79,0,0,0
2025-01-22 14:00,150,59,91,0,0,0
2025-01-22 14:15,133,53,80,0,0,0
2025-01-22 14:30,123,38,85,0,0,0
2025-01-22 14:45,162,78,84,0,0,0
2025-01-22 15:00,142,67,75,0,0,0
2025-01-22 15:15,105,48,57,0,0,0
2025-01-22 15:30,135,64,71,0,0,0
2025-01-22 15:45,162,73,89,0,0,0
2025-01-22 16:00,156,66,90,0,0,0
2025-01-22 16:15,166,72,94,0,0,0
2025-01-22 16:30,172,61,111,0,0,0
2025-01-22 16:45,191,88,103,0,0,0
2025-01-22 17:00,164,71,93,0,0,0
2025-01-22 17:15,171,65,106,0,0,0
2025-01-22 17:30,161,51,110,0,0,0
2025-01-22 17:45,193,82,111,0,0,0
2025-01-22 18:00,132,53,79,0,0,0
2025-01-22 18:15,141,57,84,0,0,0
2025-01-22 18:30,114,44,70,0,0,0
2025-01-22 18:45,140,53,87,0,0,0
2025-01-22 19:00,122,50,72,0,0,0
2025-01-22 19:15,110,55,55,0,0,0
2025-01-22 19:30,83,28,55,0,0,0
2025-01-22 19:45,95,31,64,0,0,0
2025-01-22 20:00,80,29,51,0,0,0
2025-01-22 20:15,63,21,42,0,0,0
2025-01-22 20:30,56,18,38,0,0,0
2025-01-22 20:45,55,11,44,0,0,0
2025-01-22 21:00,38,9,29,0,0,0
2025-01-22 21:15,39,9,30,0,0,0
2025-01-22 21:30,62,17,45,0,0,0
2025-01-22 21:45,51,14,37,0,0,0
2025-01-22 22:00,50,13,37,0,0,0
2025-01-22 22:15,49,12,37,0,0,0
2025-01-22 22:30,41,16,25,0,0,0
2025-01-22 22:45,32,5,27,0,0,0
2025-01-22 23:00,33,7,26,0,0,0
2025-01-22 23:15,32,11,21,0,0,0
2025-01-22 23:30,12,3,9,0,0,0
2025-01-22 23:45,15,6,9,0,0,0
2025-01-23 00:00,7,2,5,0,0,0
2025-01-23 00:15,13,9,4,0,0,0
2025-01-23 00:30,4,3,1,0,0,0
2025-01-23 00:45,7,2,5,0,0,0
2025-01-23 01:00,10,4,6,0,0,0
2025-01-23 01:15,4,0,4,0,0,0
2025-01-23 01:30,0,0,0,0,0,0
2025-01-23 01:45,2,0,2,0,0,0
2025-01-23 02:00,3,0,3,0,0,0
2025-01-23 02:15,3,1,2,0,0,0
2025-01-23 02:30,1,1,0,0,0,0
2025-01-23 02:45,3,0,3,0,0,0
2025-01-23 03:00,0,0,0,0,0,0
2025-01-23 03:15,1,0,1,0,0,0
2025-01-23 03:30,0,0,0,0,0,0
2025-01-23 03:45,1,1,0,0,0,0
2025-01-23 04:00,2,1,1,0,0,0
2025-01-23 04:15,2,2,0,0,0,0
2025-01-23 04:30,2,1,1,0,0,0
2025-01-23 04:45,5,5,0,0,0,0
2025-01-23 05:00,2,2,0,0,0,0
2025-01-23 05:15,10,4,6,0,0,0
2025-01-23 05:30,5,3,2,0,0,0
2025-01-23 05:45,16,6,10,0,0,0
2025-01-23 06:00,19,9,10,0,0,0
2025-01-23 06:15,28,21,7,0,0,0
2025-01-23 06:30,49,33,16,0,0,0
2025-01-23 06:45,54,34,20,0,0,0
2025-01-23 07:00,66,37,29,0,0,0
2025-01-23 07:15,96,56,40,0,0,0
2025-01-23 07:30,138,86,52,0,0,0
2025-01-23 07:45,153,94,59,0,0,0
2025-01-23 08:00,170,113,57,0,0,0
2025-01-23 08:15,143,97,46,0,0,0
2025-01-23 08:30,121,81,40,0,0,0
2025-01-23 08:45,154,104,50,0,0,0
2025-01-23 09:00,89,55,34,0,0,0
2025-01-23 09:15,74,44,30,0,0,0
2025-01-23 09:30,93,60,33,0,0,0
2025-01-23 09:45,113,74,39,0,0,0
2025-01-23 10:00,93,53,40,0,0,0
2025-01-23 10:15,70,45,25,0,0,0
2025-01-23 10:30,79,45,34,0,0,0
2025-01-23 10:45,90,49,41,0,0,0
2025-01-23 11:00,79,41,38,0,0,0
2025-01-23 11:15,96,45,51,0,0,0
2025-01-23 11:30,87,37,50,0,0,0
2025-01-23 11:45,107,44,63,0,0,0
2025-01-23 12:00,76,29,47,0,0,0
2025-01-23 12:15,87,49,38,0,0,0
2025-01-23 12:30,105,47,58,0,0,0
2025-01-23 12:45,113,43,70,0,0,0
2025-01-23 13:00,114,42,72,0,0,0
2025-01-23 13:15,107,41,66,0,0,0
2025-01-23 13:30,107,44,63,0,0,0
2025-01-23 13:45,127,59,68,0,0,0
2025-01-23 14:00,130,62,68,0,0,0
2025-01-23 14:15,120,47,73,0,0,0
2025-01-23 14:30,115,51,64,0,0,0
2025-01-23 14:45,156,76,80,0,0,0
2025-01-23 15:00,133,47,86,0,0,0
2025-01-23 15:15,135,55,80,0,0,0
2025-01-23 15:30,175,70,105,0,0,0
2025-01-23 15:45,161,72,89,0,0,0
2025-01-23 16:00,157,68,89,0,0,0
2025-01-23 16:15,186,74,112,0,0,0
2025-01-23 16:30,158,57,101,0,0,0
2025-01-23 16:45,187,79,108,0,0,0
2025-01-23 17:00,172,61,111,0,0,0
2025-01-23 17:15,177,61,116,0,0,0
2025-01-23 17:30,169,61,108,0,0,0
2025-01-23 17:45,186,87,99,0,0,0
2025-01-23 18:00,180,64,116,0,0,0
2025-01-23 18:15,136,41,95,0,0,0
2025-01-23 18:30,128,53,75,0,0,0
2025-01-23 18:45,130,48,82,0,0,0
2025-01-23 19:00,104,32,72,0,0,0
2025-01-23 19:15,81,31,50,0,0,0
2025-01-23 19:30,70,25,45,0,0,0
2025-01-23 19:45,95,30,65,0,0,0
2025-01-23 20:00,70,18,52,0,0,0
2025-01-23 20:15,69,25,44,0,0,0
2025-01-23 20:30,62,21,41,0,0,0
2025-01-23 20:45,73,28,45,0,0,0
2025-01-23 21:00,41,16,25,0,0,0
2025-01-23 21:15,56,18,38,0,0,0
2025-01-23 21:30,43,15,28,0,0,0
2025-01-23 21:45,53,26,27,0,0,0
2025-01-23 22:00,59,12,47,0,0,0
2025-01-23 22:15,68,15,53,0,0,0
2025-01-23 22:30,34,9,25,0,0,0
2025-01-23 22:45,54,18,36,0,0,0
2025-01-23 23:00,34,10,24,0,0,0
2025-01-23 23:15,20,10,10,0,0,0
2025-01-23 23:30,16,1,15,0,0,0
2025-01-23 23:45,11,5,6,0,0,0
2025-01-24 00:00,13,2,11,0,0,0
2025-01-24 00:15,14,4,10,0,0,0
2025-01-24 00:30,7,0,7,0,0,0
2025-01-24 00:45,3,2,1,0,0,0
2025-01-24 01:00,4,1,3,0,0,0
2025-01-24 01:15,0,0,0,0,0,0
2025-01-24 01:30,0,0,0,0,0,0
2025-01-24 01:45,3,2,1,0,0,0
2025-01-24 02:00,0,0,0,0,0,0
2025-01-24 02:15,2,0,2,0,0,0
2025-01-24 02:30,0,0,0,0,0,0
2025-01-24 02:45,0,0,0,0,0,0
2025-01-24 03:00,0,0,0,0,0,0
2025-01-24 03:15,0,0,0,0,0,0
2025-01-24 03:30,0,0,0,0,0,0
2025-01-24 03:45,1,1,0,0,0,0
2025-01-24 04:00,1,1,0,0,0,0
2025-01-24 04:15,4,3,1,0,0,0
2025-01-24 04:30,0,0,0,0,0,0
2025-01-24 04:45,4,3,1,0,0,0
2025-01-24 05:00,3,3,0,0,0,0
2025-01-24 05:15,9,3,6,0,0,0
2025-01-24 05:30,8,5,3,0,0,0
2025-01-24 05:45,22,15,7,0,0,0
2025-01-24 06:00,12,6,6,0,0,0
2025-01-24 06:15,34,23,11,0,0,0
2025-01-24 06:30,33,17,16,0,0,0
2025-01-24 06:45,56,32,24,0,0,0
2025-01-24 07:00,66,40,26,0,0,0
2025-01-24 07:15,78,49,29,0,0,0
2025-01-24 07:30,137,86,51,0,0,0
2025-01-24 07:45,147,98,49,0,0,0
2025-01-24 08:00,127,90,37,0,0,0
2025-01-24 08:15,104,74,30,0,0,0
2025-01-24 08:30,109,62,47,0,0,0
2025-01-24 08:45,129,69,60,0,0,0
2025-01-24 09:00,82,55,27,0,0,0
2025-01-24 09:15,89,53,36,0,0,0
2025-01-24 09:30,93,56,37,0,0,0
2025-01-24 09:45,107,68,39,0,0,0
2025-01-24 10:00,82,46,36,0,0,0
2025-01-24 10:15,87,53,34,0,0,0
2025-01-24 10:30,78,40,38,0,0,0
2025-01-24 10:45,98,54,44,0,0,0
2025-01-24 11:00,84,39,45,0,0,0
2025-01-24 11:15,99,37,62,0,0,0
2025-01-24 11:30,88,42,46,0,0,0
2025-01-24 11:45,118,65,53,0,0,0
2025-01-24 12:00,106,41,65,0,0,0
2025-01-24 12:15,139,59,80,0,0,0
2025-01-24 12:30,120,57,63,0,0,0
2025-01-24 12:45,144,67,77,0,0,0
2025-01-24 13:00,131,47,84,0,0,0
2025-01-24 13:15,114,45,69,0,0,0
2025-01-24 13:30,111,35,76,0,0,0
2025-01-24 13:45,113,46,67,0,0,0
2025-01-24 14:00,128,54,74,0,0,0
2025-01-24 14:15,141,52,89,0,0,0
2025-01-24 14:30,121,44,77,0,0,0
2025-01-24 14:45,130,61,69,0,0,0
2025-01-24 15:00,126,55,71,0,0,0
2025-01-24 15:15,113,47,66,0,0,0
2025-01-24 15:30,107,36,71,0,0,0
2025-01-24 15:45,129,61,68,0,0,0
2025-01-24 16:00,109,42,67,0,0,0
2025-01-24 16:15,105,53,52,0,0,0
2025-01-24 16:30,102,42,60,0,0,0
2025-01-24 16:45,107,39,68,0,0,0
2025-01-24 17:00,98,45,53,0,0,0
2025-01-24 17:15,90,36,54,0,0,0
2025-01-24 17:30,96,29,67,0,0,0
2025-01-24 17:45,100,50,50,0,0,0
2025-01-24 18:00,86,37,49,0,0,0
2025-01-24 18:15,88,36,52,0,0,0
2025-01-24 18:30,70,26,44,0,0,0
2025-01-24 18:45,96,50,46,0,0,0
2025-01-24 19:00,85,37,48,0,0,0
2025-01-24 19:15,79,39,40,0,0,0
2025-01-24 19:30,73,26,47,0,0,0
2025-01-24 19:45,60,30,30,0,0,0
2025-01-24 20:00,71,29,42,0,0,0
2025-01-24 20:15,50,25,25,0,0,0
2025-01-24 20:30,50,18,32,0,0,0
2025-01-24 20:45,45,19,26,0,0,0
2025-01-24 21:00,35,13,22,0,0,0
2025-01-24 21:15,47,15,32,0,0,0
2025-01-24 21:30,28,8,20,0,0,0
2025-01-24 21:45,42,9,33,0,0,0
2025-01-24 22:00,44,15,29,0,0,0
2025-01-24 22:15,43,10,33,0,0,0
2025-01-24 22:30,49,18,31,0,0,0
2025-01-24 22:45,40,6,34,0,0,0
2025-01-24 23:00,37,14,23,0,0,0
2025-01-24 23:15,42,10,32,0,0,0
2025-01-24 23:30,23,12,11,0,0,0
2025-01-24 23:45,46,18,28,0,0,0
2025-01-25 00:00,25,8,17,0,0,0
2025-01-25 00:15,20,3,17,0,0,0
2025-01-25 00:30,29,11,18,0,0,0
2025-01-25 00:45,19,5,14,0,0,0
2025-01-25 01:00,24,1,23,0,0,0
2025-01-25 01:15,22,13,9,0,0,0
2025-01-25 01:30,9,2,7,0,0,0
2025-01-25 01:45,14,2,12,0,0,0
2025-01-25 02:00,12,2,10,0,0,0
2025-01-25 02:15,18,2,16,0,0,0
2025-01-25 02:30,2,0,2,0,0,0
2025-01-25 02:45,7,3,4,0,0,0
2025-01-25 03:00,10,2,8,0,0,0
2025-01-25 03:15,16,0,16,0,0,0
2025-01-25 03:30,4,1,3,0,0,0
2025-01-25 03:45,1,0,1,0,0,0
2025-01-25 04:00,0,0,0,0,0,0
2025-01-25 04:15,4,2,2,0,0,0
2025-01-25 04:30,2,2,0,0,0,0
2025-01-25 04:45,3,0,3,0,0,0
2025-01-25 05:00,3,2,1,0,0,0
2025-01-25 05:15,7,1,6,0,0,0
2025-01-25 05:30,4,2,2,0,0,0
2025-01-25 05:45,6,3,3,0,0,0
2025-01-25 06:00,4,3,1,0,0,0
2025-01-25 06:15,6,2,4,0,0,0
2025-01-25 06:30,6,1,5,0,0,0
2025-01-25 06:45,10,6,4,0,0,0
2025-01-25 07:00,6,4,2,0,0,0
2025-01-25 07:15,7,4,3,0,0,0
2025-01-25 07:30,11,4,7,0,0,0
2025-01-25 07:45,27,15,12,0,0,0
2025-01-25 08:00,21,17,4,0,0,0
2025-01-25 08:15,18,9,9,0,0,0
2025-01-25 08:30,22,16,6,0,0,0
2025-01-25 08:45,52,28,24,0,0,0
2025-01-25 09:00,41,27,14,0,0,0
2025-01-25 09:15,52,38,14,0,0,0
2025-01-25 09:30,48,36,12,0,0,0
2025-01-25 09:45,96,76,20,0,0,0
2025-01-25 10:00,45,38,7,0,0,0
2025-01-25 10:15,56,35,21,0,0,0
2025-01-25 10:30,60,27,33,0,0,0
2025-01-25 10:45,98,69,29,0,0,0
2025-01-25 11:00,57,40,17,0,0,0
2025-01-25 11:15,64,32,32,0,0,0
2025-01-25 11:30,62,26,36,0,0,0
2025-01-25 11:45,60,33,27,0,0,0
2025-01-25 12:00,85,36,49,0,0,0
2025-01-25 12:15,85,43,42,0,0,0
2025-01-25 12:30,64,29,35,0,0,0
2025-01-25 12:45,89,49,40,0,0,0
2025-01-25 13:00,84,48,36,0,0,0
2025-01-25 13:15,95,39,56,0,0,0
2025-01-25 13:30,96,53,43,0,0,0
2025-01-25 13:45,97,56,41,0,0,0
2025-01-25 14:00,130,61,69,0,0,0
2025-01-25 14:15,124,69,55,0,0,0
2025-01-25 14:30,126,59,67,0,0,0
2025-01-25 14:45,133,60,73,0,0,0
2025-01-25 15:00,108,58,50,0,0,0
2025-01-25 15:15,127,66,61,0,0,0
2025-01-25 15:30,98,40,58,0,0,0
2025-01-25 15:45,115,59,56,0,0,0
2025-01-25 16:00,100,45,55,0,0,0
2025-01-25 16:15,82,32,50,0,0,0
2025-01-25 16:30,94,53,41,0,0,0
2025-01-25 16:45,98,41,57,0,0,0
2025-01-25 17:00,109,41,68,0,0,0
2025-01-25 17:15,92,35,57,0,0,0
2025-01-25 17:30,94,35,59,0,0,0
2025-01-25 17:45,92,35,57,0,0,0
2025-01-25 18:00,79,23,56,0,0,0
2025-01-25 18:15,79,31,48,0,0,0
2025-01-25 18:30,96,35,61,0,0,0
2025-01-25 18:45,71,33,38,0,0,0
2025-01-25 19:00,74,31,43,0,0,0
2025-01-25 19:15,71,34,37,0,0,0
2025-01-25 19:30,63,19,44,0,0,0
2025-01-25 19:45,60,24,36,0,0,0
2025-01-25 20:00,66,19,47,0,0,0
2025-01-25 20:15,37,15,22,0,0,0
2025-01-25 20:30,40,18,22,0,0,0
2025-01-25 20:45,46,17,29,0,0,0
2025-01-25 21:00,45,19,26,0,0,0
2025-01-25 21:15,33,11,22,0,0,0
2025-01-25 21:30,43,24,19,0,0,0
2025-01-25 21:45,34,16,18,0,0,0
2025-01-25 22:00,48,15,33,0,0,0
2025-01-25 22:15,35,10,25,0,0,0
2025-01-25 22:30,42,10,32,0,0,0
2025-01-25 22:45,36,12,24,0,0,0
2025-01-25 23:00,34,11,23,0,0,0
2025-01-25 23:15,18,8,10,0,0,0
2025-01-25 23:30,25,6,19,0,0,0
2025-01-25 23:45,30,8,22,0,0,0
