Datetime,300039328 (Coesfelder Kreuz),353425081 (Coesfelder Kreuz Stadteinwärts),353425082 (Coesfelder Kreuz Stadtauswärts),300039328-status,353425081-status,353425082-status
2024-02-01 00:00,15,6,9,0,0,0
2024-02-01 00:15,10,5,5,0,0,0
2024-02-01 00:30,6,3,3,0,0,0
2024-02-01 00:45,6,2,4,0,0,0
2024-02-01 01:00,12,3,9,0,0,0
2024-02-01 01:15,5,3,2,0,0,0
2024-02-01 01:30,4,3,1,0,0,0
2024-02-01 01:45,2,0,2,0,0,0
2024-02-01 02:00,5,2,3,0,0,0
2024-02-01 02:15,2,0,2,0,0,0
2024-02-01 02:30,5,1,4,0,0,0
2024-02-01 02:45,1,0,1,0,0,0
2024-02-01 03:00,5,1,4,0,0,0
2024-02-01 03:15,5,1,4,0,0,0
2024-02-01 03:30,1,1,0,0,0,0
2024-02-01 03:45,5,0,5,0,0,0
2024-02-01 04:00,1,0,1,0,0,0
2024-02-01 04:15,4,2,2,0,0,0
2024-02-01 04:30,1,1,0,0,0,0
2024-02-01 04:45,4,1,3,0,0,0
2024-02-01 05:00,9,5,4,0,0,0
2024-02-01 05:15,7,4,3,0,0,0
2024-02-01 05:30,16,8,8,0,0,0
2024-02-01 05:45,24,12,12,0,0,0
2024-02-01 06:00,19,11,8,0,0,0
2024-02-01 06:15,26,15,11,0,0,0
2024-02-01 06:30,37,13,24,0,0,0
2024-02-01 06:45,49,16,33,0,0,0
2024-02-01 07:00,72,43,29,0,0,0
2024-02-01 07:15,130,69,61,0,0,0
2024-02-01 07:30,235,153,82,0,0,0
2024-02-01 07:45,225,98,127,0,0,0
2024-02-01 08:00,169,67,102,0,0,0
2024-02-01 08:15,156,66,90,0,0,0
2024-02-01 08:30,156,82,74,0,0,0
2024-02-01 08:45,186,72,114,0,0,0
2024-02-01 09:00,129,44,85,0,0,0
2024-02-01 09:15,113,57,56,0,0,0
2024-02-01 09:30,130,58,72,0,0,0
2024-02-01 09:45,182,101,81,0,0,0
2024-02-01 10:00,139,70,69,0,0,0
2024-02-01 10:15,85,34,51,0,0,0
2024-02-01 10:30,76,32,44,0,0,0
2024-02-01 10:45,84,40,44,0,0,0
2024-02-01 11:00,80,32,48,0,0,0
2024-02-01 11:15,89,32,57,0,0,0
2024-02-01 11:30,117,51,66,0,0,0
2024-02-01 11:45,136,56,80,0,0,0
2024-02-01 12:00,141,59,82,0,0,0
2024-02-01 12:15,159,72,87,0,0,0
2024-02-01 12:30,149,74,75,0,0,0
2024-02-01 12:45,155,75,80,0,0,0
2024-02-01 13:00,202,90,112,0,0,0
2024-02-01 13:15,180,93,87,0,0,0
2024-02-01 13:30,195,118,77,0,0,0
2024-02-01 13:45,190,123,67,0,0,0
2024-02-01 14:00,161,94,67,0,0,0
2024-02-01 14:15,160,91,69,0,0,0
2024-02-01 14:30,118,62,56,0,0,0
2024-02-01 14:45,107,59,48,0,0,0
2024-02-01 15:00,122,58,64,0,0,0
2024-02-01 15:15,111,60,51,0,0,0
2024-02-01 15:30,115,63,52,0,0,0
2024-02-01 15:45,187,85,102,0,0,0
2024-02-01 16:00,152,74,78,0,0,0
2024-02-01 16:15,150,82,68,0,0,0
2024-02-01 16:30,142,68,74,0,0,0
2024-02-01 16:45,171,99,72,0,0,0
2024-02-01 17:00,174,96,78,0,0,0
2024-02-01 17:15,147,71,76,0,0,0
2024-02-01 17:30,150,78,72,0,0,0
2024-02-01 17:45,164,80,84,0,0,0
2024-02-01 18:00,147,82,65,0,0,0
2024-02-01 18:15,117,53,64,0,0,0
2024-02-01 18:30,111,58,53,0,0,0
2024-02-01 18:45,88,48,40,0,0,0
2024-02-01 19:00,92,58,34,0,0,0
2024-02-01 19:15,87,48,39,0,0,0
2024-02-01 19:30,84,42,42,0,0,0
2024-02-01 19:45,84,43,41,0,0,0
2024-02-01 20:00,92,46,46,0,0,0
2024-02-01 20:15,55,27,28,0,0,0
2024-02-01 20:30,50,17,33,0,0,0
2024-02-01 20:45,47,23,24,0,0,0
2024-02-01 21:00,50,27,23,0,0,0
2024-02-01 21:15,52,22,30,0,0,0
2024-02-01 21:30,37,17,20,0,0,0
2024-02-01 21:45,46,17,29,0,0,0
2024-02-01 22:00,50,15,35,0,0,0
2024-02-01 22:15,51,23,28,0,0,0
2024-02-01 22:30,31,9,22,0,0,0
2024-02-01 22:45,32,12,20,0,0,0
2024-02-01 23:00,21,12,9,0,0,0
2024-02-01 23:15,30,5,25,0,0,0
2024-02-01 23:30,19,8,11,0,0,0
2024-02-01 23:45,23,8,15,0,0,0
2024-02-02 00:00,14,5,9,0,0,0
2024-02-02 00:15,8,2,6,0,0,0
2024-02-02 00:30,5,1,4,0,0,0
2024-02-02 00:45,9,3,6,0,0,0
2024-02-02 01:00,8,1,7,0,0,0
2024-02-02 01:15,8,3,5,0,0,0
2024-02-02 01:30,10,2,8,0,0,0
2024-02-02 01:45,3,0,3,0,0,0
2024-02-02 02:00,4,0,4,0,0,0
2024-02-02 02:15,3,1,2,0,0,0
2024-02-02 02:30,5,0,5,0,0,0
2024-02-02 02:45,2,1,1,0,0,0
2024-02-02 03:00,0,0,0,0,0,0
2024-02-02 03:15,1,0,1,0,0,0
2024-02-02 03:30,2,2,0,0,0,0
2024-02-02 03:45,1,0,1,0,0,0
2024-02-02 04:00,2,2,0,0,0,0
2024-02-02 04:15,2,1,1,0,0,0
2024-02-02 04:30,7,4,3,0,0,0
2024-02-02 04:45,6,1,5,0,0,0
2024-02-02 05:00,9,3,6,0,0,0
2024-02-02 05:15,10,7,3,0,0,0
2024-02-02 05:30,15,5,10,0,0,0
2024-02-02 05:45,14,6,8,0,0,0
2024-02-02 06:00,18,9,9,0,0,0
2024-02-02 06:15,24,11,13,0,0,0
2024-02-02 06:30,37,20,17,0,0,0
2024-02-02 06:45,49,20,29,0,0,0
2024-02-02 07:00,63,30,33,0,0,0
2024-02-02 07:15,124,77,47,0,0,0
2024-02-02 07:30,201,130,71,0,0,0
2024-02-02 07:45,209,90,119,0,0,0
2024-02-02 08:00,142,50,92,0,0,0
2024-02-02 08:15,148,65,83,0,0,0
2024-02-02 08:30,117,61,56,0,0,0
2024-02-02 08:45,155,75,80,0,0,0
2024-02-02 09:00,116,47,69,0,0,0
2024-02-02 09:15,106,56,50,0,0,0
2024-02-02 09:30,98,51,47,0,0,0
2024-02-02 09:45,146,70,76,0,0,0
2024-02-02 10:00,148,63,85,0,0,0
2024-02-02 10:15,72,37,35,0,0,0
2024-02-02 10:30,73,38,35,0,0,0
2024-02-02 10:45,63,39,24,0,0,0
2024-02-02 11:00,63,34,29,0,0,0
2024-02-02 11:15,82,31,51,0,0,0
2024-02-02 11:30,128,50,78,0,0,0
2024-02-02 11:45,110,52,58,0,0,0
2024-02-02 12:00,145,74,71,0,0,0
2024-02-02 12:15,141,74,67,0,0,0
2024-02-02 12:30,147,68,79,0,0,0
2024-02-02 12:45,124,60,64,0,0,0
2024-02-02 13:00,165,83,82,0,0,0
2024-02-02 13:15,215,108,107,0,0,0
2024-02-02 13:30,170,83,87,0,0,0
2024-02-02 13:45,171,100,71,0,0,0
2024-02-02 14:00,189,101,88,0,0,0
2024-02-02 14:15,133,75,58,0,0,0
2024-02-02 14:30,110,60,50,0,0,0
2024-02-02 14:45,108,59,49,0,0,0
2024-02-02 15:00,131,73,58,0,0,0
2024-02-02 15:15,109,51,58,0,0,0
2024-02-02 15:30,118,65,53,0,0,0
2024-02-02 15:45,113,70,43,0,0,0
2024-02-02 16:00,105,57,48,0,0,0
2024-02-02 16:15,111,55,56,0,0,0
2024-02-02 16:30,122,63,59,0,0,0
2024-02-02 16:45,110,63,47,0,0,0
2024-02-02 17:00,112,61,51,0,0,0
2024-02-02 17:15,83,48,35,0,0,0
2024-02-02 17:30,89,49,40,0,0,0
2024-02-02 17:45,101,49,52,0,0,0
2024-02-02 18:00,108,62,46,0,0,0
2024-02-02 18:15,99,46,53,0,0,0
2024-02-02 18:30,106,36,70,0,0,0
2024-02-02 18:45,99,39,60,0,0,0
2024-02-02 19:00,116,52,64,0,0,0
2024-02-02 19:15,97,46,51,0,0,0
2024-02-02 19:30,88,40,48,0,0,0
2024-02-02 19:45,82,35,47,0,0,0
2024-02-02 20:00,73,29,44,0,0,0
2024-02-02 20:15,60,18,42,0,0,0
2024-02-02 20:30,55,16,39,0,0,0
2024-02-02 20:45,45,21,24,0,0,0
2024-02-02 21:00,51,21,30,0,0,0
2024-02-02 21:15,31,16,15,0,0,0
2024-02-02 21:30,45,19,26,0,0,0
2024-02-02 21:45,37,12,25,0,0,0
2024-02-02 22:00,26,16,10,0,0,0
2024-02-02 22:15,26,17,9,0,0,0
2024-02-02 22:30,25,10,15,0,0,0
2024-02-02 22:45,43,17,26,0,0,0
2024-02-02 23:00,60,35,25,0,0,0
2024-02-02 23:15,36,16,20,0,0,0
2024-02-02 23:30,39,20,19,0,0,0
2024-02-02 23:45,45,31,14,0,0,0
2024-02-03 00:00,40,21,19,0,0,0
2024-02-03 00:15,33,21,12,0,0,0
2024-02-03 00:30,31,18,13,0,0,0
2024-02-03 00:45,29,22,7,0,0,0
2024-02-03 01:00,31,18,13,0,0,0
2024-02-03 01:15,45,28,17,0,0,0
2024-02-03 01:30,43,33,10,0,0,0
2024-02-03 01:45,24,17,7,0,0,0
2024-02-03 02:00,36,23,13,0,0,0
2024-02-03 02:15,48,42,6,0,0,0
2024-02-03 02:30,19,7,12,0,0,0
2024-02-03 02:45,25,9,16,0,0,0
2024-02-03 03:00,4,1,3,0,0,0
2024-02-03 03:15,15,7,8,0,0,0
2024-02-03 03:30,3,0,3,0,0,0
2024-02-03 03:45,4,0,4,0,0,0
2024-02-03 04:00,2,0,2,0,0,0
2024-02-03 04:15,5,2,3,0,0,0
2024-02-03 04:30,2,0,2,0,0,0
2024-02-03 04:45,3,0,3,0,0,0
2024-02-03 05:00,5,4,1,0,0,0
2024-02-03 05:15,3,3,0,0,0,0
2024-02-03 05:30,11,3,8,0,0,0
2024-02-03 05:45,16,4,12,0,0,0
2024-02-03 06:00,3,0,3,0,0,0
2024-02-03 06:15,3,1,2,0,0,0
2024-02-03 06:30,14,11,3,0,0,0
2024-02-03 06:45,9,4,5,0,0,0
2024-02-03 07:00,6,4,2,0,0,0
2024-02-03 07:15,28,5,23,0,0,0
2024-02-03 07:30,45,14,31,0,0,0
2024-02-03 07:45,33,19,14,0,0,0
2024-02-03 08:00,23,17,6,0,0,0
2024-02-03 08:15,22,18,4,0,0,0
2024-02-03 08:30,27,18,9,0,0,0
2024-02-03 08:45,20,15,5,0,0,0
2024-02-03 09:00,25,16,9,0,0,0
2024-02-03 09:15,30,16,14,0,0,0
2024-02-03 09:30,26,18,8,0,0,0
2024-02-03 09:45,58,21,37,0,0,0
2024-02-03 10:00,49,28,21,0,0,0
2024-02-03 10:15,70,40,30,0,0,0
2024-02-03 10:30,76,60,16,0,0,0
2024-02-03 10:45,47,30,17,0,0,0
2024-02-03 11:00,35,16,19,0,0,0
2024-02-03 11:15,35,20,15,0,0,0
2024-02-03 11:30,35,20,15,0,0,0
2024-02-03 11:45,42,28,14,0,0,0
2024-02-03 12:00,58,28,30,0,0,0
2024-02-03 12:15,50,30,20,0,0,0
2024-02-03 12:30,57,18,39,0,0,0
2024-02-03 12:45,62,28,34,0,0,0
2024-02-03 13:00,58,30,28,0,0,0
2024-02-03 13:15,48,26,22,0,0,0
2024-02-03 13:30,46,21,25,0,0,0
2024-02-03 13:45,61,35,26,0,0,0
2024-02-03 14:00,57,26,31,0,0,0
2024-02-03 14:15,66,42,24,0,0,0
2024-02-03 14:30,49,23,26,0,0,0
2024-02-03 14:45,60,26,34,0,0,0
2024-02-03 15:00,43,18,25,0,0,0
2024-02-03 15:15,64,26,38,0,0,0
2024-02-03 15:30,57,25,32,0,0,0
2024-02-03 15:45,50,26,24,0,0,0
2024-02-03 16:00,39,23,16,0,0,0
2024-02-03 16:15,46,25,21,0,0,0
2024-02-03 16:30,37,11,26,0,0,0
2024-02-03 16:45,46,14,32,0,0,0
2024-02-03 17:00,42,18,24,0,0,0
2024-02-03 17:15,46,21,25,0,0,0
2024-02-03 17:30,43,22,21,0,0,0
2024-02-03 17:45,61,32,29,0,0,0
2024-02-03 18:00,42,24,18,0,0,0
2024-02-03 18:15,45,17,28,0,0,0
2024-02-03 18:30,35,15,20,0,0,0
2024-02-03 18:45,64,38,26,0,0,0
2024-02-03 19:00,37,19,18,0,0,0
2024-02-03 19:15,64,31,33,0,0,0
2024-02-03 19:30,52,18,34,0,0,0
2024-02-03 19:45,54,38,16,0,0,0
2024-02-03 20:00,45,22,23,0,0,0
2024-02-03 20:15,22,8,14,0,0,0
2024-02-03 20:30,30,12,18,0,0,0
2024-02-03 20:45,17,9,8,0,0,0
2024-02-03 21:00,25,17,8,0,0,0
2024-02-03 21:15,26,13,13,0,0,0
2024-02-03 21:30,18,9,9,0,0,0
2024-02-03 21:45,26,10,16,0,0,0
2024-02-03 22:00,36,18,18,0,0,0
2024-02-03 22:15,23,7,16,0,0,0
2024-02-03 22:30,27,10,17,0,0,0
2024-02-03 22:45,33,22,11,0,0,0
2024-02-03 23:00,43,20,23,0,0,0
2024-02-03 23:15,17,9,8,0,0,0
2024-02-03 23:30,17,4,13,0,0,0
2024-02-03 23:45,13,4,9,0,0,0
2024-02-04 00:00,27,15,12,0,0,0
2024-02-04 00:15,21,9,12,0,0,0
2024-02-04 00:30,16,5,11,0,0,0
2024-02-04 00:45,15,5,10,0,0,0
2024-02-04 01:00,13,4,9,0,0,0
2024-02-04 01:15,10,2,8,0,0,0
2024-02-04 01:30,13,6,7,0,0,0
2024-02-04 01:45,9,0,9,0,0,0
2024-02-04 02:00,13,4,9,0,0,0
2024-02-04 02:15,7,0,7,0,0,0
2024-02-04 02:30,9,1,8,0,0,0
2024-02-04 02:45,8,0,8,0,0,0
2024-02-04 03:00,3,0,3,0,0,0
2024-02-04 03:15,4,1,3,0,0,0
2024-02-04 03:30,7,1,6,0,0,0
2024-02-04 03:45,7,1,6,0,0,0
2024-02-04 04:00,7,3,4,0,0,0
2024-02-04 04:15,9,0,9,0,0,0
2024-02-04 04:30,3,1,2,0,0,0
2024-02-04 04:45,8,2,6,0,0,0
2024-02-04 05:00,4,3,1,0,0,0
2024-02-04 05:15,3,1,2,0,0,0
2024-02-04 05:30,9,1,8,0,0,0
2024-02-04 05:45,4,0,4,0,0,0
2024-02-04 06:00,5,3,2,0,0,0
2024-02-04 06:15,3,2,1,0,0,0
2024-02-04 06:30,11,7,4,0,0,0
2024-02-04 06:45,5,2,3,0,0,0
2024-02-04 07:00,6,2,4,0,0,0
2024-02-04 07:15,0,0,0,0,0,0
2024-02-04 07:30,9,5,4,0,0,0
2024-02-04 07:45,10,6,4,0,0,0
2024-02-04 08:00,5,4,1,0,0,0
2024-02-04 08:15,7,5,2,0,0,0
2024-02-04 08:30,7,3,4,0,0,0
2024-02-04 08:45,27,14,13,0,0,0
2024-02-04 09:00,14,9,5,0,0,0
2024-02-04 09:15,10,5,5,0,0,0
2024-02-04 09:30,15,7,8,0,0,0
2024-02-04 09:45,47,20,27,0,0,0
2024-02-04 10:00,44,17,27,0,0,0
2024-02-04 10:15,26,6,20,0,0,0
2024-02-04 10:30,18,12,6,0,0,0
2024-02-04 10:45,40,18,22,0,0,0
2024-02-04 11:00,40,16,24,0,0,0
2024-02-04 11:15,28,11,17,0,0,0
2024-02-04 11:30,31,15,16,0,0,0
2024-02-04 11:45,37,18,19,0,0,0
2024-02-04 12:00,53,26,27,0,0,0
2024-02-04 12:15,32,13,19,0,0,0
2024-02-04 12:30,58,16,42,0,0,0
2024-02-04 12:45,42,13,29,0,0,0
2024-02-04 13:00,56,22,34,0,0,0
2024-02-04 13:15,38,12,26,0,0,0
2024-02-04 13:30,59,28,31,0,0,0
2024-02-04 13:45,48,26,22,0,0,0
2024-02-04 14:00,55,39,16,0,0,0
2024-02-04 14:15,65,37,28,0,0,0
2024-02-04 14:30,40,21,19,0,0,0
2024-02-04 14:45,54,31,23,0,0,0
2024-02-04 15:00,36,20,16,0,0,0
2024-02-04 15:15,38,18,20,0,0,0
2024-02-04 15:30,40,24,16,0,0,0
2024-02-04 15:45,49,24,25,0,0,0
2024-02-04 16:00,51,29,22,0,0,0
2024-02-04 16:15,30,12,18,0,0,0
2024-02-04 16:30,30,20,10,0,0,0
2024-02-04 16:45,67,31,36,0,0,0
2024-02-04 17:00,40,21,19,0,0,0
2024-02-04 17:15,46,22,24,0,0,0
2024-02-04 17:30,48,29,19,0,0,0
2024-02-04 17:45,37,19,18,0,0,0
2024-02-04 18:00,30,16,14,0,0,0
2024-02-04 18:15,28,14,14,0,0,0
2024-02-04 18:30,32,17,15,0,0,0
2024-02-04 18:45,24,14,10,0,0,0
2024-02-04 19:00,25,16,9,0,0,0
2024-02-04 19:15,17,6,11,0,0,0
2024-02-04 19:30,25,9,16,0,0,0
2024-02-04 19:45,20,11,9,0,0,0
2024-02-04 20:00,15,8,7,0,0,0
2024-02-04 20:15,24,7,17,0,0,0
2024-02-04 20:30,15,2,13,0,0,0
2024-02-04 20:45,35,27,8,0,0,0
2024-02-04 21:00,31,20,11,0,0,0
2024-02-04 21:15,25,14,11,0,0,0
2024-02-04 21:30,17,6,11,0,0,0
2024-02-04 21:45,16,8,8,0,0,0
2024-02-04 22:00,12,6,6,0,0,0
2024-02-04 22:15,13,5,8,0,0,0
2024-02-04 22:30,4,0,4,0,0,0
2024-02-04 22:45,12,5,7,0,0,0
2024-02-04 23:00,3,0,3,0,0,0
2024-02-04 23:15,6,2,4,0,0,0
2024-02-04 23:30,9,4,5,0,0,0
2024-02-04 23:45,4,4,0,0,0,0
2024-02-05 00:00,4,2,2,0,0,0
2024-02-05 00:15,10,3,7,0,0,0
2024-02-05 00:30,2,1,1,0,0,0
2024-02-05 00:45,1,0,1,0,0,0
2024-02-05 01:00,0,0,0,0,0,0
2024-02-05 01:15,2,2,0,0,0,0
2024-02-05 01:30,2,2,0,0,0,0
2024-02-05 01:45,1,0,1,0,0,0
2024-02-05 02:00,4,0,4,0,0,0
2024-02-05 02:15,0,0,0,0,0,0
2024-02-05 02:30,1,0,1,0,0,0
2024-02-05 02:45,0,0,0,0,0,0
2024-02-05 03:00,2,1,1,0,0,0
2024-02-05 03:15,0,0,0,0,0,0
2024-02-05 03:30,4,3,1,0,0,0
2024-02-05 03:45,3,2,1,0,0,0
2024-02-05 04:00,0,0,0,0,0,0
2024-02-05 04:15,1,0,1,0,0,0
2024-02-05 04:30,3,2,1,0,0,0
2024-02-05 04:45,5,1,4,0,0,0
2024-02-05 05:00,3,3,0,0,0,0
2024-02-05 05:15,7,5,2,0,0,0
2024-02-05 05:30,18,6,12,0,0,0
2024-02-05 05:45,19,8,11,0,0,0
2024-02-05 06:00,15,10,5,0,0,0
2024-02-05 06:15,18,10,8,0,0,0
2024-02-05 06:30,46,23,23,0,0,0
2024-02-05 06:45,61,29,32,0,0,0
2024-02-05 07:00,84,40,44,0,0,0
2024-02-05 07:15,127,73,54,0,0,0
2024-02-05 07:30,197,122,75,0,0,0
2024-02-05 07:45,171,79,92,0,0,0
2024-02-05 08:00,116,46,70,0,0,0
2024-02-05 08:15,147,68,79,0,0,0
2024-02-05 08:30,155,63,92,0,0,0
2024-02-05 08:45,189,74,115,0,0,0
2024-02-05 09:00,138,57,81,0,0,0
2024-02-05 09:15,114,53,61,0,0,0
2024-02-05 09:30,135,56,79,0,0,0
2024-02-05 09:45,109,47,62,0,0,0
2024-02-05 10:00,66,29,37,0,0,0
2024-02-05 10:15,66,30,36,0,0,0
2024-02-05 10:30,50,28,22,0,0,0
2024-02-05 10:45,50,27,23,0,0,0
2024-02-05 11:00,56,28,28,0,0,0
2024-02-05 11:15,58,36,22,0,0,0
2024-02-05 11:30,67,29,38,0,0,0
2024-02-05 11:45,93,48,45,0,0,0
2024-02-05 12:00,130,64,66,0,0,0
2024-02-05 12:15,147,64,83,0,0,0
2024-02-05 12:30,121,58,63,0,0,0
2024-02-05 12:45,120,57,63,0,0,0
2024-02-05 13:00,173,89,84,0,0,0
2024-02-05 13:15,176,76,100,0,0,0
2024-02-05 13:30,178,71,107,0,0,0
2024-02-05 13:45,155,83,72,0,0,0
2024-02-05 14:00,113,64,49,0,0,0
2024-02-05 14:15,144,86,58,0,0,0
2024-02-05 14:30,123,62,61,0,0,0
2024-02-05 14:45,114,55,59,0,0,0
2024-02-05 15:00,95,42,53,0,0,0
2024-02-05 15:15,125,67,58,0,0,0
2024-02-05 15:30,113,73,40,0,0,0
2024-02-05 15:45,140,78,62,0,0,0
2024-02-05 16:00,173,110,63,0,0,0
2024-02-05 16:15,137,79,58,0,0,0
2024-02-05 16:30,126,75,51,0,0,0
2024-02-05 16:45,137,77,60,0,0,0
2024-02-05 17:00,113,58,55,0,0,0
2024-02-05 17:15,103,61,42,0,0,0
2024-02-05 17:30,135,82,53,0,0,0
2024-02-05 17:45,147,62,85,0,0,0
2024-02-05 18:00,120,69,51,0,0,0
2024-02-05 18:15,96,44,52,0,0,0
2024-02-05 18:30,99,63,36,0,0,0
2024-02-05 18:45,116,49,67,0,0,0
2024-02-05 19:00,73,43,30,0,0,0
2024-02-05 19:15,83,45,38,0,0,0
2024-02-05 19:30,45,24,21,0,0,0
2024-02-05 19:45,63,26,37,0,0,0
2024-02-05 20:00,64,28,36,0,0,0
2024-02-05 20:15,51,23,28,0,0,0
2024-02-05 20:30,47,25,22,0,0,0
2024-02-05 20:45,41,23,18,0,0,0
2024-02-05 21:00,54,27,27,0,0,0
2024-02-05 21:15,50,19,31,0,0,0
2024-02-05 21:30,30,7,23,0,0,0
2024-02-05 21:45,44,14,30,0,0,0
2024-02-05 22:00,37,13,24,0,0,0
2024-02-05 22:15,17,5,12,0,0,0
2024-02-05 22:30,21,8,13,0,0,0
2024-02-05 22:45,18,6,12,0,0,0
2024-02-05 23:00,15,7,8,0,0,0
2024-02-05 23:15,10,3,7,0,0,0
2024-02-05 23:30,14,10,4,0,0,0
2024-02-05 23:45,13,8,5,0,0,0
2024-02-06 00:00,8,6,2,0,0,0
2024-02-06 00:15,12,4,8,0,0,0
2024-02-06 00:30,5,2,3,0,0,0
2024-02-06 00:45,4,2,2,0,0,0
2024-02-06 01:00,8,2,6,0,0,0
2024-02-06 01:15,8,2,6,0,0,0
2024-02-06 01:30,7,1,6,0,0,0
2024-02-06 01:45,4,1,3,0,0,0
2024-02-06 02:00,4,1,3,0,0,0
2024-02-06 02:15,0,0,0,0,0,0
2024-02-06 02:30,1,1,0,0,0,0
2024-02-06 02:45,2,2,0,0,0,0
2024-02-06 03:00,4,2,2,0,0,0
2024-02-06 03:15,1,0,1,0,0,0
2024-02-06 03:30,11,2,9,0,0,0
2024-02-06 03:45,1,0,1,0,0,0
2024-02-06 04:00,2,0,2,0,0,0
2024-02-06 04:15,5,1,4,0,0,0
2024-02-06 04:30,3,1,2,0,0,0
2024-02-06 04:45,4,0,4,0,0,0
2024-02-06 05:00,6,3,3,0,0,0
2024-02-06 05:15,9,5,4,0,0,0
2024-02-06 05:30,18,8,10,0,0,0
2024-02-06 05:45,18,7,11,0,0,0
2024-02-06 06:00,8,3,5,0,0,0
2024-02-06 06:15,32,20,12,0,0,0
2024-02-06 06:30,38,15,23,0,0,0
2024-02-06 06:45,57,29,28,0,0,0
2024-02-06 07:00,71,33,38,0,0,0
2024-02-06 07:15,124,76,48,0,0,0
2024-02-06 07:30,208,122,86,0,0,0
2024-02-06 07:45,189,77,112,0,0,0
2024-02-06 08:00,119,53,66,0,0,0
2024-02-06 08:15,130,71,59,0,0,0
2024-02-06 08:30,125,57,68,0,0,0
2024-02-06 08:45,150,62,88,0,0,0
2024-02-06 09:00,112,38,74,0,0,0
2024-02-06 09:15,93,51,42,0,0,0
2024-02-06 09:30,99,56,43,0,0,0
2024-02-06 09:45,101,48,53,0,0,0
2024-02-06 10:00,66,24,42,0,0,0
2024-02-06 10:15,52,25,27,0,0,0
2024-02-06 10:30,46,25,21,0,0,0
2024-02-06 10:45,67,32,35,0,0,0
2024-02-06 11:00,62,32,30,0,0,0
2024-02-06 11:15,61,24,37,0,0,0
2024-02-06 11:30,57,29,28,0,0,0
2024-02-06 11:45,102,49,53,0,0,0
2024-02-06 12:00,86,38,48,0,0,0
2024-02-06 12:15,113,45,68,0,0,0
2024-02-06 12:30,109,55,54,0,0,0
2024-02-06 12:45,145,60,85,0,0,0
2024-02-06 13:00,117,39,78,0,0,0
2024-02-06 13:15,132,61,71,0,0,0
2024-02-06 13:30,107,66,41,0,0,0
2024-02-06 13:45,145,84,61,0,0,0
2024-02-06 14:00,103,61,42,0,0,0
2024-02-06 14:15,104,63,41,0,0,0
2024-02-06 14:30,75,41,34,0,0,0
2024-02-06 14:45,79,35,44,0,0,0
2024-02-06 15:00,83,45,38,0,0,0
2024-02-06 15:15,97,47,50,0,0,0
2024-02-06 15:30,121,67,54,0,0,0
2024-02-06 15:45,147,84,63,0,0,0
2024-02-06 16:00,104,61,43,0,0,0
2024-02-06 16:15,138,71,67,0,0,0
2024-02-06 16:30,130,66,64,0,0,0
2024-02-06 16:45,109,53,56,0,0,0
2024-02-06 17:00,127,62,65,0,0,0
2024-02-06 17:15,126,75,51,0,0,0
2024-02-06 17:30,104,56,48,0,0,0
2024-02-06 17:45,129,62,67,0,0,0
2024-02-06 18:00,139,58,81,0,0,0
2024-02-06 18:15,112,60,52,0,0,0
2024-02-06 18:30,83,40,43,0,0,0
2024-02-06 18:45,104,45,59,0,0,0
2024-02-06 19:00,83,45,38,0,0,0
2024-02-06 19:15,52,29,23,0,0,0
2024-02-06 19:30,63,30,33,0,0,0
2024-02-06 19:45,68,38,30,0,0,0
2024-02-06 20:00,80,34,46,0,0,0
2024-02-06 20:15,39,16,23,0,0,0
2024-02-06 20:30,40,16,24,0,0,0
2024-02-06 20:45,39,16,23,0,0,0
2024-02-06 21:00,28,18,10,0,0,0
2024-02-06 21:15,25,12,13,0,0,0
2024-02-06 21:30,30,16,14,0,0,0
2024-02-06 21:45,43,20,23,0,0,0
2024-02-06 22:00,32,14,18,0,0,0
2024-02-06 22:15,35,20,15,0,0,0
2024-02-06 22:30,19,8,11,0,0,0
2024-02-06 22:45,15,5,10,0,0,0
2024-02-06 23:00,14,5,9,0,0,0
2024-02-06 23:15,13,3,10,0,0,0
2024-02-06 23:30,18,8,10,0,0,0
2024-02-06 23:45,9,5,4,0,0,0
2024-02-07 00:00,7,3,4,0,0,0
2024-02-07 00:15,2,1,1,0,0,0
2024-02-07 00:30,4,1,3,0,0,0
2024-02-07 00:45,3,1,2,0,0,0
2024-02-07 01:00,2,1,1,0,0,0
2024-02-07 01:15,2,1,1,0,0,0
2024-02-07 01:30,0,0,0,0,0,0
2024-02-07 01:45,2,0,2,0,0,0
2024-02-07 02:00,2,0,2,0,0,0
2024-02-07 02:15,2,0,2,0,0,0
2024-02-07 02:30,1,1,0,0,0,0
2024-02-07 02:45,2,0,2,0,0,0
2024-02-07 03:00,1,0,1,0,0,0
2024-02-07 03:15,0,0,0,0,0,0
2024-02-07 03:30,1,0,1,0,0,0
2024-02-07 03:45,1,0,1,0,0,0
2024-02-07 04:00,0,0,0,0,0,0
2024-02-07 04:15,1,1,0,0,0,0
2024-02-07 04:30,4,0,4,0,0,0
2024-02-07 04:45,5,2,3,0,0,0
2024-02-07 05:00,4,1,3,0,0,0
2024-02-07 05:15,6,4,2,0,0,0
2024-02-07 05:30,16,3,13,0,0,0
2024-02-07 05:45,19,5,14,0,0,0
2024-02-07 06:00,13,7,6,0,0,0
2024-02-07 06:15,24,15,9,0,0,0
2024-02-07 06:30,31,16,15,0,0,0
2024-02-07 06:45,47,22,25,0,0,0
2024-02-07 07:00,64,32,32,0,0,0
2024-02-07 07:15,109,62,47,0,0,0
2024-02-07 07:30,229,136,93,0,0,0
2024-02-07 07:45,182,79,103,0,0,0
2024-02-07 08:00,132,60,72,0,0,0
2024-02-07 08:15,124,50,74,0,0,0
2024-02-07 08:30,129,63,66,0,0,0
2024-02-07 08:45,131,56,75,0,0,0
2024-02-07 09:00,123,47,76,0,0,0
2024-02-07 09:15,102,48,54,0,0,0
2024-02-07 09:30,98,54,44,0,0,0
2024-02-07 09:45,106,45,61,0,0,0
2024-02-07 10:00,99,44,55,0,0,0
2024-02-07 10:15,81,40,41,0,0,0
2024-02-07 10:30,78,38,40,0,0,0
2024-02-07 10:45,70,38,32,0,0,0
2024-02-07 11:00,74,32,42,0,0,0
2024-02-07 11:15,63,26,37,0,0,0
2024-02-07 11:30,73,39,34,0,0,0
2024-02-07 11:45,83,50,33,0,0,0
2024-02-07 12:00,102,46,56,0,0,0
2024-02-07 12:15,138,57,81,0,0,0
2024-02-07 12:30,121,42,79,0,0,0
2024-02-07 12:45,105,46,59,0,0,0
2024-02-07 13:00,135,68,67,0,0,0
2024-02-07 13:15,158,67,91,0,0,0
2024-02-07 13:30,119,67,52,0,0,0
2024-02-07 13:45,114,66,48,0,0,0
2024-02-07 14:00,110,57,53,0,0,0
2024-02-07 14:15,106,59,47,0,0,0
2024-02-07 14:30,125,64,61,0,0,0
2024-02-07 14:45,131,72,59,0,0,0
2024-02-07 15:00,106,59,47,0,0,0
2024-02-07 15:15,99,57,42,0,0,0
2024-02-07 15:30,140,69,71,0,0,0
2024-02-07 15:45,129,66,63,0,0,0
2024-02-07 16:00,112,66,46,0,0,0
2024-02-07 16:15,131,76,55,0,0,0
2024-02-07 16:30,101,56,45,0,0,0
2024-02-07 16:45,116,69,47,0,0,0
2024-02-07 17:00,133,80,53,0,0,0
2024-02-07 17:15,122,68,54,0,0,0
2024-02-07 17:30,113,55,58,0,0,0
2024-02-07 17:45,161,91,70,0,0,0
2024-02-07 18:00,132,83,49,0,0,0
2024-02-07 18:15,112,59,53,0,0,0
2024-02-07 18:30,113,57,56,0,0,0
2024-02-07 18:45,72,39,33,0,0,0
2024-02-07 19:00,88,36,52,0,0,0
2024-02-07 19:15,77,28,49,0,0,0
2024-02-07 19:30,69,35,34,0,0,0
2024-02-07 19:45,90,42,48,0,0,0
2024-02-07 20:00,66,36,30,0,0,0
2024-02-07 20:15,45,20,25,0,0,0
2024-02-07 20:30,44,19,25,0,0,0
2024-02-07 20:45,40,19,21,0,0,0
2024-02-07 21:00,32,14,18,0,0,0
2024-02-07 21:15,31,11,20,0,0,0
2024-02-07 21:30,43,14,29,0,0,0
2024-02-07 21:45,41,17,24,0,0,0
2024-02-07 22:00,48,19,29,0,0,0
2024-02-07 22:15,34,15,19,0,0,0
2024-02-07 22:30,34,14,20,0,0,0
2024-02-07 22:45,29,9,20,0,0,0
2024-02-07 23:00,14,7,7,0,0,0
2024-02-07 23:15,23,8,15,0,0,0
2024-02-07 23:30,20,9,11,0,0,0
2024-02-07 23:45,15,8,7,0,0,0
2024-02-08 00:00,7,2,5,0,0,0
2024-02-08 00:15,19,7,12,0,0,0
2024-02-08 00:30,5,3,2,0,0,0
2024-02-08 00:45,5,1,4,0,0,0
2024-02-08 01:00,3,1,2,0,0,0
2024-02-08 01:15,7,2,5,0,0,0
2024-02-08 01:30,6,2,4,0,0,0
2024-02-08 01:45,9,1,8,0,0,0
2024-02-08 02:00,4,0,4,0,0,0
2024-02-08 02:15,2,0,2,0,0,0
2024-02-08 02:30,10,4,6,0,0,0
2024-02-08 02:45,0,0,0,0,0,0
2024-02-08 03:00,3,0,3,0,0,0
2024-02-08 03:15,0,0,0,0,0,0
2024-02-08 03:30,4,1,3,0,0,0
2024-02-08 03:45,3,1,2,0,0,0
2024-02-08 04:00,5,3,2,0,0,0
2024-02-08 04:15,4,0,4,0,0,0
2024-02-08 04:30,7,5,2,0,0,0
2024-02-08 04:45,6,2,4,0,0,0
2024-02-08 05:00,7,3,4,0,0,0
2024-02-08 05:15,9,6,3,0,0,0
2024-02-08 05:30,17,3,14,0,0,0
2024-02-08 05:45,17,4,13,0,0,0
2024-02-08 06:00,18,14,4,0,0,0
2024-02-08 06:15,24,12,12,0,0,0
2024-02-08 06:30,27,17,10,0,0,0
2024-02-08 06:45,52,22,30,0,0,0
2024-02-08 07:00,65,28,37,0,0,0
2024-02-08 07:15,137,75,62,0,0,0
2024-02-08 07:30,221,128,93,0,0,0
2024-02-08 07:45,174,71,103,0,0,0
2024-02-08 08:00,126,47,79,0,0,0
2024-02-08 08:15,120,54,66,0,0,0
2024-02-08 08:30,101,51,50,0,0,0
2024-02-08 08:45,133,56,77,0,0,0
2024-02-08 09:00,123,47,76,0,0,0
2024-02-08 09:15,84,41,43,0,0,0
2024-02-08 09:30,132,54,78,0,0,0
2024-02-08 09:45,122,54,68,0,0,0
2024-02-08 10:00,70,34,36,0,0,0
2024-02-08 10:15,55,21,34,0,0,0
2024-02-08 10:30,59,26,33,0,0,0
2024-02-08 10:45,70,40,30,0,0,0
2024-02-08 11:00,41,16,25,0,0,0
2024-02-08 11:15,55,26,29,0,0,0
2024-02-08 11:30,81,48,33,0,0,0
2024-02-08 11:45,109,54,55,0,0,0
2024-02-08 12:00,110,65,45,0,0,0
2024-02-08 12:15,94,44,50,0,0,0
2024-02-08 12:30,104,41,63,0,0,0
2024-02-08 12:45,111,44,67,0,0,0
2024-02-08 13:00,113,45,68,0,0,0
2024-02-08 13:15,109,46,63,0,0,0
2024-02-08 13:30,125,80,45,0,0,0
2024-02-08 13:45,94,50,44,0,0,0
2024-02-08 14:00,96,50,46,0,0,0
2024-02-08 14:15,105,66,39,0,0,0
2024-02-08 14:30,80,45,35,0,0,0
2024-02-08 14:45,72,37,35,0,0,0
2024-02-08 15:00,106,56,50,0,0,0
2024-02-08 15:15,87,49,38,0,0,0
2024-02-08 15:30,98,46,52,0,0,0
2024-02-08 15:45,124,75,49,0,0,0
2024-02-08 16:00,94,58,36,0,0,0
2024-02-08 16:15,118,62,56,0,0,0
2024-02-08 16:30,84,47,37,0,0,0
2024-02-08 16:45,103,61,42,0,0,0
2024-02-08 17:00,99,54,45,0,0,0
2024-02-08 17:15,89,54,35,0,0,0
2024-02-08 17:30,91,54,37,0,0,0
2024-02-08 17:45,94,48,46,0,0,0
2024-02-08 18:00,79,45,34,0,0,0
2024-02-08 18:15,75,30,45,0,0,0
2024-02-08 18:30,65,37,28,0,0,0
2024-02-08 18:45,67,36,31,0,0,0
2024-02-08 19:00,61,36,25,0,0,0
2024-02-08 19:15,43,25,18,0,0,0
2024-02-08 19:30,61,23,38,0,0,0
2024-02-08 19:45,45,18,27,0,0,0
2024-02-08 20:00,68,39,29,0,0,0
2024-02-08 20:15,39,13,26,0,0,0
2024-02-08 20:30,24,11,13,0,0,0
2024-02-08 20:45,37,20,17,0,0,0
2024-02-08 21:00,40,24,16,0,0,0
2024-02-08 21:15,22,10,12,0,0,0
2024-02-08 21:30,21,16,5,0,0,0
2024-02-08 21:45,26,11,15,0,0,0
2024-02-08 22:00,36,10,26,0,0,0
2024-02-08 22:15,20,8,12,0,0,0
2024-02-08 22:30,25,13,12,0,0,0
2024-02-08 22:45,19,7,12,0,0,0
2024-02-08 23:00,9,7,2,0,0,0
2024-02-08 23:15,19,8,11,0,0,0
2024-02-08 23:30,14,4,10,0,0,0
2024-02-08 23:45,17,3,14,0,0,0
2024-02-09 00:00,15,6,9,0,0,0
2024-02-09 00:15,16,5,11,0,0,0
2024-02-09 00:30,7,0,7,0,0,0
2024-02-09 00:45,6,2,4,0,0,0
2024-02-09 01:00,2,1,1,0,0,0
2024-02-09 01:15,7,0,7,0,0,0
2024-02-09 01:30,10,1,9,0,0,0
2024-02-09 01:45,3,1,2,0,0,0
2024-02-09 02:00,6,0,6,0,0,0
2024-02-09 02:15,7,2,5,0,0,0
2024-02-09 02:30,1,1,0,0,0,0
2024-02-09 02:45,3,0,3,0,0,0
2024-02-09 03:00,0,0,0,0,0,0
2024-02-09 03:15,3,0,3,0,0,0
2024-02-09 03:30,0,0,0,0,0,0
2024-02-09 03:45,2,0,2,0,0,0
2024-02-09 04:00,1,1,0,0,0,0
2024-02-09 04:15,3,0,3,0,0,0
2024-02-09 04:30,5,3,2,0,0,0
2024-02-09 04:45,3,0,3,0,0,0
2024-02-09 05:00,6,4,2,0,0,0
2024-02-09 05:15,4,2,2,0,0,0
2024-02-09 05:30,17,5,12,0,0,0
2024-02-09 05:45,10,2,8,0,0,0
2024-02-09 06:00,17,8,9,0,0,0
2024-02-09 06:15,12,8,4,0,0,0
2024-02-09 06:30,25,10,15,0,0,0
2024-02-09 06:45,51,26,25,0,0,0
2024-02-09 07:00,59,27,32,0,0,0
2024-02-09 07:15,80,41,39,0,0,0
2024-02-09 07:30,147,89,58,0,0,0
2024-02-09 07:45,132,53,79,0,0,0
2024-02-09 08:00,83,32,51,0,0,0
2024-02-09 08:15,94,43,51,0,0,0
2024-02-09 08:30,95,49,46,0,0,0
2024-02-09 08:45,95,40,55,0,0,0
2024-02-09 09:00,89,30,59,0,0,0
2024-02-09 09:15,59,19,40,0,0,0
2024-02-09 09:30,84,38,46,0,0,0
2024-02-09 09:45,87,40,47,0,0,0
2024-02-09 10:00,50,19,31,0,0,0
2024-02-09 10:15,40,20,20,0,0,0
2024-02-09 10:30,43,19,24,0,0,0
2024-02-09 10:45,44,21,23,0,0,0
2024-02-09 11:00,35,14,21,0,0,0
2024-02-09 11:15,61,27,34,0,0,0
2024-02-09 11:30,55,28,27,0,0,0
2024-02-09 11:45,77,39,38,0,0,0
2024-02-09 12:00,86,46,40,0,0,0
2024-02-09 12:15,104,53,51,0,0,0
2024-02-09 12:30,83,41,42,0,0,0
2024-02-09 12:45,83,41,42,0,0,0
2024-02-09 13:00,111,60,51,0,0,0
2024-02-09 13:15,133,57,76,0,0,0
2024-02-09 13:30,101,45,56,0,0,0
2024-02-09 13:45,118,51,67,0,0,0
2024-02-09 14:00,90,51,39,0,0,0
2024-02-09 14:15,109,62,47,0,0,0
2024-02-09 14:30,75,40,35,0,0,0
2024-02-09 14:45,90,46,44,0,0,0
2024-02-09 15:00,98,62,36,0,0,0
2024-02-09 15:15,85,45,40,0,0,0
2024-02-09 15:30,93,53,40,0,0,0
2024-02-09 15:45,75,45,30,0,0,0
2024-02-09 16:00,92,53,39,0,0,0
2024-02-09 16:15,78,49,29,0,0,0
2024-02-09 16:30,76,42,34,0,0,0
2024-02-09 16:45,100,59,41,0,0,0
2024-02-09 17:00,79,48,31,0,0,0
2024-02-09 17:15,95,53,42,0,0,0
2024-02-09 17:30,54,25,29,0,0,0
2024-02-09 17:45,87,48,39,0,0,0
2024-02-09 18:00,62,33,29,0,0,0
2024-02-09 18:15,88,38,50,0,0,0
2024-02-09 18:30,74,38,36,0,0,0
2024-02-09 18:45,88,42,46,0,0,0
2024-02-09 19:00,49,22,27,0,0,0
2024-02-09 19:15,62,29,33,0,0,0
2024-02-09 19:30,47,23,24,0,0,0
2024-02-09 19:45,54,28,26,0,0,0
2024-02-09 20:00,45,20,25,0,0,0
2024-02-09 20:15,36,17,19,0,0,0
2024-02-09 20:30,40,10,30,0,0,0
2024-02-09 20:45,41,17,24,0,0,0
2024-02-09 21:00,40,25,15,0,0,0
2024-02-09 21:15,47,15,32,0,0,0
2024-02-09 21:30,38,18,20,0,0,0
2024-02-09 21:45,27,9,18,0,0,0
2024-02-09 22:00,18,9,9,0,0,0
2024-02-09 22:15,24,12,12,0,0,0
2024-02-09 22:30,37,10,27,0,0,0
2024-02-09 22:45,15,7,8,0,0,0
2024-02-09 23:00,21,5,16,0,0,0
2024-02-09 23:15,15,8,7,0,0,0
2024-02-09 23:30,13,7,6,0,0,0
2024-02-09 23:45,21,10,11,0,0,0
2024-02-10 00:00,26,9,17,0,0,0
2024-02-10 00:15,13,6,7,0,0,0
2024-02-10 00:30,6,1,5,0,0,0
2024-02-10 00:45,13,2,11,0,0,0
2024-02-10 01:00,31,11,20,0,0,0
2024-02-10 01:15,11,5,6,0,0,0
2024-02-10 01:30,5,1,4,0,0,0
2024-02-10 01:45,15,4,11,0,0,0
2024-02-10 02:00,3,2,1,0,0,0
2024-02-10 02:15,11,5,6,0,0,0
2024-02-10 02:30,7,2,5,0,0,0
2024-02-10 02:45,2,0,2,0,0,0
2024-02-10 03:00,10,1,9,0,0,0
2024-02-10 03:15,6,1,5,0,0,0
2024-02-10 03:30,7,5,2,0,0,0
2024-02-10 03:45,0,0,0,0,0,0
2024-02-10 04:00,0,0,0,0,0,0
2024-02-10 04:15,3,0,3,0,0,0
2024-02-10 04:30,11,5,6,0,0,0
2024-02-10 04:45,4,2,2,0,0,0
2024-02-10 05:00,3,0,3,0,0,0
2024-02-10 05:15,9,3,6,0,0,0
2024-02-10 05:30,9,4,5,0,0,0
2024-02-10 05:45,11,4,7,0,0,0
2024-02-10 06:00,6,3,3,0,0,0
2024-02-10 06:15,4,1,3,0,0,0
2024-02-10 06:30,10,9,1,0,0,0
2024-02-10 06:45,12,5,7,0,0,0
2024-02-10 07:00,9,7,2,0,0,0
2024-02-10 07:15,4,4,0,0,0,0
2024-02-10 07:30,16,11,5,0,0,0
2024-02-10 07:45,28,24,4,0,0,0
2024-02-10 08:00,18,16,2,0,0,0
2024-02-10 08:15,16,12,4,0,0,0
2024-02-10 08:30,24,12,12,0,0,0
2024-02-10 08:45,22,18,4,0,0,0
2024-02-10 09:00,31,21,10,0,0,0
2024-02-10 09:15,24,16,8,0,0,0
2024-02-10 09:30,41,34,7,0,0,0
2024-02-10 09:45,57,33,24,0,0,0
2024-02-10 10:00,41,20,21,0,0,0
2024-02-10 10:15,38,23,15,0,0,0
2024-02-10 10:30,48,26,22,0,0,0
2024-02-10 10:45,69,47,22,0,0,0
2024-02-10 11:00,54,32,22,0,0,0
2024-02-10 11:15,66,36,30,0,0,0
2024-02-10 11:30,66,39,27,0,0,0
2024-02-10 11:45,56,29,27,0,0,0
2024-02-10 12:00,57,33,24,0,0,0
2024-02-10 12:15,50,28,22,0,0,0
2024-02-10 12:30,57,27,30,0,0,0
2024-02-10 12:45,79,36,43,0,0,0
2024-02-10 13:00,63,26,37,0,0,0
2024-02-10 13:15,60,22,38,0,0,0
2024-02-10 13:30,81,39,42,0,0,0
2024-02-10 13:45,63,22,41,0,0,0
2024-02-10 14:00,93,32,61,0,0,0
2024-02-10 14:15,73,41,32,0,0,0
2024-02-10 14:30,63,34,29,0,0,0
2024-02-10 14:45,62,36,26,0,0,0
2024-02-10 15:00,66,31,35,0,0,0
2024-02-10 15:15,53,24,29,0,0,0
2024-02-10 15:30,65,30,35,0,0,0
2024-02-10 15:45,68,38,30,0,0,0
2024-02-10 16:00,55,31,24,0,0,0
2024-02-10 16:15,60,23,37,0,0,0
2024-02-10 16:30,54,24,30,0,0,0
2024-02-10 16:45,52,20,32,0,0,0
2024-02-10 17:00,59,25,34,0,0,0
2024-02-10 17:15,42,21,21,0,0,0
2024-02-10 17:30,34,16,18,0,0,0
2024-02-10 17:45,56,24,32,0,0,0
2024-02-10 18:00,36,15,21,0,0,0
2024-02-10 18:15,61,29,32,0,0,0
2024-02-10 18:30,37,21,16,0,0,0
2024-02-10 18:45,44,24,20,0,0,0
2024-02-10 19:00,41,20,21,0,0,0
2024-02-10 19:15,38,21,17,0,0,0
2024-02-10 19:30,25,13,12,0,0,0
2024-02-10 19:45,39,14,25,0,0,0
2024-02-10 20:00,29,11,18,0,0,0
2024-02-10 20:15,21,12,9,0,0,0
2024-02-10 20:30,29,14,15,0,0,0
2024-02-10 20:45,24,10,14,0,0,0
2024-02-10 21:00,28,12,16,0,0,0
2024-02-10 21:15,35,18,17,0,0,0
2024-02-10 21:30,23,8,15,0,0,0
2024-02-10 21:45,13,6,7,0,0,0
2024-02-10 22:00,17,13,4,0,0,0
2024-02-10 22:15,23,5,18,0,0,0
2024-02-10 22:30,17,5,12,0,0,0
2024-02-10 22:45,24,5,19,0,0,0
2024-02-10 23:00,25,8,17,0,0,0
2024-02-10 23:15,19,9,10,0,0,0
2024-02-10 23:30,11,5,6,0,0,0
2024-02-10 23:45,23,12,11,0,0,0
2024-02-11 00:00,10,3,7,0,0,0
2024-02-11 00:15,12,2,10,0,0,0
2024-02-11 00:30,15,6,9,0,0,0
2024-02-11 00:45,12,5,7,0,0,0
2024-02-11 01:00,9,1,8,0,0,0
2024-02-11 01:15,21,7,14,0,0,0
2024-02-11 01:30,8,3,5,0,0,0
2024-02-11 01:45,12,4,8,0,0,0
2024-02-11 02:00,9,2,7,0,0,0
2024-02-11 02:15,9,2,7,0,0,0
2024-02-11 02:30,12,5,7,0,0,0
2024-02-11 02:45,7,1,6,0,0,0
2024-02-11 03:00,9,0,9,0,0,0
2024-02-11 03:15,8,5,3,0,0,0
2024-02-11 03:30,3,2,1,0,0,0
2024-02-11 03:45,5,0,5,0,0,0
2024-02-11 04:00,1,0,1,0,0,0
2024-02-11 04:15,7,1,6,0,0,0
2024-02-11 04:30,3,2,1,0,0,0
2024-02-11 04:45,5,1,4,0,0,0
2024-02-11 05:00,3,0,3,0,0,0
2024-02-11 05:15,7,3,4,0,0,0
2024-02-11 05:30,7,2,5,0,0,0
2024-02-11 05:45,13,4,9,0,0,0
2024-02-11 06:00,4,2,2,0,0,0
2024-02-11 06:15,1,1,0,0,0,0
2024-02-11 06:30,11,8,3,0,0,0
2024-02-11 06:45,2,2,0,0,0,0
2024-02-11 07:00,4,2,2,0,0,0
2024-02-11 07:15,3,0,3,0,0,0
2024-02-11 07:30,6,4,2,0,0,0
2024-02-11 07:45,11,8,3,0,0,0
2024-02-11 08:00,8,4,4,0,0,0
2024-02-11 08:15,3,1,2,0,0,0
2024-02-11 08:30,11,7,4,0,0,0
2024-02-11 08:45,6,5,1,0,0,0
2024-02-11 09:00,8,6,2,0,0,0
2024-02-11 09:15,7,6,1,0,0,0
2024-02-11 09:30,14,10,4,0,0,0
2024-02-11 09:45,31,17,14,0,0,0
2024-02-11 10:00,21,8,13,0,0,0
2024-02-11 10:15,23,12,11,0,0,0
2024-02-11 10:30,19,7,12,0,0,0
2024-02-11 10:45,29,16,13,0,0,0
2024-02-11 11:00,25,16,9,0,0,0
2024-02-11 11:15,15,8,7,0,0,0
2024-02-11 11:30,25,16,9,0,0,0
2024-02-11 11:45,28,14,14,0,0,0
2024-02-11 12:00,21,8,13,0,0,0
2024-02-11 12:15,42,21,21,0,0,0
2024-02-11 12:30,37,11,26,0,0,0
2024-02-11 12:45,23,9,14,0,0,0
2024-02-11 13:00,33,17,16,0,0,0
2024-02-11 13:15,32,16,16,0,0,0
2024-02-11 13:30,25,13,12,0,0,0
2024-02-11 13:45,34,19,15,0,0,0
2024-02-11 14:00,31,14,17,0,0,0
2024-02-11 14:15,44,23,21,0,0,0
2024-02-11 14:30,25,16,9,0,0,0
2024-02-11 14:45,46,27,19,0,0,0
2024-02-11 15:00,36,12,24,0,0,0
2024-02-11 15:15,38,15,23,0,0,0
2024-02-11 15:30,25,11,14,0,0,0
2024-02-11 15:45,39,20,19,0,0,0
2024-02-11 16:00,24,15,9,0,0,0
2024-02-11 16:15,24,10,14,0,0,0
2024-02-11 16:30,35,21,14,0,0,0
2024-02-11 16:45,42,19,23,0,0,0
2024-02-11 17:00,37,15,22,0,0,0
2024-02-11 17:15,38,21,17,0,0,0
2024-02-11 17:30,44,25,19,0,0,0
2024-02-11 17:45,35,12,23,0,0,0
2024-02-11 18:00,35,20,15,0,0,0
2024-02-11 18:15,20,8,12,0,0,0
2024-02-11 18:30,21,11,10,0,0,0
2024-02-11 18:45,34,20,14,0,0,0
2024-02-11 19:00,25,10,15,0,0,0
2024-02-11 19:15,36,15,21,0,0,0
2024-02-11 19:30,21,11,10,0,0,0
2024-02-11 19:45,29,10,19,0,0,0
2024-02-11 20:00,22,7,15,0,0,0
2024-02-11 20:15,16,7,9,0,0,0
2024-02-11 20:30,12,7,5,0,0,0
2024-02-11 20:45,38,14,24,0,0,0
2024-02-11 21:00,26,13,13,0,0,0
2024-02-11 21:15,15,9,6,0,0,0
2024-02-11 21:30,19,12,7,0,0,0
2024-02-11 21:45,12,4,8,0,0,0
2024-02-11 22:00,13,3,10,0,0,0
2024-02-11 22:15,9,6,3,0,0,0
2024-02-11 22:30,17,4,13,0,0,0
2024-02-11 22:45,9,5,4,0,0,0
2024-02-11 23:00,13,4,9,0,0,0
2024-02-11 23:15,11,4,7,0,0,0
2024-02-11 23:30,7,7,0,0,0,0
2024-02-11 23:45,4,2,2,0,0,0
2024-02-12 00:00,12,8,4,0,0,0
2024-02-12 00:15,6,1,5,0,0,0
2024-02-12 00:30,6,1,5,0,0,0
2024-02-12 00:45,1,0,1,0,0,0
2024-02-12 01:00,3,1,2,0,0,0
2024-02-12 01:15,4,3,1,0,0,0
2024-02-12 01:30,0,0,0,0,0,0
2024-02-12 01:45,1,0,1,0,0,0
2024-02-12 02:00,3,1,2,0,0,0
2024-02-12 02:15,7,5,2,0,0,0
2024-02-12 02:30,1,1,0,0,0,0
2024-02-12 02:45,6,4,2,0,0,0
2024-02-12 03:00,3,1,2,0,0,0
2024-02-12 03:15,2,0,2,0,0,0
2024-02-12 03:30,0,0,0,0,0,0
2024-02-12 03:45,3,0,3,0,0,0
2024-02-12 04:00,0,0,0,0,0,0
2024-02-12 04:15,1,0,1,0,0,0
2024-02-12 04:30,4,2,2,0,0,0
2024-02-12 04:45,4,1,3,0,0,0
2024-02-12 05:00,13,9,4,0,0,0
2024-02-12 05:15,8,6,2,0,0,0
2024-02-12 05:30,16,6,10,0,0,0
2024-02-12 05:45,13,3,10,0,0,0
2024-02-12 06:00,12,8,4,0,0,0
2024-02-12 06:15,14,9,5,0,0,0
2024-02-12 06:30,20,16,4,0,0,0
2024-02-12 06:45,19,12,7,0,0,0
2024-02-12 07:00,23,14,9,0,0,0
2024-02-12 07:15,35,25,10,0,0,0
2024-02-12 07:30,38,20,18,0,0,0
2024-02-12 07:45,43,21,22,0,0,0
2024-02-12 08:00,30,9,21,0,0,0
2024-02-12 08:15,41,20,21,0,0,0
2024-02-12 08:30,34,20,14,0,0,0
2024-02-12 08:45,45,24,21,0,0,0
2024-02-12 09:00,41,12,29,0,0,0
2024-02-12 09:15,19,9,10,0,0,0
2024-02-12 09:30,35,24,11,0,0,0
2024-02-12 09:45,39,23,16,0,0,0
2024-02-12 10:00,32,14,18,0,0,0
2024-02-12 10:15,27,18,9,0,0,0
2024-02-12 10:30,37,24,13,0,0,0
2024-02-12 10:45,34,23,11,0,0,0
2024-02-12 11:00,35,16,19,0,0,0
2024-02-12 11:15,51,38,13,0,0,0
2024-02-12 11:30,50,28,22,0,0,0
2024-02-12 11:45,63,40,23,0,0,0
2024-02-12 12:00,89,70,19,0,0,0
2024-02-12 12:15,75,52,23,0,0,0
2024-02-12 12:30,88,65,23,0,0,0
2024-02-12 12:45,79,53,26,0,0,0
2024-02-12 13:00,76,58,18,0,0,0
2024-02-12 13:15,87,58,29,0,0,0
2024-02-12 13:30,63,36,27,0,0,0
2024-02-12 13:45,77,43,34,0,0,0
2024-02-12 14:00,66,42,24,0,0,0
2024-02-12 14:15,114,53,61,0,0,0
2024-02-12 14:30,114,42,72,0,0,0
2024-02-12 14:45,97,38,59,0,0,0
2024-02-12 15:00,57,25,32,0,0,0
2024-02-12 15:15,90,30,60,0,0,0
2024-02-12 15:30,58,24,34,0,0,0
2024-02-12 15:45,73,31,42,0,0,0
2024-02-12 16:00,68,26,42,0,0,0
2024-02-12 16:15,63,17,46,0,0,0
2024-02-12 16:30,50,17,33,0,0,0
2024-02-12 16:45,77,27,50,0,0,0
2024-02-12 17:00,68,23,45,0,0,0
2024-02-12 17:15,47,17,30,0,0,0
2024-02-12 17:30,53,19,34,0,0,0
2024-02-12 17:45,49,19,30,0,0,0
2024-02-12 18:00,45,19,26,0,0,0
2024-02-12 18:15,33,10,23,0,0,0
2024-02-12 18:30,39,14,25,0,0,0
2024-02-12 18:45,49,15,34,0,0,0
2024-02-12 19:00,41,13,28,0,0,0
2024-02-12 19:15,43,16,27,0,0,0
2024-02-12 19:30,32,7,25,0,0,0
2024-02-12 19:45,34,13,21,0,0,0
2024-02-12 20:00,22,6,16,0,0,0
2024-02-12 20:15,34,15,19,0,0,0
2024-02-12 20:30,26,9,17,0,0,0
2024-02-12 20:45,21,10,11,0,0,0
2024-02-12 21:00,18,10,8,0,0,0
2024-02-12 21:15,21,7,14,0,0,0
2024-02-12 21:30,11,1,10,0,0,0
2024-02-12 21:45,28,6,22,0,0,0
2024-02-12 22:00,18,8,10,0,0,0
2024-02-12 22:15,23,7,16,0,0,0
2024-02-12 22:30,10,2,8,0,0,0
2024-02-12 22:45,14,5,9,0,0,0
2024-02-12 23:00,20,7,13,0,0,0
2024-02-12 23:15,7,1,6,0,0,0
2024-02-12 23:30,12,3,9,0,0,0
2024-02-12 23:45,8,0,8,0,0,0
2024-02-13 00:00,11,3,8,0,0,0
2024-02-13 00:15,10,3,7,0,0,0
2024-02-13 00:30,3,1,2,0,0,0
2024-02-13 00:45,7,2,5,0,0,0
2024-02-13 01:00,6,2,4,0,0,0
2024-02-13 01:15,5,4,1,0,0,0
2024-02-13 01:30,2,1,1,0,0,0
2024-02-13 01:45,0,0,0,0,0,0
2024-02-13 02:00,6,1,5,0,0,0
2024-02-13 02:15,3,1,2,0,0,0
2024-02-13 02:30,5,3,2,0,0,0
2024-02-13 02:45,3,1,2,0,0,0
2024-02-13 03:00,1,0,1,0,0,0
2024-02-13 03:15,3,1,2,0,0,0
2024-02-13 03:30,1,1,0,0,0,0
2024-02-13 03:45,3,0,3,0,0,0
2024-02-13 04:00,0,0,0,0,0,0
2024-02-13 04:15,1,1,0,0,0,0
2024-02-13 04:30,4,3,1,0,0,0
2024-02-13 04:45,5,1,4,0,0,0
2024-02-13 05:00,4,3,1,0,0,0
2024-02-13 05:15,9,6,3,0,0,0
2024-02-13 05:30,11,3,8,0,0,0
2024-02-13 05:45,19,6,13,0,0,0
2024-02-13 06:00,21,10,11,0,0,0
2024-02-13 06:15,23,12,11,0,0,0
2024-02-13 06:30,39,19,20,0,0,0
2024-02-13 06:45,58,30,28,0,0,0
2024-02-13 07:00,58,31,27,0,0,0
2024-02-13 07:15,79,40,39,0,0,0
2024-02-13 07:30,121,48,73,0,0,0
2024-02-13 07:45,157,64,93,0,0,0
2024-02-13 08:00,112,44,68,0,0,0
2024-02-13 08:15,133,60,73,0,0,0
2024-02-13 08:30,125,60,65,0,0,0
2024-02-13 08:45,137,49,88,0,0,0
2024-02-13 09:00,104,34,70,0,0,0
2024-02-13 09:15,115,33,82,0,0,0
2024-02-13 09:30,129,43,86,0,0,0
2024-02-13 09:45,94,47,47,0,0,0
2024-02-13 10:00,50,22,28,0,0,0
2024-02-13 10:15,46,27,19,0,0,0
2024-02-13 10:30,51,32,19,0,0,0
2024-02-13 10:45,55,29,26,0,0,0
2024-02-13 11:00,64,35,29,0,0,0
2024-02-13 11:15,46,29,17,0,0,0
2024-02-13 11:30,66,28,38,0,0,0
2024-02-13 11:45,76,39,37,0,0,0
2024-02-13 12:00,94,52,42,0,0,0
2024-02-13 12:15,114,57,57,0,0,0
2024-02-13 12:30,100,45,55,0,0,0
2024-02-13 12:45,107,55,52,0,0,0
2024-02-13 13:00,121,49,72,0,0,0
2024-02-13 13:15,125,61,64,0,0,0
2024-02-13 13:30,115,52,63,0,0,0
2024-02-13 13:45,126,70,56,0,0,0
2024-02-13 14:00,118,62,56,0,0,0
2024-02-13 14:15,102,55,47,0,0,0
2024-02-13 14:30,105,63,42,0,0,0
2024-02-13 14:45,113,70,43,0,0,0
2024-02-13 15:00,88,50,38,0,0,0
2024-02-13 15:15,83,49,34,0,0,0
2024-02-13 15:30,102,57,45,0,0,0
2024-02-13 15:45,123,64,59,0,0,0
2024-02-13 16:00,125,74,51,0,0,0
2024-02-13 16:15,104,67,37,0,0,0
2024-02-13 16:30,143,80,63,0,0,0
2024-02-13 16:45,141,62,79,0,0,0
2024-02-13 17:00,121,60,61,0,0,0
2024-02-13 17:15,128,78,50,0,0,0
2024-02-13 17:30,105,56,49,0,0,0
2024-02-13 17:45,115,56,59,0,0,0
2024-02-13 18:00,108,54,54,0,0,0
2024-02-13 18:15,112,60,52,0,0,0
2024-02-13 18:30,91,44,47,0,0,0
2024-02-13 18:45,104,44,60,0,0,0
2024-02-13 19:00,81,47,34,0,0,0
2024-02-13 19:15,74,32,42,0,0,0
2024-02-13 19:30,55,17,38,0,0,0
2024-02-13 19:45,54,24,30,0,0,0
2024-02-13 20:00,68,35,33,0,0,0
2024-02-13 20:15,54,28,26,0,0,0
2024-02-13 20:30,32,16,16,0,0,0
2024-02-13 20:45,34,15,19,0,0,0
2024-02-13 21:00,39,25,14,0,0,0
2024-02-13 21:15,37,12,25,0,0,0
2024-02-13 21:30,36,13,23,0,0,0
2024-02-13 21:45,28,8,20,0,0,0
2024-02-13 22:00,37,21,16,0,0,0
2024-02-13 22:15,31,14,17,0,0,0
2024-02-13 22:30,21,11,10,0,0,0
2024-02-13 22:45,9,2,7,0,0,0
2024-02-13 23:00,19,4,15,0,0,0
2024-02-13 23:15,20,9,11,0,0,0
2024-02-13 23:30,11,5,6,0,0,0
2024-02-13 23:45,15,7,8,0,0,0
2024-02-14 00:00,12,6,6,0,0,0
2024-02-14 00:15,7,3,4,0,0,0
2024-02-14 00:30,6,4,2,0,0,0
2024-02-14 00:45,3,1,2,0,0,0
2024-02-14 01:00,3,1,2,0,0,0
2024-02-14 01:15,5,1,4,0,0,0
2024-02-14 01:30,1,0,1,0,0,0
2024-02-14 01:45,4,1,3,0,0,0
2024-02-14 02:00,4,1,3,0,0,0
2024-02-14 02:15,4,1,3,0,0,0
2024-02-14 02:30,1,1,0,0,0,0
2024-02-14 02:45,1,1,0,0,0,0
2024-02-14 03:00,0,0,0,0,0,0
2024-02-14 03:15,0,0,0,0,0,0
2024-02-14 03:30,1,1,0,0,0,0
2024-02-14 03:45,1,0,1,0,0,0
2024-02-14 04:00,1,1,0,0,0,0
2024-02-14 04:15,3,2,1,0,0,0
2024-02-14 04:30,1,0,1,0,0,0
2024-02-14 04:45,6,2,4,0,0,0
2024-02-14 05:00,8,2,6,0,0,0
2024-02-14 05:15,9,6,3,0,0,0
2024-02-14 05:30,15,9,6,0,0,0
2024-02-14 05:45,13,3,10,0,0,0
2024-02-14 06:00,13,11,2,0,0,0
2024-02-14 06:15,25,14,11,0,0,0
2024-02-14 06:30,39,18,21,0,0,0
2024-02-14 06:45,43,29,14,0,0,0
2024-02-14 07:00,63,31,32,0,0,0
2024-02-14 07:15,93,49,44,0,0,0
2024-02-14 07:30,157,97,60,0,0,0
2024-02-14 07:45,190,83,107,0,0,0
2024-02-14 08:00,153,62,91,0,0,0
2024-02-14 08:15,121,57,64,0,0,0
2024-02-14 08:30,116,53,63,0,0,0
2024-02-14 08:45,148,69,79,0,0,0
2024-02-14 09:00,99,36,63,0,0,0
2024-02-14 09:15,102,46,56,0,0,0
2024-02-14 09:30,79,43,36,0,0,0
2024-02-14 09:45,95,39,56,0,0,0
2024-02-14 10:00,63,29,34,0,0,0
2024-02-14 10:15,62,26,36,0,0,0
2024-02-14 10:30,57,26,31,0,0,0
2024-02-14 10:45,67,37,30,0,0,0
2024-02-14 11:00,48,25,23,0,0,0
2024-02-14 11:15,61,27,34,0,0,0
2024-02-14 11:30,61,24,37,0,0,0
2024-02-14 11:45,67,33,34,0,0,0
2024-02-14 12:00,74,39,35,0,0,0
2024-02-14 12:15,73,30,43,0,0,0
2024-02-14 12:30,90,41,49,0,0,0
2024-02-14 12:45,94,40,54,0,0,0
2024-02-14 13:00,114,58,56,0,0,0
2024-02-14 13:15,115,46,69,0,0,0
2024-02-14 13:30,94,54,40,0,0,0
2024-02-14 13:45,86,52,34,0,0,0
2024-02-14 14:00,103,68,35,0,0,0
2024-02-14 14:15,103,60,43,0,0,0
2024-02-14 14:30,86,41,45,0,0,0
2024-02-14 14:45,83,42,41,0,0,0
2024-02-14 15:00,77,41,36,0,0,0
2024-02-14 15:15,90,36,54,0,0,0
2024-02-14 15:30,107,48,59,0,0,0
2024-02-14 15:45,99,41,58,0,0,0
2024-02-14 16:00,76,43,33,0,0,0
2024-02-14 16:15,103,49,54,0,0,0
2024-02-14 16:30,103,56,47,0,0,0
2024-02-14 16:45,97,52,45,0,0,0
2024-02-14 17:00,114,61,53,0,0,0
2024-02-14 17:15,117,69,48,0,0,0
2024-02-14 17:30,112,55,57,0,0,0
2024-02-14 17:45,101,57,44,0,0,0
2024-02-14 18:00,92,53,39,0,0,0
2024-02-14 18:15,97,53,44,0,0,0
2024-02-14 18:30,67,32,35,0,0,0
2024-02-14 18:45,88,46,42,0,0,0
2024-02-14 19:00,44,18,26,0,0,0
2024-02-14 19:15,58,24,34,0,0,0
2024-02-14 19:30,42,20,22,0,0,0
2024-02-14 19:45,57,24,33,0,0,0
2024-02-14 20:00,52,26,26,0,0,0
2024-02-14 20:15,45,19,26,0,0,0
2024-02-14 20:30,29,12,17,0,0,0
2024-02-14 20:45,36,17,19,0,0,0
2024-02-14 21:00,25,13,12,0,0,0
2024-02-14 21:15,37,19,18,0,0,0
2024-02-14 21:30,21,8,13,0,0,0
2024-02-14 21:45,27,11,16,0,0,0
2024-02-14 22:00,23,10,13,0,0,0
2024-02-14 22:15,46,23,23,0,0,0
2024-02-14 22:30,17,8,9,0,0,0
2024-02-14 22:45,14,6,8,0,0,0
2024-02-14 23:00,21,9,12,0,0,0
2024-02-14 23:15,15,7,8,0,0,0
2024-02-14 23:30,12,4,8,0,0,0
2024-02-14 23:45,13,7,6,0,0,0
2024-02-15 00:00,13,7,6,0,0,0
2024-02-15 00:15,8,3,5,0,0,0
2024-02-15 00:30,8,1,7,0,0,0
2024-02-15 00:45,6,1,5,0,0,0
2024-02-15 01:00,3,0,3,0,0,0
2024-02-15 01:15,3,0,3,0,0,0
2024-02-15 01:30,2,1,1,0,0,0
2024-02-15 01:45,2,1,1,0,0,0
2024-02-15 02:00,6,2,4,0,0,0
2024-02-15 02:15,5,1,4,0,0,0
2024-02-15 02:30,2,2,0,0,0,0
2024-02-15 02:45,3,0,3,0,0,0
2024-02-15 03:00,5,2,3,0,0,0
2024-02-15 03:15,7,2,5,0,0,0
2024-02-15 03:30,3,0,3,0,0,0
2024-02-15 03:45,2,0,2,0,0,0
2024-02-15 04:00,2,1,1,0,0,0
2024-02-15 04:15,5,1,4,0,0,0
2024-02-15 04:30,3,1,2,0,0,0
2024-02-15 04:45,3,1,2,0,0,0
2024-02-15 05:00,7,4,3,0,0,0
2024-02-15 05:15,5,2,3,0,0,0
2024-02-15 05:30,17,7,10,0,0,0
2024-02-15 05:45,15,5,10,0,0,0
2024-02-15 06:00,15,9,6,0,0,0
2024-02-15 06:15,39,20,19,0,0,0
2024-02-15 06:30,49,29,20,0,0,0
2024-02-15 06:45,48,23,25,0,0,0
2024-02-15 07:00,63,30,33,0,0,0
2024-02-15 07:15,145,96,49,0,0,0
2024-02-15 07:30,206,133,73,0,0,0
2024-02-15 07:45,178,77,101,0,0,0
2024-02-15 08:00,125,48,77,0,0,0
2024-02-15 08:15,127,59,68,0,0,0
2024-02-15 08:30,111,58,53,0,0,0
2024-02-15 08:45,128,62,66,0,0,0
2024-02-15 09:00,125,41,84,0,0,0
2024-02-15 09:15,113,43,70,0,0,0
2024-02-15 09:30,117,48,69,0,0,0
2024-02-15 09:45,100,49,51,0,0,0
2024-02-15 10:00,52,21,31,0,0,0
2024-02-15 10:15,53,25,28,0,0,0
2024-02-15 10:30,53,28,25,0,0,0
2024-02-15 10:45,60,35,25,0,0,0
2024-02-15 11:00,29,7,22,0,0,0
2024-02-15 11:15,18,2,16,0,0,0
2024-02-15 11:30,34,4,30,0,0,0
2024-02-15 11:45,80,42,38,0,0,0
2024-02-15 12:00,109,52,57,0,0,0
2024-02-15 12:15,75,28,47,0,0,0
2024-02-15 12:30,66,37,29,0,0,0
2024-02-15 12:45,75,35,40,0,0,0
2024-02-15 13:00,126,52,74,0,0,0
2024-02-15 13:15,144,52,92,0,0,0
2024-02-15 13:30,99,59,40,0,0,0
2024-02-15 13:45,104,63,41,0,0,0
2024-02-15 14:00,113,48,65,0,0,0
2024-02-15 14:15,123,71,52,0,0,0
2024-02-15 14:30,84,42,42,0,0,0
2024-02-15 14:45,98,59,39,0,0,0
2024-02-15 15:00,113,62,51,0,0,0
2024-02-15 15:15,92,50,42,0,0,0
2024-02-15 15:30,108,54,54,0,0,0
2024-02-15 15:45,164,84,80,0,0,0
2024-02-15 16:00,135,75,60,0,0,0
2024-02-15 16:15,127,58,69,0,0,0
2024-02-15 16:30,135,79,56,0,0,0
2024-02-15 16:45,125,73,52,0,0,0
2024-02-15 17:00,141,75,66,0,0,0
2024-02-15 17:15,133,85,48,0,0,0
2024-02-15 17:30,142,85,57,0,0,0
2024-02-15 17:45,138,58,80,0,0,0
2024-02-15 18:00,116,55,61,0,0,0
2024-02-15 18:15,107,59,48,0,0,0
2024-02-15 18:30,105,60,45,0,0,0
2024-02-15 18:45,84,38,46,0,0,0
2024-02-15 19:00,91,45,46,0,0,0
2024-02-15 19:15,80,45,35,0,0,0
2024-02-15 19:30,57,23,34,0,0,0
2024-02-15 19:45,84,40,44,0,0,0
2024-02-15 20:00,60,27,33,0,0,0
2024-02-15 20:15,44,20,24,0,0,0
2024-02-15 20:30,37,17,20,0,0,0
2024-02-15 20:45,33,16,17,0,0,0
2024-02-15 21:00,32,17,15,0,0,0
2024-02-15 21:15,37,16,21,0,0,0
2024-02-15 21:30,37,13,24,0,0,0
2024-02-15 21:45,35,11,24,0,0,0
2024-02-15 22:00,40,11,29,0,0,0
2024-02-15 22:15,44,19,25,0,0,0
2024-02-15 22:30,26,11,15,0,0,0
2024-02-15 22:45,26,7,19,0,0,0
2024-02-15 23:00,22,4,18,0,0,0
2024-02-15 23:15,19,6,13,0,0,0
2024-02-15 23:30,11,3,8,0,0,0
2024-02-15 23:45,11,5,6,0,0,0
2024-02-16 00:00,13,6,7,0,0,0
2024-02-16 00:15,14,3,11,0,0,0
2024-02-16 00:30,14,2,12,0,0,0
2024-02-16 00:45,5,2,3,0,0,0
2024-02-16 01:00,5,1,4,0,0,0
2024-02-16 01:15,2,0,2,0,0,0
2024-02-16 01:30,3,1,2,0,0,0
2024-02-16 01:45,4,0,4,0,0,0
2024-02-16 02:00,6,0,6,0,0,0
2024-02-16 02:15,1,0,1,0,0,0
2024-02-16 02:30,1,0,1,0,0,0
2024-02-16 02:45,0,0,0,0,0,0
2024-02-16 03:00,0,0,0,0,0,0
2024-02-16 03:15,1,1,0,0,0,0
2024-02-16 03:30,1,0,1,0,0,0
2024-02-16 03:45,2,2,0,0,0,0
2024-02-16 04:00,2,1,1,0,0,0
2024-02-16 04:15,3,1,2,0,0,0
2024-02-16 04:30,3,0,3,0,0,0
2024-02-16 04:45,3,2,1,0,0,0
2024-02-16 05:00,4,2,2,0,0,0
2024-02-16 05:15,5,3,2,0,0,0
2024-02-16 05:30,6,4,2,0,0,0
2024-02-16 05:45,11,4,7,0,0,0
2024-02-16 06:00,15,11,4,0,0,0
2024-02-16 06:15,26,12,14,0,0,0
2024-02-16 06:30,41,25,16,0,0,0
2024-02-16 06:45,55,29,26,0,0,0
2024-02-16 07:00,79,37,42,0,0,0
2024-02-16 07:15,113,72,41,0,0,0
2024-02-16 07:30,192,130,62,0,0,0
2024-02-16 07:45,164,67,97,0,0,0
2024-02-16 08:00,153,59,94,0,0,0
2024-02-16 08:15,114,50,64,0,0,0
2024-02-16 08:30,112,60,52,0,0,0
2024-02-16 08:45,127,61,66,0,0,0
2024-02-16 09:00,124,59,65,0,0,0
2024-02-16 09:15,85,47,38,0,0,0
2024-02-16 09:30,92,41,51,0,0,0
2024-02-16 09:45,109,59,50,0,0,0
2024-02-16 10:00,66,29,37,0,0,0
2024-02-16 10:15,64,32,32,0,0,0
2024-02-16 10:30,56,25,31,0,0,0
2024-02-16 10:45,68,36,32,0,0,0
2024-02-16 11:00,57,31,26,0,0,0
2024-02-16 11:15,72,26,46,0,0,0
2024-02-16 11:30,70,34,36,0,0,0
2024-02-16 11:45,72,37,35,0,0,0
2024-02-16 12:00,73,38,35,0,0,0
2024-02-16 12:15,113,54,59,0,0,0
2024-02-16 12:30,95,36,59,0,0,0
2024-02-16 12:45,99,36,63,0,0,0
2024-02-16 13:00,145,60,85,0,0,0
2024-02-16 13:15,149,57,92,0,0,0
2024-02-16 13:30,133,60,73,0,0,0
2024-02-16 13:45,126,57,69,0,0,0
2024-02-16 14:00,115,62,53,0,0,0
2024-02-16 14:15,108,61,47,0,0,0
2024-02-16 14:30,91,45,46,0,0,0
2024-02-16 14:45,89,49,40,0,0,0
2024-02-16 15:00,120,75,45,0,0,0
2024-02-16 15:15,97,56,41,0,0,0
2024-02-16 15:30,112,67,45,0,0,0
2024-02-16 15:45,93,61,32,0,0,0
2024-02-16 16:00,114,74,40,0,0,0
2024-02-16 16:15,146,99,47,0,0,0
2024-02-16 16:30,131,102,29,0,0,0
2024-02-16 16:45,140,108,32,0,0,0
2024-02-16 17:00,115,86,29,0,0,0
2024-02-16 17:15,95,57,38,0,0,0
2024-02-16 17:30,79,53,26,0,0,0
2024-02-16 17:45,95,47,48,0,0,0
2024-02-16 18:00,74,35,39,0,0,0
2024-02-16 18:15,99,47,52,0,0,0
2024-02-16 18:30,91,36,55,0,0,0
2024-02-16 18:45,100,32,68,0,0,0
2024-02-16 19:00,100,25,75,0,0,0
2024-02-16 19:15,93,34,59,0,0,0
2024-02-16 19:30,86,33,53,0,0,0
2024-02-16 19:45,88,29,59,0,0,0
2024-02-16 20:00,68,21,47,0,0,0
2024-02-16 20:15,60,14,46,0,0,0
2024-02-16 20:30,44,17,27,0,0,0
2024-02-16 20:45,49,19,30,0,0,0
2024-02-16 21:00,48,25,23,0,0,0
2024-02-16 21:15,45,19,26,0,0,0
2024-02-16 21:30,35,14,21,0,0,0
2024-02-16 21:45,45,22,23,0,0,0
2024-02-16 22:00,31,9,22,0,0,0
2024-02-16 22:15,48,17,31,0,0,0
2024-02-16 22:30,28,9,19,0,0,0
2024-02-16 22:45,30,10,20,0,0,0
2024-02-16 23:00,18,6,12,0,0,0
2024-02-16 23:15,26,5,21,0,0,0
2024-02-16 23:30,17,5,12,0,0,0
2024-02-16 23:45,25,11,14,0,0,0
2024-02-17 00:00,26,15,11,0,0,0
2024-02-17 00:15,17,6,11,0,0,0
2024-02-17 00:30,19,5,14,0,0,0
2024-02-17 00:45,18,6,12,0,0,0
2024-02-17 01:00,18,7,11,0,0,0
2024-02-17 01:15,14,3,11,0,0,0
2024-02-17 01:30,20,5,15,0,0,0
2024-02-17 01:45,11,2,9,0,0,0
2024-02-17 02:00,19,8,11,0,0,0
2024-02-17 02:15,11,2,9,0,0,0
2024-02-17 02:30,11,5,6,0,0,0
2024-02-17 02:45,7,1,6,0,0,0
2024-02-17 03:00,12,4,8,0,0,0
2024-02-17 03:15,8,0,8,0,0,0
2024-02-17 03:30,5,1,4,0,0,0
2024-02-17 03:45,5,1,4,0,0,0
2024-02-17 04:00,2,1,1,0,0,0
2024-02-17 04:15,4,1,3,0,0,0
2024-02-17 04:30,1,0,1,0,0,0
2024-02-17 04:45,2,0,2,0,0,0
2024-02-17 05:00,4,4,0,0,0,0
2024-02-17 05:15,4,1,3,0,0,0
2024-02-17 05:30,12,4,8,0,0,0
2024-02-17 05:45,9,2,7,0,0,0
2024-02-17 06:00,5,2,3,0,0,0
2024-02-17 06:15,5,3,2,0,0,0
2024-02-17 06:30,6,5,1,0,0,0
2024-02-17 06:45,8,4,4,0,0,0
2024-02-17 07:00,7,4,3,0,0,0
2024-02-17 07:15,6,3,3,0,0,0
2024-02-17 07:30,8,4,4,0,0,0
2024-02-17 07:45,13,5,8,0,0,0
2024-02-17 08:00,10,8,2,0,0,0
2024-02-17 08:15,12,7,5,0,0,0
2024-02-17 08:30,27,16,11,0,0,0
2024-02-17 08:45,28,14,14,0,0,0
2024-02-17 09:00,23,14,9,0,0,0
2024-02-17 09:15,25,18,7,0,0,0
2024-02-17 09:30,44,25,19,0,0,0
2024-02-17 09:45,66,41,25,0,0,0
2024-02-17 10:00,44,26,18,0,0,0
2024-02-17 10:15,39,22,17,0,0,0
2024-02-17 10:30,49,27,22,0,0,0
2024-02-17 10:45,65,42,23,0,0,0
2024-02-17 11:00,46,29,17,0,0,0
2024-02-17 11:15,57,40,17,0,0,0
2024-02-17 11:30,50,33,17,0,0,0
2024-02-17 11:45,60,29,31,0,0,0
2024-02-17 12:00,53,32,21,0,0,0
2024-02-17 12:15,64,36,28,0,0,0
2024-02-17 12:30,64,35,29,0,0,0
2024-02-17 12:45,81,38,43,0,0,0
2024-02-17 13:00,57,33,24,0,0,0
2024-02-17 13:15,51,19,32,0,0,0
2024-02-17 13:30,60,32,28,0,0,0
2024-02-17 13:45,72,36,36,0,0,0
2024-02-17 14:00,67,26,41,0,0,0
2024-02-17 14:15,59,33,26,0,0,0
2024-02-17 14:30,71,34,37,0,0,0
2024-02-17 14:45,44,26,18,0,0,0
2024-02-17 15:00,60,36,24,0,0,0
2024-02-17 15:15,47,25,22,0,0,0
2024-02-17 15:30,42,22,20,0,0,0
2024-02-17 15:45,46,21,25,0,0,0
2024-02-17 16:00,45,23,22,0,0,0
2024-02-17 16:15,50,29,21,0,0,0
2024-02-17 16:30,66,31,35,0,0,0
2024-02-17 16:45,55,22,33,0,0,0
2024-02-17 17:00,60,24,36,0,0,0
2024-02-17 17:15,47,25,22,0,0,0
2024-02-17 17:30,52,18,34,0,0,0
2024-02-17 17:45,68,33,35,0,0,0
2024-02-17 18:00,47,21,26,0,0,0
2024-02-17 18:15,66,29,37,0,0,0
2024-02-17 18:30,53,29,24,0,0,0
2024-02-17 18:45,55,30,25,0,0,0
2024-02-17 19:00,52,29,23,0,0,0
2024-02-17 19:15,46,22,24,0,0,0
2024-02-17 19:30,36,20,16,0,0,0
2024-02-17 19:45,41,24,17,0,0,0
2024-02-17 20:00,43,18,25,0,0,0
2024-02-17 20:15,43,19,24,0,0,0
2024-02-17 20:30,21,5,16,0,0,0
2024-02-17 20:45,29,16,13,0,0,0
2024-02-17 21:00,25,13,12,0,0,0
2024-02-17 21:15,42,27,15,0,0,0
2024-02-17 21:30,25,8,17,0,0,0
2024-02-17 21:45,17,10,7,0,0,0
2024-02-17 22:00,20,7,13,0,0,0
2024-02-17 22:15,15,2,13,0,0,0
2024-02-17 22:30,26,14,12,0,0,0
2024-02-17 22:45,32,11,21,0,0,0
2024-02-17 23:00,34,11,23,0,0,0
2024-02-17 23:15,28,7,21,0,0,0
2024-02-17 23:30,30,6,24,0,0,0
2024-02-17 23:45,24,11,13,0,0,0
2024-02-18 00:00,23,7,16,0,0,0
2024-02-18 00:15,19,5,14,0,0,0
2024-02-18 00:30,21,12,9,0,0,0
2024-02-18 00:45,31,13,18,0,0,0
2024-02-18 01:00,12,4,8,0,0,0
2024-02-18 01:15,31,10,21,0,0,0
2024-02-18 01:30,16,8,8,0,0,0
2024-02-18 01:45,4,1,3,0,0,0
2024-02-18 02:00,12,6,6,0,0,0
2024-02-18 02:15,10,2,8,0,0,0
2024-02-18 02:30,12,3,9,0,0,0
2024-02-18 02:45,11,4,7,0,0,0
2024-02-18 03:00,11,3,8,0,0,0
2024-02-18 03:15,8,0,8,0,0,0
2024-02-18 03:30,6,2,4,0,0,0
2024-02-18 03:45,5,1,4,0,0,0
2024-02-18 04:00,3,1,2,0,0,0
2024-02-18 04:15,7,3,4,0,0,0
2024-02-18 04:30,1,0,1,0,0,0
2024-02-18 04:45,3,2,1,0,0,0
2024-02-18 05:00,4,2,2,0,0,0
2024-02-18 05:15,5,2,3,0,0,0
2024-02-18 05:30,6,2,4,0,0,0
2024-02-18 05:45,6,0,6,0,0,0
2024-02-18 06:00,7,3,4,0,0,0
2024-02-18 06:15,4,2,2,0,0,0
2024-02-18 06:30,9,8,1,0,0,0
2024-02-18 06:45,7,2,5,0,0,0
2024-02-18 07:00,3,0,3,0,0,0
2024-02-18 07:15,2,1,1,0,0,0
2024-02-18 07:30,5,2,3,0,0,0
2024-02-18 07:45,12,1,11,0,0,0
2024-02-18 08:00,9,3,6,0,0,0
2024-02-18 08:15,6,4,2,0,0,0
2024-02-18 08:30,13,5,8,0,0,0
2024-02-18 08:45,11,6,5,0,0,0
2024-02-18 09:00,11,7,4,0,0,0
2024-02-18 09:15,12,7,5,0,0,0
2024-02-18 09:30,21,13,8,0,0,0
2024-02-18 09:45,37,25,12,0,0,0
2024-02-18 10:00,19,9,10,0,0,0
2024-02-18 10:15,30,12,18,0,0,0
2024-02-18 10:30,13,7,6,0,0,0
2024-02-18 10:45,31,20,11,0,0,0
2024-02-18 11:00,18,8,10,0,0,0
2024-02-18 11:15,22,11,11,0,0,0
2024-02-18 11:30,29,18,11,0,0,0
2024-02-18 11:45,25,6,19,0,0,0
2024-02-18 12:00,23,10,13,0,0,0
2024-02-18 12:15,24,8,16,0,0,0
2024-02-18 12:30,24,5,19,0,0,0
2024-02-18 12:45,17,8,9,0,0,0
2024-02-18 13:00,25,11,14,0,0,0
2024-02-18 13:15,28,13,15,0,0,0
2024-02-18 13:30,21,13,8,0,0,0
2024-02-18 13:45,21,10,11,0,0,0
2024-02-18 14:00,38,15,23,0,0,0
2024-02-18 14:15,31,19,12,0,0,0
2024-02-18 14:30,18,13,5,0,0,0
2024-02-18 14:45,25,19,6,0,0,0
2024-02-18 15:00,25,11,14,0,0,0
2024-02-18 15:15,20,11,9,0,0,0
2024-02-18 15:30,21,8,13,0,0,0
2024-02-18 15:45,20,10,10,0,0,0
2024-02-18 16:00,29,17,12,0,0,0
2024-02-18 16:15,25,14,11,0,0,0
2024-02-18 16:30,28,12,16,0,0,0
2024-02-18 16:45,27,12,15,0,0,0
2024-02-18 17:00,21,11,10,0,0,0
2024-02-18 17:15,26,13,13,0,0,0
2024-02-18 17:30,30,13,17,0,0,0
2024-02-18 17:45,24,15,9,0,0,0
2024-02-18 18:00,31,14,17,0,0,0
2024-02-18 18:15,30,12,18,0,0,0
2024-02-18 18:30,28,13,15,0,0,0
2024-02-18 18:45,33,20,13,0,0,0
2024-02-18 19:00,22,12,10,0,0,0
2024-02-18 19:15,21,9,12,0,0,0
2024-02-18 19:30,19,7,12,0,0,0
2024-02-18 19:45,27,12,15,0,0,0
2024-02-18 20:00,19,5,14,0,0,0
2024-02-18 20:15,30,11,19,0,0,0
2024-02-18 20:30,15,6,9,0,0,0
2024-02-18 20:45,20,8,12,0,0,0
2024-02-18 21:00,16,13,3,0,0,0
2024-02-18 21:15,13,8,5,0,0,0
2024-02-18 21:30,15,7,8,0,0,0
2024-02-18 21:45,13,7,6,0,0,0
2024-02-18 22:00,10,6,4,0,0,0
2024-02-18 22:15,9,7,2,0,0,0
2024-02-18 22:30,12,4,8,0,0,0
2024-02-18 22:45,5,1,4,0,0,0
2024-02-18 23:00,4,2,2,0,0,0
2024-02-18 23:15,2,0,2,0,0,0
2024-02-18 23:30,3,1,2,0,0,0
2024-02-18 23:45,4,1,3,0,0,0
2024-02-19 00:00,3,0,3,0,0,0
2024-02-19 00:15,3,0,3,0,0,0
2024-02-19 00:30,2,2,0,0,0,0
2024-02-19 00:45,1,0,1,0,0,0
2024-02-19 01:00,1,0,1,0,0,0
2024-02-19 01:15,3,2,1,0,0,0
2024-02-19 01:30,1,0,1,0,0,0
2024-02-19 01:45,0,0,0,0,0,0
2024-02-19 02:00,2,0,2,0,0,0
2024-02-19 02:15,1,0,1,0,0,0
2024-02-19 02:30,0,0,0,0,0,0
2024-02-19 02:45,0,0,0,0,0,0
2024-02-19 03:00,0,0,0,0,0,0
2024-02-19 03:15,1,0,1,0,0,0
2024-02-19 03:30,1,0,1,0,0,0
2024-02-19 03:45,0,0,0,0,0,0
2024-02-19 04:00,0,0,0,0,0,0
2024-02-19 04:15,3,1,2,0,0,0
2024-02-19 04:30,3,2,1,0,0,0
2024-02-19 04:45,3,0,3,0,0,0
2024-02-19 05:00,6,3,3,0,0,0
2024-02-19 05:15,3,1,2,0,0,0
2024-02-19 05:30,14,6,8,0,0,0
2024-02-19 05:45,16,6,10,0,0,0
2024-02-19 06:00,20,13,7,0,0,0
2024-02-19 06:15,30,16,14,0,0,0
2024-02-19 06:30,55,27,28,0,0,0
2024-02-19 06:45,52,24,28,0,0,0
2024-02-19 07:00,41,35,6,0,0,0
2024-02-19 07:15,82,77,5,0,0,0
2024-02-19 07:30,132,121,11,0,0,0
2024-02-19 07:45,88,76,12,0,0,0
2024-02-19 08:00,56,56,0,0,0,0
2024-02-19 08:15,64,57,7,0,0,0
2024-02-19 08:30,63,62,1,0,0,0
2024-02-19 08:45,54,50,4,0,0,0
2024-02-19 09:00,102,45,57,0,0,0
2024-02-19 09:15,84,46,38,0,0,0
2024-02-19 09:30,114,57,57,0,0,0
2024-02-19 09:45,94,38,56,0,0,0
2024-02-19 10:00,60,32,28,0,0,0
2024-02-19 10:15,59,29,30,0,0,0
2024-02-19 10:30,39,19,20,0,0,0
2024-02-19 10:45,57,31,26,0,0,0
2024-02-19 11:00,52,18,34,0,0,0
2024-02-19 11:15,54,30,24,0,0,0
2024-02-19 11:30,60,33,27,0,0,0
2024-02-19 11:45,73,41,32,0,0,0
2024-02-19 12:00,74,33,41,0,0,0
2024-02-19 12:15,83,38,45,0,0,0
2024-02-19 12:30,107,46,61,0,0,0
2024-02-19 12:45,90,37,53,0,0,0
2024-02-19 13:00,25,21,4,0,0,0
2024-02-19 13:15,39,37,2,0,0,0
2024-02-19 13:30,35,32,3,0,0,0
2024-02-19 13:45,37,33,4,0,0,0
2024-02-19 14:00,36,35,1,0,0,0
2024-02-19 14:15,53,47,6,0,0,0
2024-02-19 14:30,36,33,3,0,0,0
2024-02-19 14:45,42,39,3,0,0,0
2024-02-19 15:00,34,31,3,0,0,0
2024-02-19 15:15,39,37,2,0,0,0
2024-02-19 15:30,51,50,1,0,0,0
2024-02-19 15:45,58,51,7,0,0,0
2024-02-19 16:00,61,58,3,0,0,0
2024-02-19 16:15,60,57,3,0,0,0
2024-02-19 16:30,77,71,6,0,0,0
2024-02-19 16:45,56,53,3,0,0,0
2024-02-19 17:00,61,55,6,0,0,0
2024-02-19 17:15,60,56,4,0,0,0
2024-02-19 17:30,61,57,4,0,0,0
2024-02-19 17:45,60,58,2,0,0,0
2024-02-19 18:00,103,48,55,0,0,0
2024-02-19 18:15,75,33,42,0,0,0
2024-02-19 18:30,87,48,39,0,0,0
2024-02-19 18:45,85,46,39,0,0,0
2024-02-19 19:00,50,44,6,0,0,0
2024-02-19 19:15,36,31,5,0,0,0
2024-02-19 19:30,18,18,0,0,0,0
2024-02-19 19:45,19,17,2,0,0,0
2024-02-19 20:00,26,24,2,0,0,0
2024-02-19 20:15,14,10,4,0,0,0
2024-02-19 20:30,12,9,3,0,0,0
2024-02-19 20:45,11,11,0,0,0,0
2024-02-19 21:00,21,18,3,0,0,0
2024-02-19 21:15,15,13,2,0,0,0
2024-02-19 21:30,4,3,1,0,0,0
2024-02-19 21:45,4,3,1,0,0,0
2024-02-19 22:00,8,8,0,0,0,0
2024-02-19 22:15,8,6,2,0,0,0
2024-02-19 22:30,1,1,0,0,0,0
2024-02-19 22:45,3,3,0,0,0,0
2024-02-19 23:00,5,5,0,0,0,0
2024-02-19 23:15,3,3,0,0,0,0
2024-02-19 23:30,2,1,1,0,0,0
2024-02-19 23:45,2,2,0,0,0,0
2024-02-20 00:00,2,2,0,0,0,0
2024-02-20 00:15,0,0,0,0,0,0
2024-02-20 00:30,3,3,0,0,0,0
2024-02-20 00:45,0,0,0,0,0,0
2024-02-20 01:00,1,1,0,0,0,0
2024-02-20 01:15,1,1,0,0,0,0
2024-02-20 01:30,1,1,0,0,0,0
2024-02-20 01:45,0,0,0,0,0,0
2024-02-20 02:00,1,1,0,0,0,0
2024-02-20 02:15,0,0,0,0,0,0
2024-02-20 02:30,3,2,1,0,0,0
2024-02-20 02:45,0,0,0,0,0,0
2024-02-20 03:00,0,0,0,0,0,0
2024-02-20 03:15,0,0,0,0,0,0
2024-02-20 03:30,1,0,1,0,0,0
2024-02-20 03:45,0,0,0,0,0,0
2024-02-20 04:00,0,0,0,0,0,0
2024-02-20 04:15,4,2,2,0,0,0
2024-02-20 04:30,4,4,0,0,0,0
2024-02-20 04:45,4,1,3,0,0,0
2024-02-20 05:00,3,2,1,0,0,0
2024-02-20 05:15,2,1,1,0,0,0
2024-02-20 05:30,12,7,5,0,0,0
2024-02-20 05:45,7,6,1,0,0,0
2024-02-20 06:00,15,13,2,0,0,0
2024-02-20 06:15,15,13,2,0,0,0
2024-02-20 06:30,23,20,3,0,0,0
2024-02-20 06:45,33,28,5,0,0,0
2024-02-20 07:00,79,44,35,0,0,0
2024-02-20 07:15,114,64,50,0,0,0
2024-02-20 07:30,218,136,82,0,0,0
2024-02-20 07:45,178,63,115,0,0,0
2024-02-20 08:00,149,65,84,0,0,0
2024-02-20 08:15,145,66,79,0,0,0
2024-02-20 08:30,110,60,50,0,0,0
2024-02-20 08:45,131,55,76,0,0,0
2024-02-20 09:00,120,40,80,0,0,0
2024-02-20 09:15,77,32,45,0,0,0
2024-02-20 09:30,90,44,46,0,0,0
2024-02-20 09:45,125,45,80,0,0,0
2024-02-20 10:00,75,38,37,0,0,0
2024-02-20 10:15,61,21,40,0,0,0
2024-02-20 10:30,60,36,24,0,0,0
2024-02-20 10:45,66,34,32,0,0,0
2024-02-20 11:00,64,36,28,0,0,0
2024-02-20 11:15,69,27,42,0,0,0
2024-02-20 11:30,75,30,45,0,0,0
2024-02-20 11:45,93,39,54,0,0,0
2024-02-20 12:00,70,35,35,0,0,0
2024-02-20 12:15,110,38,72,0,0,0
2024-02-20 12:30,116,60,56,0,0,0
2024-02-20 12:45,95,42,53,0,0,0
2024-02-20 13:00,33,30,3,0,0,0
2024-02-20 13:15,30,29,1,0,0,0
2024-02-20 13:30,34,32,2,0,0,0
2024-02-20 13:45,52,47,5,0,0,0
2024-02-20 14:00,36,36,0,0,0,0
2024-02-20 14:15,53,52,1,0,0,0
2024-02-20 14:30,49,45,4,0,0,0
2024-02-20 14:45,55,51,4,0,0,0
2024-02-20 15:00,42,34,8,0,0,0
2024-02-20 15:15,67,66,1,0,0,0
2024-02-20 15:30,52,47,5,0,0,0
2024-02-20 15:45,82,76,6,0,0,0
2024-02-20 16:00,63,58,5,0,0,0
2024-02-20 16:15,74,68,6,0,0,0
2024-02-20 16:30,80,75,5,0,0,0
2024-02-20 16:45,82,77,5,0,0,0
2024-02-20 17:00,81,72,9,0,0,0
2024-02-20 17:15,67,62,5,0,0,0
2024-02-20 17:30,83,79,4,0,0,0
2024-02-20 17:45,61,55,6,0,0,0
2024-02-20 18:00,65,60,5,0,0,0
2024-02-20 18:15,44,42,2,0,0,0
2024-02-20 18:30,46,42,4,0,0,0
2024-02-20 18:45,38,33,5,0,0,0
2024-02-20 19:00,53,50,3,0,0,0
2024-02-20 19:15,33,32,1,0,0,0
2024-02-20 19:30,29,29,0,0,0,0
2024-02-20 19:45,41,38,3,0,0,0
2024-02-20 20:00,30,28,2,0,0,0
2024-02-20 20:15,28,23,5,0,0,0
2024-02-20 20:30,13,11,2,0,0,0
2024-02-20 20:45,21,19,2,0,0,0
2024-02-20 21:00,15,12,3,0,0,0
2024-02-20 21:15,9,7,2,0,0,0
2024-02-20 21:30,11,8,3,0,0,0
2024-02-20 21:45,12,11,1,0,0,0
2024-02-20 22:00,16,16,0,0,0,0
2024-02-20 22:15,31,25,6,0,0,0
2024-02-20 22:30,5,5,0,0,0,0
2024-02-20 22:45,2,2,0,0,0,0
2024-02-20 23:00,7,7,0,0,0,0
2024-02-20 23:15,7,4,3,0,0,0
2024-02-20 23:30,4,3,1,0,0,0
2024-02-20 23:45,2,2,0,0,0,0
2024-02-21 00:00,7,6,1,0,0,0
2024-02-21 00:15,0,0,0,0,0,0
2024-02-21 00:30,1,1,0,0,0,0
2024-02-21 00:45,3,1,2,0,0,0
2024-02-21 01:00,0,0,0,0,0,0
2024-02-21 01:15,1,1,0,0,0,0
2024-02-21 01:30,1,1,0,0,0,0
2024-02-21 01:45,1,1,0,0,0,0
2024-02-21 02:00,1,0,1,0,0,0
2024-02-21 02:15,0,0,0,0,0,0
2024-02-21 02:30,1,1,0,0,0,0
2024-02-21 02:45,0,0,0,0,0,0
2024-02-21 03:00,0,0,0,0,0,0
2024-02-21 03:15,0,0,0,0,0,0
2024-02-21 03:30,0,0,0,0,0,0
2024-02-21 03:45,1,0,1,0,0,0
2024-02-21 04:00,1,1,0,0,0,0
2024-02-21 04:15,3,2,1,0,0,0
2024-02-21 04:30,3,1,2,0,0,0
2024-02-21 04:45,1,0,1,0,0,0
2024-02-21 05:00,4,2,2,0,0,0
2024-02-21 05:15,5,4,1,0,0,0
2024-02-21 05:30,9,5,4,0,0,0
2024-02-21 05:45,5,4,1,0,0,0
2024-02-21 06:00,14,12,2,0,0,0
2024-02-21 06:15,15,14,1,0,0,0
2024-02-21 06:30,21,19,2,0,0,0
2024-02-21 06:45,40,33,7,0,0,0
2024-02-21 07:00,44,39,5,0,0,0
2024-02-21 07:15,81,77,4,0,0,0
2024-02-21 07:30,129,117,12,0,0,0
2024-02-21 07:45,106,96,10,0,0,0
2024-02-21 08:00,69,65,4,0,0,0
2024-02-21 08:15,66,57,9,0,0,0
2024-02-21 08:30,53,49,4,0,0,0
2024-02-21 08:45,45,41,4,0,0,0
2024-02-21 09:00,48,40,8,0,0,0
2024-02-21 09:15,43,39,4,0,0,0
2024-02-21 09:30,41,41,0,0,0,0
2024-02-21 09:45,49,44,5,0,0,0
2024-02-21 10:00,42,38,4,0,0,0
2024-02-21 10:15,32,31,1,0,0,0
2024-02-21 10:30,43,41,2,0,0,0
2024-02-21 10:45,32,30,2,0,0,0
2024-02-21 11:00,46,42,4,0,0,0
2024-02-21 11:15,39,33,6,0,0,0
2024-02-21 11:30,22,21,1,0,0,0
2024-02-21 11:45,44,39,5,0,0,0
2024-02-21 12:00,21,19,2,0,0,0
2024-02-21 12:15,28,26,2,0,0,0
2024-02-21 12:30,38,34,4,0,0,0
2024-02-21 12:45,32,27,5,0,0,0
2024-02-21 13:00,28,27,1,0,0,0
2024-02-21 13:15,42,41,1,0,0,0
2024-02-21 13:30,33,29,4,0,0,0
2024-02-21 13:45,28,25,3,0,0,0
2024-02-21 14:00,39,37,2,0,0,0
2024-02-21 14:15,52,47,5,0,0,0
2024-02-21 14:30,49,43,6,0,0,0
2024-02-21 14:45,62,55,7,0,0,0
2024-02-21 15:00,41,39,2,0,0,0
2024-02-21 15:15,53,49,4,0,0,0
2024-02-21 15:30,40,37,3,0,0,0
2024-02-21 15:45,63,59,4,0,0,0
2024-02-21 16:00,95,86,9,0,0,0
2024-02-21 16:15,56,52,4,0,0,0
2024-02-21 16:30,85,76,9,0,0,0
2024-02-21 16:45,70,64,6,0,0,0
2024-02-21 17:00,69,66,3,0,0,0
2024-02-21 17:15,62,57,5,0,0,0
2024-02-21 17:30,70,66,4,0,0,0
2024-02-21 17:45,66,64,2,0,0,0
2024-02-21 18:00,58,55,3,0,0,0
2024-02-21 18:15,58,50,8,0,0,0
2024-02-21 18:30,38,36,2,0,0,0
2024-02-21 18:45,29,26,3,0,0,0
2024-02-21 19:00,31,29,2,0,0,0
2024-02-21 19:15,26,25,1,0,0,0
2024-02-21 19:30,28,25,3,0,0,0
2024-02-21 19:45,35,33,2,0,0,0
2024-02-21 20:00,27,26,1,0,0,0
2024-02-21 20:15,17,15,2,0,0,0
2024-02-21 20:30,18,16,2,0,0,0
2024-02-21 20:45,17,16,1,0,0,0
2024-02-21 21:00,21,18,3,0,0,0
2024-02-21 21:15,12,10,2,0,0,0
2024-02-21 21:30,10,9,1,0,0,0
2024-02-21 21:45,11,11,0,0,0,0
2024-02-21 22:00,18,13,5,0,0,0
2024-02-21 22:15,18,18,0,0,0,0
2024-02-21 22:30,12,11,1,0,0,0
2024-02-21 22:45,9,8,1,0,0,0
2024-02-21 23:00,4,3,1,0,0,0
2024-02-21 23:15,5,3,2,0,0,0
2024-02-21 23:30,3,3,0,0,0,0
2024-02-21 23:45,3,3,0,0,0,0
2024-02-22 00:00,2,2,0,0,0,0
2024-02-22 00:15,7,5,2,0,0,0
2024-02-22 00:30,4,4,0,0,0,0
2024-02-22 00:45,4,4,0,0,0,0
2024-02-22 01:00,2,2,0,0,0,0
2024-02-22 01:15,1,1,0,0,0,0
2024-02-22 01:30,1,1,0,0,0,0
2024-02-22 01:45,0,0,0,0,0,0
2024-02-22 02:00,0,0,0,0,0,0
2024-02-22 02:15,1,1,0,0,0,0
2024-02-22 02:30,1,1,0,0,0,0
2024-02-22 02:45,0,0,0,0,0,0
2024-02-22 03:00,1,1,0,0,0,0
2024-02-22 03:15,0,0,0,0,0,0
2024-02-22 03:30,1,1,0,0,0,0
2024-02-22 03:45,1,0,1,0,0,0
2024-02-22 04:00,1,0,1,0,0,0
2024-02-22 04:15,3,2,1,0,0,0
2024-02-22 04:30,2,2,0,0,0,0
2024-02-22 04:45,1,0,1,0,0,0
2024-02-22 05:00,5,3,2,0,0,0
2024-02-22 05:15,3,3,0,0,0,0
2024-02-22 05:30,4,3,1,0,0,0
2024-02-22 05:45,13,9,4,0,0,0
2024-02-22 06:00,7,5,2,0,0,0
2024-02-22 06:15,11,10,1,0,0,0
2024-02-22 06:30,27,24,3,0,0,0
2024-02-22 06:45,26,21,5,0,0,0
2024-02-22 07:00,38,36,2,0,0,0
2024-02-22 07:15,77,72,5,0,0,0
2024-02-22 07:30,127,112,15,0,0,0
2024-02-22 07:45,81,67,14,0,0,0
2024-02-22 08:00,53,47,6,0,0,0
2024-02-22 08:15,56,49,7,0,0,0
2024-02-22 08:30,58,52,6,0,0,0
2024-02-22 08:45,64,57,7,0,0,0
2024-02-22 09:00,46,42,4,0,0,0
2024-02-22 09:15,25,25,0,0,0,0
2024-02-22 09:30,39,37,2,0,0,0
2024-02-22 09:45,38,38,0,0,0,0
2024-02-22 10:00,29,27,2,0,0,0
2024-02-22 10:15,29,29,0,0,0,0
2024-02-22 10:30,36,34,2,0,0,0
2024-02-22 10:45,29,23,6,0,0,0
2024-02-22 11:00,22,20,2,0,0,0
2024-02-22 11:15,15,15,0,0,0,0
2024-02-22 11:30,22,20,2,0,0,0
2024-02-22 11:45,40,36,4,0,0,0
2024-02-22 12:00,37,33,4,0,0,0
2024-02-22 12:15,28,26,2,0,0,0
2024-02-22 12:30,27,26,1,0,0,0
2024-02-22 12:45,32,31,1,0,0,0
2024-02-22 13:00,36,31,5,0,0,0
2024-02-22 13:15,23,23,0,0,0,0
2024-02-22 13:30,36,35,1,0,0,0
2024-02-22 13:45,46,45,1,0,0,0
2024-02-22 14:00,40,34,6,0,0,0
2024-02-22 14:15,57,48,9,0,0,0
2024-02-22 14:30,44,42,2,0,0,0
2024-02-22 14:45,43,40,3,0,0,0
2024-02-22 15:00,55,53,2,0,0,0
2024-02-22 15:15,67,62,5,0,0,0
2024-02-22 15:30,58,54,4,0,0,0
2024-02-22 15:45,57,52,5,0,0,0
2024-02-22 16:00,69,65,4,0,0,0
2024-02-22 16:15,64,60,4,0,0,0
2024-02-22 16:30,69,66,3,0,0,0
2024-02-22 16:45,69,62,7,0,0,0
2024-02-22 17:00,63,53,10,0,0,0
2024-02-22 17:15,47,43,4,0,0,0
2024-02-22 17:30,65,57,8,0,0,0
2024-02-22 17:45,60,54,6,0,0,0
2024-02-22 18:00,49,48,1,0,0,0
2024-02-22 18:15,42,40,2,0,0,0
2024-02-22 18:30,51,48,3,0,0,0
2024-02-22 18:45,32,28,4,0,0,0
2024-02-22 19:00,25,25,0,0,0,0
2024-02-22 19:15,21,20,1,0,0,0
2024-02-22 19:30,34,32,2,0,0,0
2024-02-22 19:45,24,19,5,0,0,0
2024-02-22 20:00,19,16,3,0,0,0
2024-02-22 20:15,10,9,1,0,0,0
2024-02-22 20:30,8,6,2,0,0,0
2024-02-22 20:45,10,8,2,0,0,0
2024-02-22 21:00,18,13,5,0,0,0
2024-02-22 21:15,22,20,2,0,0,0
2024-02-22 21:30,9,7,2,0,0,0
2024-02-22 21:45,10,10,0,0,0,0
2024-02-22 22:00,13,11,2,0,0,0
2024-02-22 22:15,14,14,0,0,0,0
2024-02-22 22:30,4,4,0,0,0,0
2024-02-22 22:45,9,8,1,0,0,0
2024-02-22 23:00,3,3,0,0,0,0
2024-02-22 23:15,0,0,0,0,0,0
2024-02-22 23:30,4,4,0,0,0,0
2024-02-22 23:45,3,3,0,0,0,0
2024-02-23 00:00,3,3,0,0,0,0
2024-02-23 00:15,3,3,0,0,0,0
2024-02-23 00:30,6,5,1,0,0,0
2024-02-23 00:45,2,1,1,0,0,0
2024-02-23 01:00,0,0,0,0,0,0
2024-02-23 01:15,0,0,0,0,0,0
2024-02-23 01:30,0,0,0,0,0,0
2024-02-23 01:45,0,0,0,0,0,0
2024-02-23 02:00,0,0,0,0,0,0
2024-02-23 02:15,1,1,0,0,0,0
2024-02-23 02:30,1,1,0,0,0,0
2024-02-23 02:45,0,0,0,0,0,0
2024-02-23 03:00,0,0,0,0,0,0
2024-02-23 03:15,0,0,0,0,0,0
2024-02-23 03:30,2,1,1,0,0,0
2024-02-23 03:45,0,0,0,0,0,0
2024-02-23 04:00,0,0,0,0,0,0
2024-02-23 04:15,2,1,1,0,0,0
2024-02-23 04:30,4,3,1,0,0,0
2024-02-23 04:45,2,0,2,0,0,0
2024-02-23 05:00,3,1,2,0,0,0
2024-02-23 05:15,6,5,1,0,0,0
2024-02-23 05:30,8,4,4,0,0,0
2024-02-23 05:45,7,3,4,0,0,0
2024-02-23 06:00,11,9,2,0,0,0
2024-02-23 06:15,11,10,1,0,0,0
2024-02-23 06:30,20,17,3,0,0,0
2024-02-23 06:45,28,23,5,0,0,0
2024-02-23 07:00,33,26,7,0,0,0
2024-02-23 07:15,76,71,5,0,0,0
2024-02-23 07:30,108,99,9,0,0,0
2024-02-23 07:45,73,62,11,0,0,0
2024-02-23 08:00,43,36,7,0,0,0
2024-02-23 08:15,45,44,1,0,0,0
2024-02-23 08:30,59,57,2,0,0,0
2024-02-23 08:45,53,42,11,0,0,0
2024-02-23 09:00,41,37,4,0,0,0
2024-02-23 09:15,36,33,3,0,0,0
2024-02-23 09:30,40,38,2,0,0,0
2024-02-23 09:45,45,40,5,0,0,0
2024-02-23 10:00,26,25,1,0,0,0
2024-02-23 10:15,35,33,2,0,0,0
2024-02-23 10:30,26,24,2,0,0,0
2024-02-23 10:45,28,25,3,0,0,0
2024-02-23 11:00,24,22,2,0,0,0
2024-02-23 11:15,17,16,1,0,0,0
2024-02-23 11:30,32,30,2,0,0,0
2024-02-23 11:45,37,33,4,0,0,0
2024-02-23 12:00,35,33,2,0,0,0
2024-02-23 12:15,38,31,7,0,0,0
2024-02-23 12:30,42,38,4,0,0,0
2024-02-23 12:45,40,35,5,0,0,0
2024-02-23 13:00,38,34,4,0,0,0
2024-02-23 13:15,28,28,0,0,0,0
2024-02-23 13:30,34,32,2,0,0,0
2024-02-23 13:45,35,32,3,0,0,0
2024-02-23 14:00,46,43,3,0,0,0
2024-02-23 14:15,57,51,6,0,0,0
2024-02-23 14:30,47,45,2,0,0,0
2024-02-23 14:45,61,59,2,0,0,0
2024-02-23 15:00,64,62,2,0,0,0
2024-02-23 15:15,57,53,4,0,0,0
2024-02-23 15:30,52,46,6,0,0,0
2024-02-23 15:45,58,54,4,0,0,0
2024-02-23 16:00,57,55,2,0,0,0
2024-02-23 16:15,55,52,3,0,0,0
2024-02-23 16:30,54,52,2,0,0,0
2024-02-23 16:45,48,43,5,0,0,0
2024-02-23 17:00,49,47,2,0,0,0
2024-02-23 17:15,56,51,5,0,0,0
2024-02-23 17:30,41,40,1,0,0,0
2024-02-23 17:45,58,55,3,0,0,0
2024-02-23 18:00,36,32,4,0,0,0
2024-02-23 18:15,33,29,4,0,0,0
2024-02-23 18:30,33,30,3,0,0,0
2024-02-23 18:45,39,38,1,0,0,0
2024-02-23 19:00,33,29,4,0,0,0
2024-02-23 19:15,28,24,4,0,0,0
2024-02-23 19:30,35,32,3,0,0,0
2024-02-23 19:45,23,20,3,0,0,0
2024-02-23 20:00,17,16,1,0,0,0
2024-02-23 20:15,19,16,3,0,0,0
2024-02-23 20:30,17,17,0,0,0,0
2024-02-23 20:45,17,16,1,0,0,0
2024-02-23 21:00,20,20,0,0,0,0
2024-02-23 21:15,19,17,2,0,0,0
2024-02-23 21:30,10,10,0,0,0,0
2024-02-23 21:45,9,9,0,0,0,0
2024-02-23 22:00,10,10,0,0,0,0
2024-02-23 22:15,15,12,3,0,0,0
2024-02-23 22:30,11,11,0,0,0,0
2024-02-23 22:45,4,4,0,0,0,0
2024-02-23 23:00,8,7,1,0,0,0
2024-02-23 23:15,11,11,0,0,0,0
2024-02-23 23:30,2,2,0,0,0,0
2024-02-23 23:45,3,3,0,0,0,0
2024-02-24 00:00,1,1,0,0,0,0
2024-02-24 00:15,4,2,2,0,0,0
2024-02-24 00:30,4,2,2,0,0,0
2024-02-24 00:45,5,4,1,0,0,0
2024-02-24 01:00,4,3,1,0,0,0
2024-02-24 01:15,3,3,0,0,0,0
2024-02-24 01:30,2,2,0,0,0,0
2024-02-24 01:45,0,0,0,0,0,0
2024-02-24 02:00,4,4,0,0,0,0
2024-02-24 02:15,1,1,0,0,0,0
2024-02-24 02:30,3,3,0,0,0,0
2024-02-24 02:45,4,4,0,0,0,0
2024-02-24 03:00,0,0,0,0,0,0
2024-02-24 03:15,1,0,1,0,0,0
2024-02-24 03:30,1,1,0,0,0,0
2024-02-24 03:45,3,3,0,0,0,0
2024-02-24 04:00,2,2,0,0,0,0
2024-02-24 04:15,2,2,0,0,0,0
2024-02-24 04:30,5,3,2,0,0,0
2024-02-24 04:45,6,2,4,0,0,0
2024-02-24 05:00,1,1,0,0,0,0
2024-02-24 05:15,6,5,1,0,0,0
2024-02-24 05:30,6,4,2,0,0,0
2024-02-24 05:45,6,0,6,0,0,0
2024-02-24 06:00,4,2,2,0,0,0
2024-02-24 06:15,6,5,1,0,0,0
2024-02-24 06:30,6,5,1,0,0,0
2024-02-24 06:45,8,6,2,0,0,0
2024-02-24 07:00,5,4,1,0,0,0
2024-02-24 07:15,2,2,0,0,0,0
2024-02-24 07:30,4,3,1,0,0,0
2024-02-24 07:45,13,13,0,0,0,0
2024-02-24 08:00,12,10,2,0,0,0
2024-02-24 08:15,3,3,0,0,0,0
2024-02-24 08:30,14,12,2,0,0,0
2024-02-24 08:45,22,19,3,0,0,0
2024-02-24 09:00,17,15,2,0,0,0
2024-02-24 09:15,18,18,0,0,0,0
2024-02-24 09:30,28,27,1,0,0,0
2024-02-24 09:45,35,33,2,0,0,0
2024-02-24 10:00,19,17,2,0,0,0
2024-02-24 10:15,21,20,1,0,0,0
2024-02-24 10:30,21,21,0,0,0,0
2024-02-24 10:45,27,25,2,0,0,0
2024-02-24 11:00,27,22,5,0,0,0
2024-02-24 11:15,31,27,4,0,0,0
2024-02-24 11:30,18,17,1,0,0,0
2024-02-24 11:45,22,21,1,0,0,0
2024-02-24 12:00,22,22,0,0,0,0
2024-02-24 12:15,14,14,0,0,0,0
2024-02-24 12:30,21,18,3,0,0,0
2024-02-24 12:45,33,30,3,0,0,0
2024-02-24 13:00,38,35,3,0,0,0
2024-02-24 13:15,20,17,3,0,0,0
2024-02-24 13:30,29,26,3,0,0,0
2024-02-24 13:45,36,35,1,0,0,0
2024-02-24 14:00,30,27,3,0,0,0
2024-02-24 14:15,30,30,0,0,0,0
2024-02-24 14:30,31,28,3,0,0,0
2024-02-24 14:45,25,24,1,0,0,0
2024-02-24 15:00,26,25,1,0,0,0
2024-02-24 15:15,22,21,1,0,0,0
2024-02-24 15:30,19,18,1,0,0,0
2024-02-24 15:45,23,22,1,0,0,0
2024-02-24 16:00,17,16,1,0,0,0
2024-02-24 16:15,21,20,1,0,0,0
2024-02-24 16:30,22,19,3,0,0,0
2024-02-24 16:45,14,13,1,0,0,0
2024-02-24 17:00,14,14,0,0,0,0
2024-02-24 17:15,21,19,2,0,0,0
2024-02-24 17:30,20,18,2,0,0,0
2024-02-24 17:45,29,27,2,0,0,0
2024-02-24 18:00,14,13,1,0,0,0
2024-02-24 18:15,21,19,2,0,0,0
2024-02-24 18:30,26,21,5,0,0,0
2024-02-24 18:45,20,19,1,0,0,0
2024-02-24 19:00,26,23,3,0,0,0
2024-02-24 19:15,22,22,0,0,0,0
2024-02-24 19:30,21,19,2,0,0,0
2024-02-24 19:45,14,13,1,0,0,0
2024-02-24 20:00,16,15,1,0,0,0
2024-02-24 20:15,12,12,0,0,0,0
2024-02-24 20:30,20,19,1,0,0,0
2024-02-24 20:45,8,8,0,0,0,0
2024-02-24 21:00,20,18,2,0,0,0
2024-02-24 21:15,5,5,0,0,0,0
2024-02-24 21:30,3,2,1,0,0,0
2024-02-24 21:45,5,5,0,0,0,0
2024-02-24 22:00,10,9,1,0,0,0
2024-02-24 22:15,6,6,0,0,0,0
2024-02-24 22:30,10,10,0,0,0,0
2024-02-24 22:45,6,3,3,0,0,0
2024-02-24 23:00,3,3,0,0,0,0
2024-02-24 23:15,8,7,1,0,0,0
2024-02-24 23:30,13,12,1,0,0,0
2024-02-24 23:45,0,0,0,0,0,0
2024-02-25 00:00,6,6,0,0,0,0
2024-02-25 00:15,3,3,0,0,0,0
2024-02-25 00:30,10,9,1,0,0,0
2024-02-25 00:45,4,4,0,0,0,0
2024-02-25 01:00,9,7,2,0,0,0
2024-02-25 01:15,5,4,1,0,0,0
2024-02-25 01:30,11,10,1,0,0,0
2024-02-25 01:45,4,3,1,0,0,0
2024-02-25 02:00,2,1,1,0,0,0
2024-02-25 02:15,2,2,0,0,0,0
2024-02-25 02:30,4,4,0,0,0,0
2024-02-25 02:45,1,1,0,0,0,0
2024-02-25 03:00,1,1,0,0,0,0
2024-02-25 03:15,4,3,1,0,0,0
2024-02-25 03:30,1,1,0,0,0,0
2024-02-25 03:45,0,0,0,0,0,0
2024-02-25 04:00,1,1,0,0,0,0
2024-02-25 04:15,0,0,0,0,0,0
2024-02-25 04:30,5,3,2,0,0,0
2024-02-25 04:45,0,0,0,0,0,0
2024-02-25 05:00,3,1,2,0,0,0
2024-02-25 05:15,0,0,0,0,0,0
2024-02-25 05:30,0,0,0,0,0,0
2024-02-25 05:45,4,1,3,0,0,0
2024-02-25 06:00,4,2,2,0,0,0
2024-02-25 06:15,6,4,2,0,0,0
2024-02-25 06:30,3,2,1,0,0,0
2024-02-25 06:45,5,4,1,0,0,0
2024-02-25 07:00,2,1,1,0,0,0
2024-02-25 07:15,0,0,0,0,0,0
2024-02-25 07:30,3,1,2,0,0,0
2024-02-25 07:45,3,2,1,0,0,0
2024-02-25 08:00,1,1,0,0,0,0
2024-02-25 08:15,2,0,2,0,0,0
2024-02-25 08:30,6,6,0,0,0,0
2024-02-25 08:45,7,4,3,0,0,0
2024-02-25 09:00,5,5,0,0,0,0
2024-02-25 09:15,9,5,4,0,0,0
2024-02-25 09:30,9,8,1,0,0,0
2024-02-25 09:45,17,17,0,0,0,0
2024-02-25 10:00,13,11,2,0,0,0
2024-02-25 10:15,6,5,1,0,0,0
2024-02-25 10:30,16,16,0,0,0,0
2024-02-25 10:45,12,10,2,0,0,0
2024-02-25 11:00,12,11,1,0,0,0
2024-02-25 11:15,13,13,0,0,0,0
2024-02-25 11:30,14,13,1,0,0,0
2024-02-25 11:45,12,11,1,0,0,0
2024-02-25 12:00,13,13,0,0,0,0
2024-02-25 12:15,20,17,3,0,0,0
2024-02-25 12:30,15,11,4,0,0,0
2024-02-25 12:45,20,17,3,0,0,0
2024-02-25 13:00,21,21,0,0,0,0
2024-02-25 13:15,21,14,7,0,0,0
2024-02-25 13:30,9,8,1,0,0,0
2024-02-25 13:45,17,13,4,0,0,0
2024-02-25 14:00,26,23,3,0,0,0
2024-02-25 14:15,21,19,2,0,0,0
2024-02-25 14:30,21,21,0,0,0,0
2024-02-25 14:45,32,27,5,0,0,0
2024-02-25 15:00,17,15,2,0,0,0
2024-02-25 15:15,12,10,2,0,0,0
2024-02-25 15:30,16,15,1,0,0,0
2024-02-25 15:45,34,30,4,0,0,0
2024-02-25 16:00,18,17,1,0,0,0
2024-02-25 16:15,19,18,1,0,0,0
2024-02-25 16:30,28,27,1,0,0,0
2024-02-25 16:45,19,18,1,0,0,0
2024-02-25 17:00,17,16,1,0,0,0
2024-02-25 17:15,21,17,4,0,0,0
2024-02-25 17:30,26,24,2,0,0,0
2024-02-25 17:45,36,33,3,0,0,0
2024-02-25 18:00,10,10,0,0,0,0
2024-02-25 18:15,9,9,0,0,0,0
2024-02-25 18:30,17,16,1,0,0,0
2024-02-25 18:45,20,17,3,0,0,0
2024-02-25 19:00,3,3,0,0,0,0
2024-02-25 19:15,9,8,1,0,0,0
2024-02-25 19:30,15,14,1,0,0,0
2024-02-25 19:45,11,10,1,0,0,0
2024-02-25 20:00,9,7,2,0,0,0
2024-02-25 20:15,9,8,1,0,0,0
2024-02-25 20:30,5,5,0,0,0,0
2024-02-25 20:45,15,13,2,0,0,0
2024-02-25 21:00,11,11,0,0,0,0
2024-02-25 21:15,14,12,2,0,0,0
2024-02-25 21:30,6,6,0,0,0,0
2024-02-25 21:45,7,7,0,0,0,0
2024-02-25 22:00,10,10,0,0,0,0
2024-02-25 22:15,7,7,0,0,0,0
2024-02-25 22:30,2,2,0,0,0,0
2024-02-25 22:45,1,1,0,0,0,0
2024-02-25 23:00,2,0,2,0,0,0
2024-02-25 23:15,1,1,0,0,0,0
2024-02-25 23:30,2,2,0,0,0,0
2024-02-25 23:45,1,1,0,0,0,0
2024-02-26 00:00,2,2,0,0,0,0
2024-02-26 00:15,4,3,1,0,0,0
2024-02-26 00:30,1,1,0,0,0,0
2024-02-26 00:45,1,1,0,0,0,0
2024-02-26 01:00,1,1,0,0,0,0
2024-02-26 01:15,0,0,0,0,0,0
2024-02-26 01:30,1,1,0,0,0,0
2024-02-26 01:45,0,0,0,0,0,0
2024-02-26 02:00,2,2,0,0,0,0
2024-02-26 02:15,1,1,0,0,0,0
2024-02-26 02:30,0,0,0,0,0,0
2024-02-26 02:45,0,0,0,0,0,0
2024-02-26 03:00,0,0,0,0,0,0
2024-02-26 03:15,0,0,0,0,0,0
2024-02-26 03:30,3,2,1,0,0,0
2024-02-26 03:45,1,1,0,0,0,0
2024-02-26 04:00,1,1,0,0,0,0
2024-02-26 04:15,4,2,2,0,0,0
2024-02-26 04:30,4,2,2,0,0,0
2024-02-26 04:45,0,0,0,0,0,0
2024-02-26 05:00,6,3,3,0,0,0
2024-02-26 05:15,6,4,2,0,0,0
2024-02-26 05:30,4,3,1,0,0,0
2024-02-26 05:45,9,5,4,0,0,0
2024-02-26 06:00,12,9,3,0,0,0
2024-02-26 06:15,13,12,1,0,0,0
2024-02-26 06:30,30,25,5,0,0,0
2024-02-26 06:45,31,26,5,0,0,0
2024-02-26 07:00,32,30,2,0,0,0
2024-02-26 07:15,64,59,5,0,0,0
2024-02-26 07:30,122,114,8,0,0,0
2024-02-26 07:45,96,88,8,0,0,0
2024-02-26 08:00,46,38,8,0,0,0
2024-02-26 08:15,57,54,3,0,0,0
2024-02-26 08:30,51,48,3,0,0,0
2024-02-26 08:45,48,45,3,0,0,0
2024-02-26 09:00,41,39,2,0,0,0
2024-02-26 09:15,42,35,7,0,0,0
2024-02-26 09:30,37,35,2,0,0,0
2024-02-26 09:45,38,35,3,0,0,0
2024-02-26 10:00,22,20,2,0,0,0
2024-02-26 10:15,22,19,3,0,0,0
2024-02-26 10:30,25,23,2,0,0,0
2024-02-26 10:45,19,17,2,0,0,0
2024-02-26 11:00,25,22,3,0,0,0
2024-02-26 11:15,23,22,1,0,0,0
2024-02-26 11:30,19,18,1,0,0,0
2024-02-26 11:45,30,28,2,0,0,0
2024-02-26 12:00,20,15,5,0,0,0
2024-02-26 12:15,18,17,1,0,0,0
2024-02-26 12:30,20,19,1,0,0,0
2024-02-26 12:45,25,22,3,0,0,0
2024-02-26 13:00,102,44,58,0,0,0
2024-02-26 13:15,123,52,71,0,0,0
2024-02-26 13:30,117,57,60,0,0,0
2024-02-26 13:45,85,51,34,0,0,0
2024-02-26 14:00,86,43,43,0,0,0
2024-02-26 14:15,119,72,47,0,0,0
2024-02-26 14:30,104,60,44,0,0,0
2024-02-26 14:45,77,39,38,0,0,0
2024-02-26 15:00,93,43,50,0,0,0
2024-02-26 15:15,111,61,50,0,0,0
2024-02-26 15:30,81,43,38,0,0,0
2024-02-26 15:45,131,69,62,0,0,0
2024-02-26 16:00,104,62,42,0,0,0
2024-02-26 16:15,94,55,39,0,0,0
2024-02-26 16:30,124,68,56,0,0,0
2024-02-26 16:45,84,40,44,0,0,0
2024-02-26 17:00,127,62,65,0,0,0
2024-02-26 17:15,121,63,58,0,0,0
2024-02-26 17:30,105,48,57,0,0,0
2024-02-26 17:45,117,52,65,0,0,0
2024-02-26 18:00,89,51,38,0,0,0
2024-02-26 18:15,81,39,42,0,0,0
2024-02-26 18:30,79,43,36,0,0,0
2024-02-26 18:45,81,35,46,0,0,0
2024-02-26 19:00,36,35,1,0,0,0
2024-02-26 19:15,29,28,1,0,0,0
2024-02-26 19:30,18,16,2,0,0,0
2024-02-26 19:45,23,22,1,0,0,0
2024-02-26 20:00,19,19,0,0,0,0
2024-02-26 20:15,18,15,3,0,0,0
2024-02-26 20:30,10,10,0,0,0,0
2024-02-26 20:45,7,7,0,0,0,0
2024-02-26 21:00,22,20,2,0,0,0
2024-02-26 21:15,17,16,1,0,0,0
2024-02-26 21:30,2,1,1,0,0,0
2024-02-26 21:45,12,10,2,0,0,0
2024-02-26 22:00,9,9,0,0,0,0
2024-02-26 22:15,7,7,0,0,0,0
2024-02-26 22:30,2,1,1,0,0,0
2024-02-26 22:45,6,5,1,0,0,0
2024-02-26 23:00,5,5,0,0,0,0
2024-02-26 23:15,3,1,2,0,0,0
2024-02-26 23:30,7,7,0,0,0,0
2024-02-26 23:45,2,2,0,0,0,0
2024-02-27 00:00,0,0,0,0,0,0
2024-02-27 00:15,0,0,0,0,0,0
2024-02-27 00:30,1,0,1,0,0,0
2024-02-27 00:45,0,0,0,0,0,0
2024-02-27 01:00,2,2,0,0,0,0
2024-02-27 01:15,3,3,0,0,0,0
2024-02-27 01:30,0,0,0,0,0,0
2024-02-27 01:45,0,0,0,0,0,0
2024-02-27 02:00,1,0,1,0,0,0
2024-02-27 02:15,4,4,0,0,0,0
2024-02-27 02:30,0,0,0,0,0,0
2024-02-27 02:45,1,1,0,0,0,0
2024-02-27 03:00,0,0,0,0,0,0
2024-02-27 03:15,0,0,0,0,0,0
2024-02-27 03:30,3,1,2,0,0,0
2024-02-27 03:45,0,0,0,0,0,0
2024-02-27 04:00,0,0,0,0,0,0
2024-02-27 04:15,3,1,2,0,0,0
2024-02-27 04:30,4,3,1,0,0,0
2024-02-27 04:45,3,1,2,0,0,0
2024-02-27 05:00,3,2,1,0,0,0
2024-02-27 05:15,11,8,3,0,0,0
2024-02-27 05:30,6,3,3,0,0,0
2024-02-27 05:45,9,5,4,0,0,0
2024-02-27 06:00,12,9,3,0,0,0
2024-02-27 06:15,16,12,4,0,0,0
2024-02-27 06:30,30,27,3,0,0,0
2024-02-27 06:45,36,33,3,0,0,0
2024-02-27 07:00,57,29,28,0,0,0
2024-02-27 07:15,149,89,60,0,0,0
2024-02-27 07:30,199,129,70,0,0,0
2024-02-27 07:45,198,90,108,0,0,0
2024-02-27 08:00,149,60,89,0,0,0
2024-02-27 08:15,147,68,79,0,0,0
2024-02-27 08:30,103,45,58,0,0,0
2024-02-27 08:45,149,57,92,0,0,0
2024-02-27 09:00,126,57,69,0,0,0
2024-02-27 09:15,93,32,61,0,0,0
2024-02-27 09:30,83,34,49,0,0,0
2024-02-27 09:45,77,32,45,0,0,0
2024-02-27 10:00,69,34,35,0,0,0
2024-02-27 10:15,43,17,26,0,0,0
2024-02-27 10:30,54,28,26,0,0,0
2024-02-27 10:45,63,24,39,0,0,0
2024-02-27 11:00,65,35,30,0,0,0
2024-02-27 11:15,66,29,37,0,0,0
2024-02-27 11:30,64,31,33,0,0,0
2024-02-27 11:45,73,32,41,0,0,0
2024-02-27 12:00,93,36,57,0,0,0
2024-02-27 12:15,77,36,41,0,0,0
2024-02-27 12:30,80,41,39,0,0,0
2024-02-27 12:45,90,50,40,0,0,0
2024-02-27 13:00,113,49,64,0,0,0
2024-02-27 13:15,147,54,93,0,0,0
2024-02-27 13:30,118,59,59,0,0,0
2024-02-27 13:45,107,55,52,0,0,0
2024-02-27 14:00,130,74,56,0,0,0
2024-02-27 14:15,113,62,51,0,0,0
2024-02-27 14:30,96,61,35,0,0,0
2024-02-27 14:45,110,60,50,0,0,0
2024-02-27 15:00,100,60,40,0,0,0
2024-02-27 15:15,87,48,39,0,0,0
2024-02-27 15:30,126,69,57,0,0,0
2024-02-27 15:45,97,48,49,0,0,0
2024-02-27 16:00,139,79,60,0,0,0
2024-02-27 16:15,118,60,58,0,0,0
2024-02-27 16:30,132,76,56,0,0,0
2024-02-27 16:45,111,60,51,0,0,0
2024-02-27 17:00,126,68,58,0,0,0
2024-02-27 17:15,148,79,69,0,0,0
2024-02-27 17:30,147,75,72,0,0,0
2024-02-27 17:45,133,69,64,0,0,0
2024-02-27 18:00,117,53,64,0,0,0
2024-02-27 18:15,87,46,41,0,0,0
2024-02-27 18:30,86,48,38,0,0,0
2024-02-27 18:45,97,46,51,0,0,0
2024-02-27 19:00,74,43,31,0,0,0
2024-02-27 19:15,79,46,33,0,0,0
2024-02-27 19:30,45,24,21,0,0,0
2024-02-27 19:45,65,30,35,0,0,0
2024-02-27 20:00,77,33,44,0,0,0
2024-02-27 20:15,46,12,34,0,0,0
2024-02-27 20:30,37,14,23,0,0,0
2024-02-27 20:45,37,19,18,0,0,0
2024-02-27 21:00,40,23,17,0,0,0
2024-02-27 21:15,26,13,13,0,0,0
2024-02-27 21:30,39,15,24,0,0,0
2024-02-27 21:45,24,8,16,0,0,0
2024-02-27 22:00,32,20,12,0,0,0
2024-02-27 22:15,37,15,22,0,0,0
2024-02-27 22:30,22,7,15,0,0,0
2024-02-27 22:45,22,5,17,0,0,0
2024-02-27 23:00,16,5,11,0,0,0
2024-02-27 23:15,18,7,11,0,0,0
2024-02-27 23:30,10,4,6,0,0,0
2024-02-27 23:45,9,4,5,0,0,0
2024-02-28 00:00,14,3,11,0,0,0
2024-02-28 00:15,6,3,3,0,0,0
2024-02-28 00:30,4,1,3,0,0,0
2024-02-28 00:45,7,4,3,0,0,0
2024-02-28 01:00,3,1,2,0,0,0
2024-02-28 01:15,3,1,2,0,0,0
2024-02-28 01:30,6,4,2,0,0,0
2024-02-28 01:45,2,0,2,0,0,0
2024-02-28 02:00,4,0,4,0,0,0
2024-02-28 02:15,3,2,1,0,0,0
2024-02-28 02:30,1,0,1,0,0,0
2024-02-28 02:45,0,0,0,0,0,0
2024-02-28 03:00,0,0,0,0,0,0
2024-02-28 03:15,0,0,0,0,0,0
2024-02-28 03:30,1,1,0,0,0,0
2024-02-28 03:45,0,0,0,0,0,0
2024-02-28 04:00,0,0,0,0,0,0
2024-02-28 04:15,2,1,1,0,0,0
2024-02-28 04:30,6,5,1,0,0,0
2024-02-28 04:45,5,1,4,0,0,0
2024-02-28 05:00,10,5,5,0,0,0
2024-02-28 05:15,8,5,3,0,0,0
2024-02-28 05:30,10,4,6,0,0,0
2024-02-28 05:45,22,5,17,0,0,0
2024-02-28 06:00,15,10,5,0,0,0
2024-02-28 06:15,15,9,6,0,0,0
2024-02-28 06:30,42,24,18,0,0,0
2024-02-28 06:45,71,37,34,0,0,0
2024-02-28 07:00,56,38,18,0,0,0
2024-02-28 07:15,105,65,40,0,0,0
2024-02-28 07:30,203,133,70,0,0,0
2024-02-28 07:45,196,96,100,0,0,0
2024-02-28 08:00,137,44,93,0,0,0
2024-02-28 08:15,147,54,93,0,0,0
2024-02-28 08:30,126,64,62,0,0,0
2024-02-28 08:45,138,50,88,0,0,0
2024-02-28 09:00,119,49,70,0,0,0
2024-02-28 09:15,89,40,49,0,0,0
2024-02-28 09:30,78,38,40,0,0,0
2024-02-28 09:45,78,34,44,0,0,0
2024-02-28 10:00,55,25,30,0,0,0
2024-02-28 10:15,75,37,38,0,0,0
2024-02-28 10:30,65,33,32,0,0,0
2024-02-28 10:45,48,28,20,0,0,0
2024-02-28 11:00,68,32,36,0,0,0
2024-02-28 11:15,64,26,38,0,0,0
2024-02-28 11:30,66,26,40,0,0,0
2024-02-28 11:45,75,40,35,0,0,0
2024-02-28 12:00,77,30,47,0,0,0
2024-02-28 12:15,83,29,54,0,0,0
2024-02-28 12:30,104,44,60,0,0,0
2024-02-28 12:45,116,56,60,0,0,0
2024-02-28 13:00,124,60,64,0,0,0
2024-02-28 13:15,159,61,98,0,0,0
2024-02-28 13:30,113,56,57,0,0,0
2024-02-28 13:45,96,46,50,0,0,0
2024-02-28 14:00,103,57,46,0,0,0
2024-02-28 14:15,98,64,34,0,0,0
2024-02-28 14:30,119,59,60,0,0,0
2024-02-28 14:45,98,52,46,0,0,0
2024-02-28 15:00,101,57,44,0,0,0
2024-02-28 15:15,87,48,39,0,0,0
2024-02-28 15:30,99,53,46,0,0,0
2024-02-28 15:45,144,69,75,0,0,0
2024-02-28 16:00,115,74,41,0,0,0
2024-02-28 16:15,101,52,49,0,0,0
2024-02-28 16:30,118,63,55,0,0,0
2024-02-28 16:45,118,69,49,0,0,0
2024-02-28 17:00,105,57,48,0,0,0
2024-02-28 17:15,142,74,68,0,0,0
2024-02-28 17:30,99,51,48,0,0,0
2024-02-28 17:45,133,69,64,0,0,0
2024-02-28 18:00,113,56,57,0,0,0
2024-02-28 18:15,95,44,51,0,0,0
2024-02-28 18:30,87,43,44,0,0,0
2024-02-28 18:45,91,45,46,0,0,0
2024-02-28 19:00,65,38,27,0,0,0
2024-02-28 19:15,67,28,39,0,0,0
2024-02-28 19:30,73,34,39,0,0,0
2024-02-28 19:45,65,35,30,0,0,0
2024-02-28 20:00,66,34,32,0,0,0
2024-02-28 20:15,59,19,40,0,0,0
2024-02-28 20:30,48,24,24,0,0,0
2024-02-28 20:45,37,20,17,0,0,0
2024-02-28 21:00,46,26,20,0,0,0
2024-02-28 21:15,33,14,19,0,0,0
2024-02-28 21:30,46,19,27,0,0,0
2024-02-28 21:45,35,14,21,0,0,0
2024-02-28 22:00,40,18,22,0,0,0
2024-02-28 22:15,48,20,28,0,0,0
2024-02-28 22:30,31,15,16,0,0,0
2024-02-28 22:45,22,7,15,0,0,0
2024-02-28 23:00,21,7,14,0,0,0
2024-02-28 23:15,10,1,9,0,0,0
2024-02-28 23:30,9,3,6,0,0,0
2024-02-28 23:45,4,2,2,0,0,0
2024-02-29 00:00,8,0,8,0,0,0
2024-02-29 00:15,11,3,8,0,0,0
2024-02-29 00:30,12,5,7,0,0,0
2024-02-29 00:45,3,1,2,0,0,0
2024-02-29 01:00,8,2,6,0,0,0
2024-02-29 01:15,7,2,5,0,0,0
2024-02-29 01:30,10,4,6,0,0,0
2024-02-29 01:45,9,1,8,0,0,0
2024-02-29 02:00,9,2,7,0,0,0
2024-02-29 02:15,5,4,1,0,0,0
2024-02-29 02:30,2,0,2,0,0,0
2024-02-29 02:45,0,0,0,0,0,0
2024-02-29 03:00,1,0,1,0,0,0
2024-02-29 03:15,2,0,2,0,0,0
2024-02-29 03:30,2,2,0,0,0,0
2024-02-29 03:45,2,0,2,0,0,0
2024-02-29 04:00,1,0,1,0,0,0
2024-02-29 04:15,2,2,0,0,0,0
2024-02-29 04:30,4,3,1,0,0,0
2024-02-29 04:45,3,0,3,0,0,0
2024-02-29 05:00,5,3,2,0,0,0
2024-02-29 05:15,9,9,0,0,0,0
2024-02-29 05:30,15,5,10,0,0,0
2024-02-29 05:45,19,5,14,0,0,0
2024-02-29 06:00,19,13,6,0,0,0
2024-02-29 06:15,24,15,9,0,0,0
2024-02-29 06:30,42,25,17,0,0,0
2024-02-29 06:45,76,35,41,0,0,0
2024-02-29 07:00,63,39,24,0,0,0
2024-02-29 07:15,135,92,43,0,0,0
2024-02-29 07:30,227,143,84,0,0,0
2024-02-29 07:45,187,69,118,0,0,0
2024-02-29 08:00,159,70,89,0,0,0
2024-02-29 08:15,132,58,74,0,0,0
2024-02-29 08:30,141,77,64,0,0,0
2024-02-29 08:45,142,76,66,0,0,0
2024-02-29 09:00,121,51,70,0,0,0
2024-02-29 09:15,95,41,54,0,0,0
2024-02-29 09:30,93,45,48,0,0,0
2024-02-29 09:45,108,59,49,0,0,0
2024-02-29 10:00,54,20,34,0,0,0
2024-02-29 10:15,74,30,44,0,0,0
2024-02-29 10:30,63,36,27,0,0,0
2024-02-29 10:45,61,26,35,0,0,0
2024-02-29 11:00,69,31,38,0,0,0
2024-02-29 11:15,57,25,32,0,0,0
2024-02-29 11:30,69,33,36,0,0,0
2024-02-29 11:45,86,35,51,0,0,0
2024-02-29 12:00,95,41,54,0,0,0
2024-02-29 12:15,103,47,56,0,0,0
2024-02-29 12:30,116,43,73,0,0,0
2024-02-29 12:45,121,54,67,0,0,0
2024-02-29 13:00,105,48,57,0,0,0
2024-02-29 13:15,147,49,98,0,0,0
2024-02-29 13:30,94,53,41,0,0,0
2024-02-29 13:45,143,79,64,0,0,0
2024-02-29 14:00,126,74,52,0,0,0
2024-02-29 14:15,134,75,59,0,0,0
2024-02-29 14:30,114,66,48,0,0,0
2024-02-29 14:45,114,64,50,0,0,0
2024-02-29 15:00,115,67,48,0,0,0
2024-02-29 15:15,133,69,64,0,0,0
2024-02-29 15:30,118,55,63,0,0,0
2024-02-29 15:45,150,71,79,0,0,0
2024-02-29 16:00,131,68,63,0,0,0
2024-02-29 16:15,133,71,62,0,0,0
2024-02-29 16:30,129,64,65,0,0,0
2024-02-29 16:45,131,71,60,0,0,0
2024-02-29 17:00,138,81,57,0,0,0
2024-02-29 17:15,136,67,69,0,0,0
2024-02-29 17:30,121,63,58,0,0,0
2024-02-29 17:45,123,60,63,0,0,0
2024-02-29 18:00,124,68,56,0,0,0
2024-02-29 18:15,112,65,47,0,0,0
2024-02-29 18:30,100,52,48,0,0,0
2024-02-29 18:45,111,53,58,0,0,0
2024-02-29 19:00,87,41,46,0,0,0
2024-02-29 19:15,61,28,33,0,0,0
2024-02-29 19:30,77,37,40,0,0,0
2024-02-29 19:45,68,30,38,0,0,0
2024-02-29 20:00,80,34,46,0,0,0
2024-02-29 20:15,50,21,29,0,0,0
2024-02-29 20:30,58,25,33,0,0,0
2024-02-29 20:45,34,19,15,0,0,0
2024-02-29 21:00,42,23,19,0,0,0
2024-02-29 21:15,34,12,22,0,0,0
2024-02-29 21:30,41,16,25,0,0,0
2024-02-29 21:45,40,13,27,0,0,0
2024-02-29 22:00,37,11,26,0,0,0
2024-02-29 22:15,42,18,24,0,0,0
2024-02-29 22:30,50,14,36,0,0,0
2024-02-29 22:45,32,7,25,0,0,0
2024-02-29 23:00,28,15,13,0,0,0
2024-02-29 23:15,26,5,21,0,0,0
2024-02-29 23:30,18,8,10,0,0,0
2024-02-29 23:45,13,8,5,0,0,0
